Departamento de residencia,Estado civil,Grupos de edad,Total,Hombres,Mujeres,Anio
Todos los departamentos,Todos los estados civiles,Todas las edades,71707,41354,30353,09
Todos los departamentos,Todos los estados civiles,Menos de 15 años,12855,6989,5866,09
Todos los departamentos,Todos los estados civiles,15 - 24,5374,3975,1399,09
Todos los departamentos,Todos los estados civiles,25 - 44,11606,8391,3215,09
Todos los departamentos,Todos los estados civiles,45 - 64,13796,7798,5998,09
Todos los departamentos,Todos los estados civiles,65 y más,27565,13899,13666,09
Todos los departamentos,Todos los estados civiles,Ignorado,511,302,209,09
Todos los departamentos,Todos los estados civiles,Todas las edades,42692,24490,18202,09
Todos los departamentos,Soltero(a),Menos de 15 años,11277,6137,5140,09
Todos los departamentos,Soltero(a),15 - 24,4830,3638,1192,09
Todos los departamentos,Soltero(a),25 - 44,6991,5194,1797,09
Todos los departamentos,Soltero(a),45 - 64,6093,3429,2664,09
Todos los departamentos,Soltero(a),65 y más,13140,5897,7243,09
Todos los departamentos,Soltero(a),Ignorado,361,195,166,09
Todos los departamentos,Casado(a),Todas las edades,25833,14939,10894,09
Todos los departamentos,Casado(a),Menos de 15 años,11,7,4,09
Todos los departamentos,Casado(a),15 - 24,415,248,167,09
Todos los departamentos,Casado(a),25 - 44,4167,2827,1340,09
Todos los departamentos,Casado(a),45 - 64,7402,4166,3236,09
Todos los departamentos,Casado(a),65 y más,13799,7664,6135,09
Todos los departamentos,Casado(a),Ignorado,39,27,12,09
Todos los departamentos,Unido(a),Todas las edades,603,320,283,09
Todos los departamentos,Unido(a),Menos de 15 años,1,0,1,09
Todos los departamentos,Unido(a),15 - 24,4,2,2,09
Todos los departamentos,Unido(a),25 - 44,71,39,32,09
Todos los departamentos,Unido(a),45 - 64,130,65,65,09
Todos los departamentos,Unido(a),65 y más,395,212,183,09
Todos los departamentos,Unido(a),Ignorado,2,2,0,09
Todos los departamentos,Ignorado(a),Todas las edades,2579,1605,974,09
Todos los departamentos,Ignorado(a),Menos de 15 años,1566,845,721,09
Todos los departamentos,Ignorado(a),15 - 24,125,87,38,09
Todos los departamentos,Ignorado(a),25 - 44,377,331,46,09
Todos los departamentos,Ignorado(a),45 - 64,171,138,33,09
Todos los departamentos,Ignorado(a),65 y más,231,126,105,09
Todos los departamentos,Ignorado(a),Ignorado,109,78,31,09
Guatemala,Todos los estados civiles,Todas las edades,16887,9705,7182,09
Guatemala,Todos los estados civiles,Menos de 15 años,2404,1342,1062,09
Guatemala,Todos los estados civiles,15 - 24,1569,1286,283,09
Guatemala,Todos los estados civiles,25 - 44,2699,2075,624,09
Guatemala,Todos los estados civiles,45 - 64,3317,1794,1523,09
Guatemala,Todos los estados civiles,65 y más,6849,3177,3672,09
Guatemala,Todos los estados civiles,Ignorado,49,31,18,09
Guatemala,Todos los estados civiles,Todas las edades,9544,5555,3989,09
Guatemala,Soltero(a),Menos de 15 años,2000,1121,879,09
Guatemala,Soltero(a),15 - 24,1456,1204,252,09
Guatemala,Soltero(a),25 - 44,1712,1347,365,09
Guatemala,Soltero(a),45 - 64,1518,800,718,09
Guatemala,Soltero(a),65 y más,2823,1065,1758,09
Guatemala,Soltero(a),Ignorado,35,18,17,09
Guatemala,Casado(a),Todas las edades,6736,3790,2946,09
Guatemala,Casado(a),Menos de 15 años,2,1,1,09
Guatemala,Casado(a),15 - 24,88,62,26,09
Guatemala,Casado(a),25 - 44,927,675,252,09
Guatemala,Casado(a),45 - 64,1773,981,792,09
Guatemala,Casado(a),65 y más,3944,2069,1875,09
Guatemala,Casado(a),Ignorado,2,2,0,09
Guatemala,Unido(a),Todas las edades,45,30,15,09
Guatemala,Unido(a),Menos de 15 años,0,0,0,09
Guatemala,Unido(a),15 - 24,0,0,0,09
Guatemala,Unido(a),25 - 44,5,2,3,09
Guatemala,Unido(a),45 - 64,3,2,1,09
Guatemala,Unido(a),65 y más,37,26,11,09
Guatemala,Unido(a),Ignorado,0,0,0,09
Guatemala,Ignorado(a),Todas las edades,562,330,232,09
Guatemala,Ignorado(a),Menos de 15 años,402,220,182,09
Guatemala,Ignorado(a),15 - 24,25,20,5,09
Guatemala,Ignorado(a),25 - 44,55,51,4,09
Guatemala,Ignorado(a),45 - 64,23,11,12,09
Guatemala,Ignorado(a),65 y más,45,17,28,09
Guatemala,Ignorado(a),Ignorado,12,11,1,09
El Progreso,Todos los estados civiles,Todas las edades,1028,590,438,09
El Progreso,Todos los estados civiles,Menos de 15 años,119,64,55,09
El Progreso,Todos los estados civiles,15 - 24,66,48,18,09
El Progreso,Todos los estados civiles,25 - 44,174,129,45,09
El Progreso,Todos los estados civiles,45 - 64,189,104,85,09
El Progreso,Todos los estados civiles,65 y más,479,244,235,09
El Progreso,Todos los estados civiles,Ignorado,1,1,0,09
El Progreso,Todos los estados civiles,Todas las edades,579,325,254,09
El Progreso,Soltero(a),Menos de 15 años,93,50,43,09
El Progreso,Soltero(a),15 - 24,65,47,18,09
El Progreso,Soltero(a),25 - 44,115,87,28,09
El Progreso,Soltero(a),45 - 64,89,51,38,09
El Progreso,Soltero(a),65 y más,217,90,127,09
El Progreso,Soltero(a),Ignorado,0,0,0,09
El Progreso,Casado(a),Todas las edades,401,232,169,09
El Progreso,Casado(a),Menos de 15 años,0,0,0,09
El Progreso,Casado(a),15 - 24,0,0,0,09
El Progreso,Casado(a),25 - 44,57,40,17,09
El Progreso,Casado(a),45 - 64,99,53,46,09
El Progreso,Casado(a),65 y más,244,138,106,09
El Progreso,Casado(a),Ignorado,1,1,0,09
El Progreso,Unido(a),Todas las edades,13,10,3,09
El Progreso,Unido(a),Menos de 15 años,0,0,0,09
El Progreso,Unido(a),15 - 24,0,0,0,09
El Progreso,Unido(a),25 - 44,0,0,0,09
El Progreso,Unido(a),45 - 64,1,0,1,09
El Progreso,Unido(a),65 y más,12,10,2,09
El Progreso,Unido(a),Ignorado,0,0,0,09
El Progreso,Ignorado(a),Todas las edades,35,23,12,09
El Progreso,Ignorado(a),Menos de 15 años,26,14,12,09
El Progreso,Ignorado(a),15 - 24,1,1,0,09
El Progreso,Ignorado(a),25 - 44,2,2,0,09
El Progreso,Ignorado(a),45 - 64,0,0,0,09
El Progreso,Ignorado(a),65 y más,6,6,0,09
El Progreso,Ignorado(a),Ignorado,0,0,0,09
Sacatepéquez,Todos los estados civiles,Todas las edades,1537,847,690,09
Sacatepéquez,Todos los estados civiles,Menos de 15 años,201,110,91,09
Sacatepéquez,Todos los estados civiles,15 - 24,98,70,28,09
Sacatepéquez,Todos los estados civiles,25 - 44,218,165,53,09
Sacatepéquez,Todos los estados civiles,45 - 64,305,157,148,09
Sacatepéquez,Todos los estados civiles,65 y más,706,340,366,09
Sacatepéquez,Todos los estados civiles,Ignorado,9,5,4,09
Sacatepéquez,Todos los estados civiles,Todas las edades,764,426,338,09
Sacatepéquez,Soltero(a),Menos de 15 años,185,103,82,09
Sacatepéquez,Soltero(a),15 - 24,90,64,26,09
Sacatepéquez,Soltero(a),25 - 44,103,78,25,09
Sacatepéquez,Soltero(a),45 - 64,100,54,46,09
Sacatepéquez,Soltero(a),65 y más,279,124,155,09
Sacatepéquez,Soltero(a),Ignorado,7,3,4,09
Sacatepéquez,Casado(a),Todas las edades,739,402,337,09
Sacatepéquez,Casado(a),Menos de 15 años,0,0,0,09
Sacatepéquez,Casado(a),15 - 24,8,6,2,09
Sacatepéquez,Casado(a),25 - 44,114,86,28,09
Sacatepéquez,Casado(a),45 - 64,200,101,99,09
Sacatepéquez,Casado(a),65 y más,417,209,208,09
Sacatepéquez,Casado(a),Ignorado,0,0,0,09
Sacatepéquez,Unido(a),Todas las edades,3,1,2,09
Sacatepéquez,Unido(a),Menos de 15 años,0,0,0,09
Sacatepéquez,Unido(a),15 - 24,0,0,0,09
Sacatepéquez,Unido(a),25 - 44,0,0,0,09
Sacatepéquez,Unido(a),45 - 64,0,0,0,09
Sacatepéquez,Unido(a),65 y más,3,1,2,09
Sacatepéquez,Unido(a),Ignorado,0,0,0,09
Sacatepéquez,Ignorado(a),Todas las edades,31,18,13,09
Sacatepéquez,Ignorado(a),Menos de 15 años,16,7,9,09
Sacatepéquez,Ignorado(a),15 - 24,0,0,0,09
Sacatepéquez,Ignorado(a),25 - 44,1,1,0,09
Sacatepéquez,Ignorado(a),45 - 64,5,2,3,09
Sacatepéquez,Ignorado(a),65 y más,7,6,1,09
Sacatepéquez,Ignorado(a),Ignorado,2,2,0,09
Chimaltenango,Todos los estados civiles,Todas las edades,2670,1529,1141,09
Chimaltenango,Todos los estados civiles,Menos de 15 años,514,292,222,09
Chimaltenango,Todos los estados civiles,15 - 24,166,116,50,09
Chimaltenango,Todos los estados civiles,25 - 44,408,283,125,09
Chimaltenango,Todos los estados civiles,45 - 64,478,273,205,09
Chimaltenango,Todos los estados civiles,65 y más,1086,557,529,09
Chimaltenango,Todos los estados civiles,Ignorado,18,8,10,09
Chimaltenango,Todos los estados civiles,Todas las edades,1296,736,560,09
Chimaltenango,Soltero(a),Menos de 15 años,477,270,207,09
Chimaltenango,Soltero(a),15 - 24,142,100,42,09
Chimaltenango,Soltero(a),25 - 44,198,145,53,09
Chimaltenango,Soltero(a),45 - 64,133,69,64,09
Chimaltenango,Soltero(a),65 y más,331,145,186,09
Chimaltenango,Soltero(a),Ignorado,15,7,8,09
Chimaltenango,Casado(a),Todas las edades,1305,751,554,09
Chimaltenango,Casado(a),Menos de 15 años,0,0,0,09
Chimaltenango,Casado(a),15 - 24,21,13,8,09
Chimaltenango,Casado(a),25 - 44,205,133,72,09
Chimaltenango,Casado(a),45 - 64,343,202,141,09
Chimaltenango,Casado(a),65 y más,735,403,332,09
Chimaltenango,Casado(a),Ignorado,1,0,1,09
Chimaltenango,Unido(a),Todas las edades,17,9,8,09
Chimaltenango,Unido(a),Menos de 15 años,0,0,0,09
Chimaltenango,Unido(a),15 - 24,0,0,0,09
Chimaltenango,Unido(a),25 - 44,0,0,0,09
Chimaltenango,Unido(a),45 - 64,1,1,0,09
Chimaltenango,Unido(a),65 y más,16,8,8,09
Chimaltenango,Unido(a),Ignorado,0,0,0,09
Chimaltenango,Ignorado(a),Todas las edades,52,33,19,09
Chimaltenango,Ignorado(a),Menos de 15 años,37,22,15,09
Chimaltenango,Ignorado(a),15 - 24,3,3,0,09
Chimaltenango,Ignorado(a),25 - 44,5,5,0,09
Chimaltenango,Ignorado(a),45 - 64,1,1,0,09
Chimaltenango,Ignorado(a),65 y más,4,1,3,09
Chimaltenango,Ignorado(a),Ignorado,2,1,1,09
Escuintla,Todos los estados civiles,Todas las edades,3950,2446,1504,09
Escuintla,Todos los estados civiles,Menos de 15 años,432,245,187,09
Escuintla,Todos los estados civiles,15 - 24,304,247,57,09
Escuintla,Todos los estados civiles,25 - 44,784,609,175,09
Escuintla,Todos los estados civiles,45 - 64,878,495,383,09
Escuintla,Todos los estados civiles,65 y más,1537,840,697,09
Escuintla,Todos los estados civiles,Ignorado,15,10,5,09
Escuintla,Todos los estados civiles,Todas las edades,2464,1590,874,09
Escuintla,Soltero(a),Menos de 15 años,356,208,148,09
Escuintla,Soltero(a),15 - 24,283,234,49,09
Escuintla,Soltero(a),25 - 44,560,446,114,09
Escuintla,Soltero(a),45 - 64,439,260,179,09
Escuintla,Soltero(a),65 y más,817,436,381,09
Escuintla,Soltero(a),Ignorado,9,6,3,09
Escuintla,Casado(a),Todas las edades,1329,765,564,09
Escuintla,Casado(a),Menos de 15 años,0,0,0,09
Escuintla,Casado(a),15 - 24,19,11,8,09
Escuintla,Casado(a),25 - 44,203,145,58,09
Escuintla,Casado(a),45 - 64,426,227,199,09
Escuintla,Casado(a),65 y más,680,381,299,09
Escuintla,Casado(a),Ignorado,1,1,0,09
Escuintla,Unido(a),Todas las edades,42,21,21,09
Escuintla,Unido(a),Menos de 15 años,0,0,0,09
Escuintla,Unido(a),15 - 24,1,1,0,09
Escuintla,Unido(a),25 - 44,7,4,3,09
Escuintla,Unido(a),45 - 64,7,3,4,09
Escuintla,Unido(a),65 y más,27,13,14,09
Escuintla,Unido(a),Ignorado,0,0,0,09
Escuintla,Ignorado(a),Todas las edades,115,70,45,09
Escuintla,Ignorado(a),Menos de 15 años,76,37,39,09
Escuintla,Ignorado(a),15 - 24,1,1,0,09
Escuintla,Ignorado(a),25 - 44,14,14,0,09
Escuintla,Ignorado(a),45 - 64,6,5,1,09
Escuintla,Ignorado(a),65 y más,13,10,3,09
Escuintla,Ignorado(a),Ignorado,5,3,2,09
Santa Rosa,Todos los estados civiles,Todas las edades,2067,1232,835,09
Santa Rosa,Todos los estados civiles,Menos de 15 años,177,90,87,09
Santa Rosa,Todos los estados civiles,15 - 24,144,107,37,09
Santa Rosa,Todos los estados civiles,25 - 44,364,267,97,09
Santa Rosa,Todos los estados civiles,45 - 64,424,254,170,09
Santa Rosa,Todos los estados civiles,65 y más,949,508,441,09
Santa Rosa,Todos los estados civiles,Ignorado,9,6,3,09
Santa Rosa,Todos los estados civiles,Todas las edades,1237,747,490,09
Santa Rosa,Soltero(a),Menos de 15 años,166,86,80,09
Santa Rosa,Soltero(a),15 - 24,132,99,33,09
Santa Rosa,Soltero(a),25 - 44,230,180,50,09
Santa Rosa,Soltero(a),45 - 64,213,136,77,09
Santa Rosa,Soltero(a),65 y más,487,240,247,09
Santa Rosa,Soltero(a),Ignorado,9,6,3,09
Santa Rosa,Casado(a),Todas las edades,796,469,327,09
Santa Rosa,Casado(a),Menos de 15 años,1,0,1,09
Santa Rosa,Casado(a),15 - 24,11,7,4,09
Santa Rosa,Casado(a),25 - 44,130,85,45,09
Santa Rosa,Casado(a),45 - 64,207,115,92,09
Santa Rosa,Casado(a),65 y más,447,262,185,09
Santa Rosa,Casado(a),Ignorado,0,0,0,09
Santa Rosa,Unido(a),Todas las edades,16,7,9,09
Santa Rosa,Unido(a),Menos de 15 años,0,0,0,09
Santa Rosa,Unido(a),15 - 24,0,0,0,09
Santa Rosa,Unido(a),25 - 44,3,1,2,09
Santa Rosa,Unido(a),45 - 64,4,3,1,09
Santa Rosa,Unido(a),65 y más,9,3,6,09
Santa Rosa,Unido(a),Ignorado,0,0,0,09
Santa Rosa,Ignorado(a),Todas las edades,18,9,9,09
Santa Rosa,Ignorado(a),Menos de 15 años,10,4,6,09
Santa Rosa,Ignorado(a),15 - 24,1,1,0,09
Santa Rosa,Ignorado(a),25 - 44,1,1,0,09
Santa Rosa,Ignorado(a),45 - 64,0,0,0,09
Santa Rosa,Ignorado(a),65 y más,6,3,3,09
Santa Rosa,Ignorado(a),Ignorado,0,0,0,09
Sololá,Todos los estados civiles,Todas las edades,1743,929,814,09
Sololá,Todos los estados civiles,Menos de 15 años,371,191,180,09
Sololá,Todos los estados civiles,15 - 24,98,67,31,09
Sololá,Todos los estados civiles,25 - 44,260,171,89,09
Sololá,Todos los estados civiles,45 - 64,348,183,165,09
Sololá,Todos los estados civiles,65 y más,646,307,339,09
Sololá,Todos los estados civiles,Ignorado,20,10,10,09
Sololá,Todos los estados civiles,Todas las edades,1041,558,483,09
Sololá,Soltero(a),Menos de 15 años,322,165,157,09
Sololá,Soltero(a),15 - 24,94,66,28,09
Sololá,Soltero(a),25 - 44,146,95,51,09
Sololá,Soltero(a),45 - 64,140,79,61,09
Sololá,Soltero(a),65 y más,337,152,185,09
Sololá,Soltero(a),Ignorado,2,1,1,09
Sololá,Casado(a),Todas las edades,587,318,269,09
Sololá,Casado(a),Menos de 15 años,0,0,0,09
Sololá,Casado(a),15 - 24,4,1,3,09
Sololá,Casado(a),25 - 44,110,75,35,09
Sololá,Casado(a),45 - 64,193,97,96,09
Sololá,Casado(a),65 y más,279,144,135,09
Sololá,Casado(a),Ignorado,1,1,0,09
Sololá,Unido(a),Todas las edades,41,16,25,09
Sololá,Unido(a),Menos de 15 años,0,0,0,09
Sololá,Unido(a),15 - 24,0,0,0,09
Sololá,Unido(a),25 - 44,3,1,2,09
Sololá,Unido(a),45 - 64,13,6,7,09
Sololá,Unido(a),65 y más,25,9,16,09
Sololá,Unido(a),Ignorado,0,0,0,09
Sololá,Ignorado(a),Todas las edades,74,37,37,09
Sololá,Ignorado(a),Menos de 15 años,49,26,23,09
Sololá,Ignorado(a),15 - 24,0,0,0,09
Sololá,Ignorado(a),25 - 44,1,0,1,09
Sololá,Ignorado(a),45 - 64,2,1,1,09
Sololá,Ignorado(a),65 y más,5,2,3,09
Sololá,Ignorado(a),Ignorado,17,8,9,09
Totonicapán,Todos los estados civiles,Todas las edades,2289,1290,999,09
Totonicapán,Todos los estados civiles,Menos de 15 años,550,325,225,09
Totonicapán,Todos los estados civiles,15 - 24,106,56,50,09
Totonicapán,Todos los estados civiles,25 - 44,353,230,123,09
Totonicapán,Todos los estados civiles,45 - 64,419,245,174,09
Totonicapán,Todos los estados civiles,65 y más,825,413,412,09
Totonicapán,Todos los estados civiles,Ignorado,36,21,15,09
Totonicapán,Todos los estados civiles,Todas las edades,1270,695,575,09
Totonicapán,Soltero(a),Menos de 15 años,487,288,199,09
Totonicapán,Soltero(a),15 - 24,92,49,43,09
Totonicapán,Soltero(a),25 - 44,172,121,51,09
Totonicapán,Soltero(a),45 - 64,144,82,62,09
Totonicapán,Soltero(a),65 y más,352,145,207,09
Totonicapán,Soltero(a),Ignorado,23,10,13,09
Totonicapán,Casado(a),Todas las edades,884,515,369,09
Totonicapán,Casado(a),Menos de 15 años,0,0,0,09
Totonicapán,Casado(a),15 - 24,13,7,6,09
Totonicapán,Casado(a),25 - 44,177,108,69,09
Totonicapán,Casado(a),45 - 64,257,152,105,09
Totonicapán,Casado(a),65 y más,430,242,188,09
Totonicapán,Casado(a),Ignorado,7,6,1,09
Totonicapán,Unido(a),Todas las edades,59,35,24,09
Totonicapán,Unido(a),Menos de 15 años,0,0,0,09
Totonicapán,Unido(a),15 - 24,0,0,0,09
Totonicapán,Unido(a),25 - 44,1,0,1,09
Totonicapán,Unido(a),45 - 64,16,10,6,09
Totonicapán,Unido(a),65 y más,40,23,17,09
Totonicapán,Unido(a),Ignorado,2,2,0,09
Totonicapán,Ignorado(a),Todas las edades,76,45,31,09
Totonicapán,Ignorado(a),Menos de 15 años,63,37,26,09
Totonicapán,Ignorado(a),15 - 24,1,0,1,09
Totonicapán,Ignorado(a),25 - 44,3,1,2,09
Totonicapán,Ignorado(a),45 - 64,2,1,1,09
Totonicapán,Ignorado(a),65 y más,3,3,0,09
Totonicapán,Ignorado(a),Ignorado,4,3,1,09
Quetzaltenango,Todos los estados civiles,Todas las edades,3921,2154,1767,09
Quetzaltenango,Todos los estados civiles,Menos de 15 años,608,347,261,09
Quetzaltenango,Todos los estados civiles,15 - 24,223,160,63,09
Quetzaltenango,Todos los estados civiles,25 - 44,544,367,177,09
Quetzaltenango,Todos los estados civiles,45 - 64,809,444,365,09
Quetzaltenango,Todos los estados civiles,65 y más,1705,816,889,09
Quetzaltenango,Todos los estados civiles,Ignorado,32,20,12,09
Quetzaltenango,Todos los estados civiles,Todas las edades,2165,1174,991,09
Quetzaltenango,Soltero(a),Menos de 15 años,485,274,211,09
Quetzaltenango,Soltero(a),15 - 24,192,143,49,09
Quetzaltenango,Soltero(a),25 - 44,313,213,100,09
Quetzaltenango,Soltero(a),45 - 64,312,162,150,09
Quetzaltenango,Soltero(a),65 y más,840,368,472,09
Quetzaltenango,Soltero(a),Ignorado,23,14,9,09
Quetzaltenango,Casado(a),Todas las edades,1578,876,702,09
Quetzaltenango,Casado(a),Menos de 15 años,1,1,0,09
Quetzaltenango,Casado(a),15 - 24,27,13,14,09
Quetzaltenango,Casado(a),25 - 44,228,151,77,09
Quetzaltenango,Casado(a),45 - 64,484,273,211,09
Quetzaltenango,Casado(a),65 y más,832,435,397,09
Quetzaltenango,Casado(a),Ignorado,6,3,3,09
Quetzaltenango,Unido(a),Todas las edades,11,2,9,09
Quetzaltenango,Unido(a),Menos de 15 años,0,0,0,09
Quetzaltenango,Unido(a),15 - 24,0,0,0,09
Quetzaltenango,Unido(a),25 - 44,0,0,0,09
Quetzaltenango,Unido(a),45 - 64,2,0,2,09
Quetzaltenango,Unido(a),65 y más,9,2,7,09
Quetzaltenango,Unido(a),Ignorado,0,0,0,09
Quetzaltenango,Ignorado(a),Todas las edades,167,102,65,09
Quetzaltenango,Ignorado(a),Menos de 15 años,122,72,50,09
Quetzaltenango,Ignorado(a),15 - 24,4,4,0,09
Quetzaltenango,Ignorado(a),25 - 44,3,3,0,09
Quetzaltenango,Ignorado(a),45 - 64,11,9,2,09
Quetzaltenango,Ignorado(a),65 y más,24,11,13,09
Quetzaltenango,Ignorado(a),Ignorado,3,3,0,09
Suchitepéquez,Todos los estados civiles,Todas las edades,2781,1615,1166,09
Suchitepéquez,Todos los estados civiles,Menos de 15 años,323,173,150,09
Suchitepéquez,Todos los estados civiles,15 - 24,185,152,33,09
Suchitepéquez,Todos los estados civiles,25 - 44,449,320,129,09
Suchitepéquez,Todos los estados civiles,45 - 64,606,349,257,09
Suchitepéquez,Todos los estados civiles,65 y más,1196,608,588,09
Suchitepéquez,Todos los estados civiles,Ignorado,22,13,9,09
Suchitepéquez,Todos los estados civiles,Todas las edades,1645,966,679,09
Suchitepéquez,Soltero(a),Menos de 15 años,308,164,144,09
Suchitepéquez,Soltero(a),15 - 24,163,138,25,09
Suchitepéquez,Soltero(a),25 - 44,271,201,70,09
Suchitepéquez,Soltero(a),45 - 64,274,161,113,09
Suchitepéquez,Soltero(a),65 y más,615,295,320,09
Suchitepéquez,Soltero(a),Ignorado,14,7,7,09
Suchitepéquez,Casado(a),Todas las edades,1089,620,469,09
Suchitepéquez,Casado(a),Menos de 15 años,1,0,1,09
Suchitepéquez,Casado(a),15 - 24,19,12,7,09
Suchitepéquez,Casado(a),25 - 44,174,117,57,09
Suchitepéquez,Casado(a),45 - 64,328,184,144,09
Suchitepéquez,Casado(a),65 y más,561,303,258,09
Suchitepéquez,Casado(a),Ignorado,6,4,2,09
Suchitepéquez,Unido(a),Todas las edades,17,9,8,09
Suchitepéquez,Unido(a),Menos de 15 años,0,0,0,09
Suchitepéquez,Unido(a),15 - 24,0,0,0,09
Suchitepéquez,Unido(a),25 - 44,1,0,1,09
Suchitepéquez,Unido(a),45 - 64,1,1,0,09
Suchitepéquez,Unido(a),65 y más,15,8,7,09
Suchitepéquez,Unido(a),Ignorado,0,0,0,09
Suchitepéquez,Ignorado(a),Todas las edades,30,20,10,09
Suchitepéquez,Ignorado(a),Menos de 15 años,14,9,5,09
Suchitepéquez,Ignorado(a),15 - 24,3,2,1,09
Suchitepéquez,Ignorado(a),25 - 44,3,2,1,09
Suchitepéquez,Ignorado(a),45 - 64,3,3,0,09
Suchitepéquez,Ignorado(a),65 y más,5,2,3,09
Suchitepéquez,Ignorado(a),Ignorado,2,2,0,09
Retalhuleu,Todos los estados civiles,Todas las edades,1621,947,674,09
Retalhuleu,Todos los estados civiles,Menos de 15 años,181,103,78,09
Retalhuleu,Todos los estados civiles,15 - 24,107,79,28,09
Retalhuleu,Todos los estados civiles,25 - 44,259,192,67,09
Retalhuleu,Todos los estados civiles,45 - 64,384,238,146,09
Retalhuleu,Todos los estados civiles,65 y más,685,331,354,09
Retalhuleu,Todos los estados civiles,Ignorado,5,4,1,09
Retalhuleu,Todos los estados civiles,Todas las edades,980,563,417,09
Retalhuleu,Soltero(a),Menos de 15 años,168,95,73,09
Retalhuleu,Soltero(a),15 - 24,93,69,24,09
Retalhuleu,Soltero(a),25 - 44,166,125,41,09
Retalhuleu,Soltero(a),45 - 64,180,113,67,09
Retalhuleu,Soltero(a),65 y más,369,158,211,09
Retalhuleu,Soltero(a),Ignorado,4,3,1,09
Retalhuleu,Casado(a),Todas las edades,594,355,239,09
Retalhuleu,Casado(a),Menos de 15 años,0,0,0,09
Retalhuleu,Casado(a),15 - 24,14,10,4,09
Retalhuleu,Casado(a),25 - 44,90,65,25,09
Retalhuleu,Casado(a),45 - 64,200,123,77,09
Retalhuleu,Casado(a),65 y más,290,157,133,09
Retalhuleu,Casado(a),Ignorado,0,0,0,09
Retalhuleu,Unido(a),Todas las edades,27,18,9,09
Retalhuleu,Unido(a),Menos de 15 años,0,0,0,09
Retalhuleu,Unido(a),15 - 24,0,0,0,09
Retalhuleu,Unido(a),25 - 44,1,1,0,09
Retalhuleu,Unido(a),45 - 64,4,2,2,09
Retalhuleu,Unido(a),65 y más,22,15,7,09
Retalhuleu,Unido(a),Ignorado,0,0,0,09
Retalhuleu,Ignorado(a),Todas las edades,20,11,9,09
Retalhuleu,Ignorado(a),Menos de 15 años,13,8,5,09
Retalhuleu,Ignorado(a),15 - 24,0,0,0,09
Retalhuleu,Ignorado(a),25 - 44,2,1,1,09
Retalhuleu,Ignorado(a),45 - 64,0,0,0,09
Retalhuleu,Ignorado(a),65 y más,4,1,3,09
Retalhuleu,Ignorado(a),Ignorado,1,1,0,09
San Marcos,Todos los estados civiles,Todas las edades,4787,2784,2003,09
San Marcos,Todos los estados civiles,Menos de 15 años,921,486,435,09
San Marcos,Todos los estados civiles,15 - 24,304,209,95,09
San Marcos,Todos los estados civiles,25 - 44,798,564,234,09
San Marcos,Todos los estados civiles,45 - 64,919,548,371,09
San Marcos,Todos los estados civiles,65 y más,1816,961,855,09
San Marcos,Todos los estados civiles,Ignorado,29,16,13,09
San Marcos,Todos los estados civiles,Todas las edades,3078,1791,1287,09
San Marcos,Soltero(a),Menos de 15 años,794,425,369,09
San Marcos,Soltero(a),15 - 24,271,190,81,09
San Marcos,Soltero(a),25 - 44,515,366,149,09
San Marcos,Soltero(a),45 - 64,470,299,171,09
San Marcos,Soltero(a),65 y más,1008,502,506,09
San Marcos,Soltero(a),Ignorado,20,9,11,09
San Marcos,Casado(a),Todas las edades,1461,850,611,09
San Marcos,Casado(a),Menos de 15 años,1,0,1,09
San Marcos,Casado(a),15 - 24,27,15,12,09
San Marcos,Casado(a),25 - 44,253,178,75,09
San Marcos,Casado(a),45 - 64,411,225,186,09
San Marcos,Casado(a),65 y más,765,429,336,09
San Marcos,Casado(a),Ignorado,4,3,1,09
San Marcos,Unido(a),Todas las edades,83,54,29,09
San Marcos,Unido(a),Menos de 15 años,1,0,1,09
San Marcos,Unido(a),15 - 24,0,0,0,09
San Marcos,Unido(a),25 - 44,20,12,8,09
San Marcos,Unido(a),45 - 64,29,17,12,09
San Marcos,Unido(a),65 y más,33,25,8,09
San Marcos,Unido(a),Ignorado,0,0,0,09
San Marcos,Ignorado(a),Todas las edades,165,89,76,09
San Marcos,Ignorado(a),Menos de 15 años,125,61,64,09
San Marcos,Ignorado(a),15 - 24,6,4,2,09
San Marcos,Ignorado(a),25 - 44,10,8,2,09
San Marcos,Ignorado(a),45 - 64,9,7,2,09
San Marcos,Ignorado(a),65 y más,10,5,5,09
San Marcos,Ignorado(a),Ignorado,5,4,1,09
Huehuetenango,Todos los estados civiles,Todas las edades,3934,2215,1719,09
Huehuetenango,Todos los estados civiles,Menos de 15 años,854,489,365,09
Huehuetenango,Todos los estados civiles,15 - 24,273,154,119,09
Huehuetenango,Todos los estados civiles,25 - 44,581,349,232,09
Huehuetenango,Todos los estados civiles,45 - 64,690,389,301,09
Huehuetenango,Todos los estados civiles,65 y más,1521,825,696,09
Huehuetenango,Todos los estados civiles,Ignorado,15,9,6,09
Huehuetenango,Todos los estados civiles,Todas las edades,2570,1434,1136,09
Huehuetenango,Soltero(a),Menos de 15 años,715,412,303,09
Huehuetenango,Soltero(a),15 - 24,245,140,105,09
Huehuetenango,Soltero(a),25 - 44,340,206,134,09
Huehuetenango,Soltero(a),45 - 64,370,209,161,09
Huehuetenango,Soltero(a),65 y más,889,460,429,09
Huehuetenango,Soltero(a),Ignorado,11,7,4,09
Huehuetenango,Casado(a),Todas las edades,1173,684,489,09
Huehuetenango,Casado(a),Menos de 15 años,1,1,0,09
Huehuetenango,Casado(a),15 - 24,22,11,11,09
Huehuetenango,Casado(a),25 - 44,236,140,96,09
Huehuetenango,Casado(a),45 - 64,317,178,139,09
Huehuetenango,Casado(a),65 y más,596,353,243,09
Huehuetenango,Casado(a),Ignorado,1,1,0,09
Huehuetenango,Unido(a),Todas las edades,32,15,17,09
Huehuetenango,Unido(a),Menos de 15 años,0,0,0,09
Huehuetenango,Unido(a),15 - 24,1,1,0,09
Huehuetenango,Unido(a),25 - 44,0,0,0,09
Huehuetenango,Unido(a),45 - 64,3,2,1,09
Huehuetenango,Unido(a),65 y más,28,12,16,09
Huehuetenango,Unido(a),Ignorado,0,0,0,09
Huehuetenango,Ignorado(a),Todas las edades,159,82,77,09
Huehuetenango,Ignorado(a),Menos de 15 años,138,76,62,09
Huehuetenango,Ignorado(a),15 - 24,5,2,3,09
Huehuetenango,Ignorado(a),25 - 44,5,3,2,09
Huehuetenango,Ignorado(a),45 - 64,0,0,0,09
Huehuetenango,Ignorado(a),65 y más,8,0,8,09
Huehuetenango,Ignorado(a),Ignorado,3,1,2,09
Quiché,Todos los estados civiles,Todas las edades,3826,2103,1723,09
Quiché,Todos los estados civiles,Menos de 15 años,969,506,463,09
Quiché,Todos los estados civiles,15 - 24,246,153,93,09
Quiché,Todos los estados civiles,25 - 44,598,400,198,09
Quiché,Todos los estados civiles,45 - 64,714,430,284,09
Quiché,Todos los estados civiles,65 y más,1259,592,667,09
Quiché,Todos los estados civiles,Ignorado,40,22,18,09
Quiché,Todos los estados civiles,Todas las edades,2741,1436,1305,09
Quiché,Soltero(a),Menos de 15 años,908,471,437,09
Quiché,Soltero(a),15 - 24,212,137,75,09
Quiché,Soltero(a),25 - 44,347,232,115,09
Quiché,Soltero(a),45 - 64,371,210,161,09
Quiché,Soltero(a),65 y más,868,367,501,09
Quiché,Soltero(a),Ignorado,35,19,16,09
Quiché,Casado(a),Todas las edades,980,616,364,09
Quiché,Casado(a),Menos de 15 años,2,2,0,09
Quiché,Casado(a),15 - 24,29,13,16,09
Quiché,Casado(a),25 - 44,247,167,80,09
Quiché,Casado(a),45 - 64,336,219,117,09
Quiché,Casado(a),65 y más,362,212,150,09
Quiché,Casado(a),Ignorado,4,3,1,09
Quiché,Unido(a),Todas las edades,28,13,15,09
Quiché,Unido(a),Menos de 15 años,0,0,0,09
Quiché,Unido(a),15 - 24,1,0,1,09
Quiché,Unido(a),25 - 44,1,0,1,09
Quiché,Unido(a),45 - 64,5,1,4,09
Quiché,Unido(a),65 y más,21,12,9,09
Quiché,Unido(a),Ignorado,0,0,0,09
Quiché,Ignorado(a),Todas las edades,77,38,39,09
Quiché,Ignorado(a),Menos de 15 años,59,33,26,09
Quiché,Ignorado(a),15 - 24,4,3,1,09
Quiché,Ignorado(a),25 - 44,3,1,2,09
Quiché,Ignorado(a),45 - 64,2,0,2,09
Quiché,Ignorado(a),65 y más,8,1,7,09
Quiché,Ignorado(a),Ignorado,1,0,1,09
Baja Verapaz,Todos los estados civiles,Todas las edades,1238,717,521,09
Baja Verapaz,Todos los estados civiles,Menos de 15 años,213,108,105,09
Baja Verapaz,Todos los estados civiles,15 - 24,90,61,29,09
Baja Verapaz,Todos los estados civiles,25 - 44,208,151,57,09
Baja Verapaz,Todos los estados civiles,45 - 64,204,125,79,09
Baja Verapaz,Todos los estados civiles,65 y más,518,268,250,09
Baja Verapaz,Todos los estados civiles,Ignorado,5,4,1,09
Baja Verapaz,Todos los estados civiles,Todas las edades,667,358,309,09
Baja Verapaz,Soltero(a),Menos de 15 años,193,97,96,09
Baja Verapaz,Soltero(a),15 - 24,74,49,25,09
Baja Verapaz,Soltero(a),25 - 44,97,72,25,09
Baja Verapaz,Soltero(a),45 - 64,76,43,33,09
Baja Verapaz,Soltero(a),65 y más,223,94,129,09
Baja Verapaz,Soltero(a),Ignorado,4,3,1,09
Baja Verapaz,Casado(a),Todas las edades,531,338,193,09
Baja Verapaz,Casado(a),Menos de 15 años,0,0,0,09
Baja Verapaz,Casado(a),15 - 24,16,12,4,09
Baja Verapaz,Casado(a),25 - 44,111,79,32,09
Baja Verapaz,Casado(a),45 - 64,126,81,45,09
Baja Verapaz,Casado(a),65 y más,278,166,112,09
Baja Verapaz,Casado(a),Ignorado,0,0,0,09
Baja Verapaz,Unido(a),Todas las edades,19,9,10,09
Baja Verapaz,Unido(a),Menos de 15 años,0,0,0,09
Baja Verapaz,Unido(a),15 - 24,0,0,0,09
Baja Verapaz,Unido(a),25 - 44,0,0,0,09
Baja Verapaz,Unido(a),45 - 64,2,1,1,09
Baja Verapaz,Unido(a),65 y más,17,8,9,09
Baja Verapaz,Unido(a),Ignorado,0,0,0,09
Baja Verapaz,Ignorado(a),Todas las edades,21,12,9,09
Baja Verapaz,Ignorado(a),Menos de 15 años,20,11,9,09
Baja Verapaz,Ignorado(a),15 - 24,0,0,0,09
Baja Verapaz,Ignorado(a),25 - 44,0,0,0,09
Baja Verapaz,Ignorado(a),45 - 64,0,0,0,09
Baja Verapaz,Ignorado(a),65 y más,0,0,0,09
Baja Verapaz,Ignorado(a),Ignorado,1,1,0,09
Alta Verapaz,Todos los estados civiles,Todas las edades,4240,2267,1973,09
Alta Verapaz,Todos los estados civiles,Menos de 15 años,1236,644,592,09
Alta Verapaz,Todos los estados civiles,15 - 24,318,198,120,09
Alta Verapaz,Todos los estados civiles,25 - 44,553,341,212,09
Alta Verapaz,Todos los estados civiles,45 - 64,698,368,330,09
Alta Verapaz,Todos los estados civiles,65 y más,1396,698,698,09
Alta Verapaz,Todos los estados civiles,Ignorado,39,18,21,09
Alta Verapaz,Todos los estados civiles,Todas las edades,2483,1271,1212,09
Alta Verapaz,Soltero(a),Menos de 15 años,1128,584,544,09
Alta Verapaz,Soltero(a),15 - 24,279,181,98,09
Alta Verapaz,Soltero(a),25 - 44,283,192,91,09
Alta Verapaz,Soltero(a),45 - 64,222,103,119,09
Alta Verapaz,Soltero(a),65 y más,538,195,343,09
Alta Verapaz,Soltero(a),Ignorado,33,16,17,09
Alta Verapaz,Casado(a),Todas las edades,1620,918,702,09
Alta Verapaz,Casado(a),Menos de 15 años,0,0,0,09
Alta Verapaz,Casado(a),15 - 24,35,14,21,09
Alta Verapaz,Casado(a),25 - 44,264,143,121,09
Alta Verapaz,Casado(a),45 - 64,471,262,209,09
Alta Verapaz,Casado(a),65 y más,848,499,349,09
Alta Verapaz,Casado(a),Ignorado,2,0,2,09
Alta Verapaz,Unido(a),Todas las edades,9,5,4,09
Alta Verapaz,Unido(a),Menos de 15 años,0,0,0,09
Alta Verapaz,Unido(a),15 - 24,0,0,0,09
Alta Verapaz,Unido(a),25 - 44,1,1,0,09
Alta Verapaz,Unido(a),45 - 64,4,2,2,09
Alta Verapaz,Unido(a),65 y más,4,2,2,09
Alta Verapaz,Unido(a),Ignorado,0,0,0,09
Alta Verapaz,Ignorado(a),Todas las edades,128,73,55,09
Alta Verapaz,Ignorado(a),Menos de 15 años,108,60,48,09
Alta Verapaz,Ignorado(a),15 - 24,4,3,1,09
Alta Verapaz,Ignorado(a),25 - 44,5,5,0,09
Alta Verapaz,Ignorado(a),45 - 64,1,1,0,09
Alta Verapaz,Ignorado(a),65 y más,6,2,4,09
Alta Verapaz,Ignorado(a),Ignorado,4,2,2,09
Petén,Todos los estados civiles,Todas las edades,1824,1144,680,09
Petén,Todos los estados civiles,Menos de 15 años,266,125,141,09
Petén,Todos los estados civiles,15 - 24,224,173,51,09
Petén,Todos los estados civiles,25 - 44,425,319,106,09
Petén,Todos los estados civiles,45 - 64,347,205,142,09
Petén,Todos los estados civiles,65 y más,545,308,237,09
Petén,Todos los estados civiles,Ignorado,17,14,3,09
Petén,Todos los estados civiles,Todas las edades,1122,720,402,09
Petén,Soltero(a),Menos de 15 años,245,112,133,09
Petén,Soltero(a),15 - 24,208,164,44,09
Petén,Soltero(a),25 - 44,280,224,56,09
Petén,Soltero(a),45 - 64,143,86,57,09
Petén,Soltero(a),65 y más,236,127,109,09
Petén,Soltero(a),Ignorado,10,7,3,09
Petén,Casado(a),Todas las edades,589,357,232,09
Petén,Casado(a),Menos de 15 años,0,0,0,09
Petén,Casado(a),15 - 24,15,9,6,09
Petén,Casado(a),25 - 44,117,76,41,09
Petén,Casado(a),45 - 64,183,109,74,09
Petén,Casado(a),65 y más,274,163,111,09
Petén,Casado(a),Ignorado,0,0,0,09
Petén,Unido(a),Todas las edades,75,39,36,09
Petén,Unido(a),Menos de 15 años,0,0,0,09
Petén,Unido(a),15 - 24,1,0,1,09
Petén,Unido(a),25 - 44,23,14,9,09
Petén,Unido(a),45 - 64,20,9,11,09
Petén,Unido(a),65 y más,31,16,15,09
Petén,Unido(a),Ignorado,0,0,0,09
Petén,Ignorado(a),Todas las edades,38,28,10,09
Petén,Ignorado(a),Menos de 15 años,21,13,8,09
Petén,Ignorado(a),15 - 24,0,0,0,09
Petén,Ignorado(a),25 - 44,5,5,0,09
Petén,Ignorado(a),45 - 64,1,1,0,09
Petén,Ignorado(a),65 y más,4,2,2,09
Petén,Ignorado(a),Ignorado,7,7,0,09
Izabal,Todos los estados civiles,Todas las edades,1873,1114,759,09
Izabal,Todos los estados civiles,Menos de 15 años,277,154,123,09
Izabal,Todos los estados civiles,15 - 24,148,115,33,09
Izabal,Todos los estados civiles,25 - 44,364,273,91,09
Izabal,Todos los estados civiles,45 - 64,402,213,189,09
Izabal,Todos los estados civiles,65 y más,677,357,320,09
Izabal,Todos los estados civiles,Ignorado,5,2,3,09
Izabal,Todos los estados civiles,Todas las edades,1213,730,483,09
Izabal,Soltero(a),Menos de 15 años,244,131,113,09
Izabal,Soltero(a),15 - 24,134,107,27,09
Izabal,Soltero(a),25 - 44,263,204,59,09
Izabal,Soltero(a),45 - 64,196,106,90,09
Izabal,Soltero(a),65 y más,372,181,191,09
Izabal,Soltero(a),Ignorado,4,1,3,09
Izabal,Casado(a),Todas las edades,589,343,246,09
Izabal,Casado(a),Menos de 15 años,1,1,0,09
Izabal,Casado(a),15 - 24,11,7,4,09
Izabal,Casado(a),25 - 44,97,66,31,09
Izabal,Casado(a),45 - 64,196,102,94,09
Izabal,Casado(a),65 y más,284,167,117,09
Izabal,Casado(a),Ignorado,0,0,0,09
Izabal,Unido(a),Todas las edades,27,10,17,09
Izabal,Unido(a),Menos de 15 años,0,0,0,09
Izabal,Unido(a),15 - 24,0,0,0,09
Izabal,Unido(a),25 - 44,1,0,1,09
Izabal,Unido(a),45 - 64,8,3,5,09
Izabal,Unido(a),65 y más,18,7,11,09
Izabal,Unido(a),Ignorado,0,0,0,09
Izabal,Ignorado(a),Todas las edades,44,31,13,09
Izabal,Ignorado(a),Menos de 15 años,32,22,10,09
Izabal,Ignorado(a),15 - 24,3,1,2,09
Izabal,Ignorado(a),25 - 44,3,3,0,09
Izabal,Ignorado(a),45 - 64,2,2,0,09
Izabal,Ignorado(a),65 y más,3,2,1,09
Izabal,Ignorado(a),Ignorado,1,1,0,09
Zacapa,Todos los estados civiles,Todas las edades,1294,746,548,09
Zacapa,Todos los estados civiles,Menos de 15 años,166,67,99,09
Zacapa,Todos los estados civiles,15 - 24,87,63,24,09
Zacapa,Todos los estados civiles,25 - 44,200,144,56,09
Zacapa,Todos los estados civiles,45 - 64,258,134,124,09
Zacapa,Todos los estados civiles,65 y más,577,337,240,09
Zacapa,Todos los estados civiles,Ignorado,6,1,5,09
Zacapa,Todos los estados civiles,Todas las edades,779,433,346,09
Zacapa,Soltero(a),Menos de 15 años,135,55,80,09
Zacapa,Soltero(a),15 - 24,81,59,22,09
Zacapa,Soltero(a),25 - 44,131,97,34,09
Zacapa,Soltero(a),45 - 64,132,68,64,09
Zacapa,Soltero(a),65 y más,296,153,143,09
Zacapa,Soltero(a),Ignorado,4,1,3,09
Zacapa,Casado(a),Todas las edades,472,295,177,09
Zacapa,Casado(a),Menos de 15 años,0,0,0,09
Zacapa,Casado(a),15 - 24,5,4,1,09
Zacapa,Casado(a),25 - 44,66,44,22,09
Zacapa,Casado(a),45 - 64,123,64,59,09
Zacapa,Casado(a),65 y más,277,183,94,09
Zacapa,Casado(a),Ignorado,1,0,1,09
Zacapa,Unido(a),Todas las edades,4,1,3,09
Zacapa,Unido(a),Menos de 15 años,0,0,0,09
Zacapa,Unido(a),15 - 24,0,0,0,09
Zacapa,Unido(a),25 - 44,0,0,0,09
Zacapa,Unido(a),45 - 64,1,0,1,09
Zacapa,Unido(a),65 y más,3,1,2,09
Zacapa,Unido(a),Ignorado,0,0,0,09
Zacapa,Ignorado(a),Todas las edades,39,17,22,09
Zacapa,Ignorado(a),Menos de 15 años,31,12,19,09
Zacapa,Ignorado(a),15 - 24,1,0,1,09
Zacapa,Ignorado(a),25 - 44,3,3,0,09
Zacapa,Ignorado(a),45 - 64,2,2,0,09
Zacapa,Ignorado(a),65 y más,1,0,1,09
Zacapa,Ignorado(a),Ignorado,1,0,1,09
Chiquimula,Todos los estados civiles,Todas las edades,1985,1165,820,09
Chiquimula,Todos los estados civiles,Menos de 15 años,316,168,148,09
Chiquimula,Todos los estados civiles,15 - 24,138,110,28,09
Chiquimula,Todos los estados civiles,25 - 44,311,224,87,09
Chiquimula,Todos los estados civiles,45 - 64,427,254,173,09
Chiquimula,Todos los estados civiles,65 y más,786,405,381,09
Chiquimula,Todos los estados civiles,Ignorado,7,4,3,09
Chiquimula,Todos los estados civiles,Todas las edades,1261,755,506,09
Chiquimula,Soltero(a),Menos de 15 años,268,144,124,09
Chiquimula,Soltero(a),15 - 24,129,107,22,09
Chiquimula,Soltero(a),25 - 44,209,156,53,09
Chiquimula,Soltero(a),45 - 64,224,135,89,09
Chiquimula,Soltero(a),65 y más,426,211,215,09
Chiquimula,Soltero(a),Ignorado,5,2,3,09
Chiquimula,Casado(a),Todas las edades,640,369,271,09
Chiquimula,Casado(a),Menos de 15 años,1,1,0,09
Chiquimula,Casado(a),15 - 24,8,3,5,09
Chiquimula,Casado(a),25 - 44,100,66,34,09
Chiquimula,Casado(a),45 - 64,198,115,83,09
Chiquimula,Casado(a),65 y más,331,182,149,09
Chiquimula,Casado(a),Ignorado,2,2,0,09
Chiquimula,Unido(a),Todas las edades,17,9,8,09
Chiquimula,Unido(a),Menos de 15 años,0,0,0,09
Chiquimula,Unido(a),15 - 24,0,0,0,09
Chiquimula,Unido(a),25 - 44,2,2,0,09
Chiquimula,Unido(a),45 - 64,0,0,0,09
Chiquimula,Unido(a),65 y más,15,7,8,09
Chiquimula,Unido(a),Ignorado,0,0,0,09
Chiquimula,Ignorado(a),Todas las edades,67,32,35,09
Chiquimula,Ignorado(a),Menos de 15 años,47,23,24,09
Chiquimula,Ignorado(a),15 - 24,1,0,1,09
Chiquimula,Ignorado(a),25 - 44,0,0,0,09
Chiquimula,Ignorado(a),45 - 64,5,4,1,09
Chiquimula,Ignorado(a),65 y más,14,5,9,09
Chiquimula,Ignorado(a),Ignorado,0,0,0,09
Jalapa,Todos los estados civiles,Todas las edades,1584,911,673,09
Jalapa,Todos los estados civiles,Menos de 15 años,290,146,144,09
Jalapa,Todos los estados civiles,15 - 24,132,95,37,09
Jalapa,Todos los estados civiles,25 - 44,270,195,75,09
Jalapa,Todos los estados civiles,45 - 64,307,164,143,09
Jalapa,Todos los estados civiles,65 y más,581,311,270,09
Jalapa,Todos los estados civiles,Ignorado,4,0,4,09
Jalapa,Todos los estados civiles,Todas las edades,783,454,329,09
Jalapa,Soltero(a),Menos de 15 años,175,91,84,09
Jalapa,Soltero(a),15 - 24,116,83,33,09
Jalapa,Soltero(a),25 - 44,159,120,39,09
Jalapa,Soltero(a),45 - 64,90,52,38,09
Jalapa,Soltero(a),65 y más,241,108,133,09
Jalapa,Soltero(a),Ignorado,2,0,2,09
Jalapa,Casado(a),Todas las edades,665,393,272,09
Jalapa,Casado(a),Menos de 15 años,0,0,0,09
Jalapa,Casado(a),15 - 24,11,9,2,09
Jalapa,Casado(a),25 - 44,106,72,34,09
Jalapa,Casado(a),45 - 64,214,112,102,09
Jalapa,Casado(a),65 y más,334,200,134,09
Jalapa,Casado(a),Ignorado,0,0,0,09
Jalapa,Unido(a),Todas las edades,7,2,5,09
Jalapa,Unido(a),Menos de 15 años,0,0,0,09
Jalapa,Unido(a),15 - 24,0,0,0,09
Jalapa,Unido(a),25 - 44,1,0,1,09
Jalapa,Unido(a),45 - 64,2,0,2,09
Jalapa,Unido(a),65 y más,4,2,2,09
Jalapa,Unido(a),Ignorado,0,0,0,09
Jalapa,Ignorado(a),Todas las edades,129,62,67,09
Jalapa,Ignorado(a),Menos de 15 años,115,55,60,09
Jalapa,Ignorado(a),15 - 24,5,3,2,09
Jalapa,Ignorado(a),25 - 44,4,3,1,09
Jalapa,Ignorado(a),45 - 64,1,0,1,09
Jalapa,Ignorado(a),65 y más,2,1,1,09
Jalapa,Ignorado(a),Ignorado,2,0,2,09
Jutiapa,Todos los estados civiles,Todas las edades,2499,1500,999,09
Jutiapa,Todos los estados civiles,Menos de 15 años,249,139,110,09
Jutiapa,Todos los estados civiles,15 - 24,175,127,48,09
Jutiapa,Todos los estados civiles,25 - 44,423,312,111,09
Jutiapa,Todos los estados civiles,45 - 64,511,292,219,09
Jutiapa,Todos los estados civiles,65 y más,1134,627,507,09
Jutiapa,Todos los estados civiles,Ignorado,7,3,4,09
Jutiapa,Todos los estados civiles,Todas las edades,1424,829,595,09
Jutiapa,Soltero(a),Menos de 15 años,224,127,97,09
Jutiapa,Soltero(a),15 - 24,165,120,45,09
Jutiapa,Soltero(a),25 - 44,279,202,77,09
Jutiapa,Soltero(a),45 - 64,212,116,96,09
Jutiapa,Soltero(a),65 y más,539,262,277,09
Jutiapa,Soltero(a),Ignorado,5,2,3,09
Jutiapa,Casado(a),Todas las edades,1032,651,381,09
Jutiapa,Casado(a),Menos de 15 años,0,0,0,09
Jutiapa,Casado(a),15 - 24,10,7,3,09
Jutiapa,Casado(a),25 - 44,143,109,34,09
Jutiapa,Casado(a),45 - 64,295,174,121,09
Jutiapa,Casado(a),65 y más,584,361,223,09
Jutiapa,Casado(a),Ignorado,0,0,0,09
Jutiapa,Unido(a),Todas las edades,10,4,6,09
Jutiapa,Unido(a),Menos de 15 años,0,0,0,09
Jutiapa,Unido(a),15 - 24,0,0,0,09
Jutiapa,Unido(a),25 - 44,1,1,0,09
Jutiapa,Unido(a),45 - 64,4,2,2,09
Jutiapa,Unido(a),65 y más,5,1,4,09
Jutiapa,Unido(a),Ignorado,0,0,0,09
Jutiapa,Ignorado(a),Todas las edades,33,16,17,09
Jutiapa,Ignorado(a),Menos de 15 años,25,12,13,09
Jutiapa,Ignorado(a),15 - 24,0,0,0,09
Jutiapa,Ignorado(a),25 - 44,0,0,0,09
Jutiapa,Ignorado(a),45 - 64,0,0,0,09
Jutiapa,Ignorado(a),65 y más,6,3,3,09
Jutiapa,Ignorado(a),Ignorado,2,1,1,09
Extranjero,Todos los estados civiles,Todas las edades,153,105,48,09
Extranjero,Todos los estados civiles,Menos de 15 años,10,2,8,09
Extranjero,Todos los estados civiles,15 - 24,21,16,5,09
Extranjero,Todos los estados civiles,25 - 44,52,38,14,09
Extranjero,Todos los estados civiles,45 - 64,43,33,10,09
Extranjero,Todos los estados civiles,65 y más,24,13,11,09
Extranjero,Todos los estados civiles,Ignorado,3,3,0,09
Extranjero,Todos los estados civiles,Todas las edades,101,68,33,09
Extranjero,Soltero(a),Menos de 15 años,6,2,4,09
Extranjero,Soltero(a),15 - 24,19,15,4,09
Extranjero,Soltero(a),25 - 44,36,27,9,09
Extranjero,Soltero(a),45 - 64,22,16,6,09
Extranjero,Soltero(a),65 y más,15,5,10,09
Extranjero,Soltero(a),Ignorado,3,3,0,09
Extranjero,Casado(a),Todas las edades,31,23,8,09
Extranjero,Casado(a),Menos de 15 años,0,0,0,09
Extranjero,Casado(a),15 - 24,1,1,0,09
Extranjero,Casado(a),25 - 44,8,5,3,09
Extranjero,Casado(a),45 - 64,17,13,4,09
Extranjero,Casado(a),65 y más,5,4,1,09
Extranjero,Casado(a),Ignorado,0,0,0,09
Extranjero,Unido(a),Todas las edades,1,1,0,09
Extranjero,Unido(a),Menos de 15 años,0,0,0,09
Extranjero,Unido(a),15 - 24,0,0,0,09
Extranjero,Unido(a),25 - 44,0,0,0,09
Extranjero,Unido(a),45 - 64,0,0,0,09
Extranjero,Unido(a),65 y más,1,1,0,09
Extranjero,Unido(a),Ignorado,0,0,0,09
Extranjero,Ignorado(a),Todas las edades,20,13,7,09
Extranjero,Ignorado(a),Menos de 15 años,4,0,4,09
Extranjero,Ignorado(a),15 - 24,1,0,1,09
Extranjero,Ignorado(a),25 - 44,8,6,2,09
Extranjero,Ignorado(a),45 - 64,4,4,0,09
Extranjero,Ignorado(a),65 y más,3,3,0,09
Extranjero,Ignorado(a),Ignorado,0,0,0,09
Ignorado,Todos los estados civiles,Todas las edades,1976,1299,677,09
Ignorado,Todos los estados civiles,Menos de 15 años,1208,673,535,09
Ignorado,Todos los estados civiles,15 - 24,152,113,39,09
Ignorado,Todos los estados civiles,25 - 44,311,273,38,09
Ignorado,Todos los estados civiles,45 - 64,119,107,12,09
Ignorado,Todos los estados civiles,65 y más,68,56,12,09
Ignorado,Todos los estados civiles,Ignorado,118,77,41,09
Ignorado,Todos los estados civiles,Todas las edades,1485,876,609,09
Ignorado,Soltero(a),Menos de 15 años,1195,662,533,09
Ignorado,Soltero(a),15 - 24,95,73,22,09
Ignorado,Soltero(a),25 - 44,66,58,8,09
Ignorado,Soltero(a),45 - 64,23,19,4,09
Ignorado,Soltero(a),65 y más,22,14,8,09
Ignorado,Soltero(a),Ignorado,84,50,34,09
Ignorado,Casado(a),Todas las edades,12,9,3,09
Ignorado,Casado(a),Menos de 15 años,0,0,0,09
Ignorado,Casado(a),15 - 24,1,1,0,09
Ignorado,Casado(a),25 - 44,4,2,2,09
Ignorado,Casado(a),45 - 64,5,4,1,09
Ignorado,Casado(a),65 y más,2,2,0,09
Ignorado,Casado(a),Ignorado,0,0,0,09
Ignorado,Unido(a),Todas las edades,0,0,0,09
Ignorado,Unido(a),Menos de 15 años,0,0,0,09
Ignorado,Unido(a),15 - 24,0,0,0,09
Ignorado,Unido(a),25 - 44,0,0,0,09
Ignorado,Unido(a),45 - 64,0,0,0,09
Ignorado,Unido(a),65 y más,0,0,0,09
Ignorado,Unido(a),Ignorado,0,0,0,09
Ignorado,Ignorado(a),Todas las edades,479,414,65,09
Ignorado,Ignorado(a),Menos de 15 años,13,11,2,09
Ignorado,Ignorado(a),15 - 24,56,39,17,09
Ignorado,Ignorado(a),25 - 44,241,213,28,09
Ignorado,Ignorado(a),45 - 64,91,84,7,09
Ignorado,Ignorado(a),65 y más,44,40,4,09
Ignorado,Ignorado(a),Ignorado,34,27,7,09
Todos los departamentos,Todos los estados civiles,Todas las edades,72748,41829,30919,10
Todos los departamentos,Todos los estados civiles,Menos de 15 años,12278,6878,5400,10
Todos los departamentos,Todos los estados civiles,15 - 24,5159,3778,1381,10
Todos los departamentos,Todos los estados civiles,25 - 44,11210,7988,3222,10
Todos los departamentos,Todos los estados civiles,45 - 64,14049,7944,6105,10
Todos los departamentos,Todos los estados civiles,65 y más,28899,14471,14428,10
Todos los departamentos,Todos los estados civiles,Ignorado,1153,770,383,10
Todos los departamentos,Todos los estados civiles,Todas las edades,43693,24993,18700,10
Todos los departamentos,Soltero(a),Menos de 15 años,11329,6327,5002,10
Todos los departamentos,Soltero(a),15 - 24,4682,3490,1192,10
Todos los departamentos,Soltero(a),25 - 44,6875,5023,1852,10
Todos los departamentos,Soltero(a),45 - 64,6331,3519,2812,10
Todos los departamentos,Soltero(a),65 y más,13800,6200,7600,10
Todos los departamentos,Soltero(a),Ignorado,676,434,242,10
Todos los departamentos,Todos los estados civiles,Todas las edades,26581,15271,11310,10
Todos los departamentos,Casado(a),Menos de 15 años,5,4,1,10
Todos los departamentos,Casado(a),15 - 24,396,232,164,10
Todos los departamentos,Casado(a),25 - 44,4055,2735,1320,10
Todos los departamentos,Casado(a),45 - 64,7474,4263,3211,10
Todos los departamentos,Casado(a),65 y más,14530,7963,6567,10
Todos los departamentos,Casado(a),Ignorado,121,74,47,10
Todos los departamentos,Todos los estados civiles,Todas las edades,596,315,281,10
Todos los departamentos,Unido(a),Menos de 15 años,0,0,0,10
Todos los departamentos,Unido(a),15 - 24,5,1,4,10
Todos los departamentos,Unido(a),25 - 44,41,27,14,10
Todos los departamentos,Unido(a),45 - 64,119,63,56,10
Todos los departamentos,Unido(a),65 y más,420,222,198,10
Todos los departamentos,Unido(a),Ignorado,11,2,9,10
Todos los departamentos,Todos los estados civiles,Todas las edades,1878,1250,628,10
Todos los departamentos,Ignorado(a),Menos de 15 años,944,547,397,10
Todos los departamentos,Ignorado(a),15 - 24,76,55,21,10
Todos los departamentos,Ignorado(a),25 - 44,239,203,36,10
Todos los departamentos,Ignorado(a),45 - 64,125,99,26,10
Todos los departamentos,Ignorado(a),65 y más,149,86,63,10
Todos los departamentos,Ignorado(a),Ignorado,345,260,85,10
Guatemala,Todos los estados civiles,Todas las edades,18187,10367,7820,10
Guatemala,Todos los estados civiles,Menos de 15 años,2599,1496,1103,10
Guatemala,Todos los estados civiles,15 - 24,1556,1281,275,10
Guatemala,Todos los estados civiles,25 - 44,2626,1964,662,10
Guatemala,Todos los estados civiles,45 - 64,3599,2065,1534,10
Guatemala,Todos los estados civiles,65 y más,7711,3505,4206,10
Guatemala,Todos los estados civiles,Ignorado,96,56,40,10
Guatemala,Todos los estados civiles,Todas las edades,10296,5973,4323,10
Guatemala,Soltero(a),Menos de 15 años,2292,1327,965,10
Guatemala,Soltero(a),15 - 24,1445,1200,245,10
Guatemala,Soltero(a),25 - 44,1708,1298,410,10
Guatemala,Soltero(a),45 - 64,1621,910,711,10
Guatemala,Soltero(a),65 y más,3168,1205,1963,10
Guatemala,Soltero(a),Ignorado,62,33,29,10
Guatemala,Todos los estados civiles,Todas las edades,7401,4113,3288,10
Guatemala,Casado(a),Menos de 15 años,0,0,0,10
Guatemala,Casado(a),15 - 24,82,58,24,10
Guatemala,Casado(a),25 - 44,884,639,245,10
Guatemala,Casado(a),45 - 64,1955,1146,809,10
Guatemala,Casado(a),65 y más,4474,2268,2206,10
Guatemala,Casado(a),Ignorado,6,2,4,10
Guatemala,Todos los estados civiles,Todas las edades,45,18,27,10
Guatemala,Unido(a),Menos de 15 años,0,0,0,10
Guatemala,Unido(a),15 - 24,0,0,0,10
Guatemala,Unido(a),25 - 44,0,0,0,10
Guatemala,Unido(a),45 - 64,4,1,3,10
Guatemala,Unido(a),65 y más,41,17,24,10
Guatemala,Unido(a),Ignorado,0,0,0,10
Guatemala,Todos los estados civiles,Todas las edades,445,263,182,10
Guatemala,Ignorado(a),Menos de 15 años,307,169,138,10
Guatemala,Ignorado(a),15 - 24,29,23,6,10
Guatemala,Ignorado(a),25 - 44,34,27,7,10
Guatemala,Ignorado(a),45 - 64,19,8,11,10
Guatemala,Ignorado(a),65 y más,28,15,13,10
Guatemala,Ignorado(a),Ignorado,28,21,7,10
El Progreso,Todos los estados civiles,Todas las edades,993,573,420,10
El Progreso,Todos los estados civiles,Menos de 15 años,109,61,48,10
El Progreso,Todos los estados civiles,15 - 24,69,54,15,10
El Progreso,Todos los estados civiles,25 - 44,136,92,44,10
El Progreso,Todos los estados civiles,45 - 64,188,111,77,10
El Progreso,Todos los estados civiles,65 y más,485,250,235,10
El Progreso,Todos los estados civiles,Ignorado,6,5,1,10
El Progreso,Todos los estados civiles,Todas las edades,586,350,236,10
El Progreso,Soltero(a),Menos de 15 años,102,57,45,10
El Progreso,Soltero(a),15 - 24,59,47,12,10
El Progreso,Soltero(a),25 - 44,90,65,25,10
El Progreso,Soltero(a),45 - 64,110,67,43,10
El Progreso,Soltero(a),65 y más,222,112,110,10
El Progreso,Soltero(a),Ignorado,3,2,1,10
El Progreso,Todos los estados civiles,Todas las edades,383,211,172,10
El Progreso,Casado(a),Menos de 15 años,0,0,0,10
El Progreso,Casado(a),15 - 24,9,6,3,10
El Progreso,Casado(a),25 - 44,46,27,19,10
El Progreso,Casado(a),45 - 64,78,44,34,10
El Progreso,Casado(a),65 y más,249,133,116,10
El Progreso,Casado(a),Ignorado,1,1,0,10
El Progreso,Todos los estados civiles,Todas las edades,13,4,9,10
El Progreso,Unido(a),Menos de 15 años,0,0,0,10
El Progreso,Unido(a),15 - 24,0,0,0,10
El Progreso,Unido(a),25 - 44,0,0,0,10
El Progreso,Unido(a),45 - 64,0,0,0,10
El Progreso,Unido(a),65 y más,13,4,9,10
El Progreso,Unido(a),Ignorado,0,0,0,10
El Progreso,Todos los estados civiles,Todas las edades,11,8,3,10
El Progreso,Ignorado(a),Menos de 15 años,7,4,3,10
El Progreso,Ignorado(a),15 - 24,1,1,0,10
El Progreso,Ignorado(a),25 - 44,0,0,0,10
El Progreso,Ignorado(a),45 - 64,0,0,0,10
El Progreso,Ignorado(a),65 y más,1,1,0,10
El Progreso,Ignorado(a),Ignorado,2,2,0,10
Sacatepéquez,Todos los estados civiles,Todas las edades,1535,833,702,10
Sacatepéquez,Todos los estados civiles,Menos de 15 años,189,108,81,10
Sacatepéquez,Todos los estados civiles,15 - 24,85,60,25,10
Sacatepéquez,Todos los estados civiles,25 - 44,211,152,59,10
Sacatepéquez,Todos los estados civiles,45 - 64,297,146,151,10
Sacatepéquez,Todos los estados civiles,65 y más,743,360,383,10
Sacatepéquez,Todos los estados civiles,Ignorado,10,7,3,10
Sacatepéquez,Todos los estados civiles,Todas las edades,744,417,327,10
Sacatepéquez,Soltero(a),Menos de 15 años,183,105,78,10
Sacatepéquez,Soltero(a),15 - 24,75,55,20,10
Sacatepéquez,Soltero(a),25 - 44,122,94,28,10
Sacatepéquez,Soltero(a),45 - 64,96,49,47,10
Sacatepéquez,Soltero(a),65 y más,260,108,152,10
Sacatepéquez,Soltero(a),Ignorado,8,6,2,10
Sacatepéquez,Todos los estados civiles,Todas las edades,774,408,366,10
Sacatepéquez,Casado(a),Menos de 15 años,0,0,0,10
Sacatepéquez,Casado(a),15 - 24,9,5,4,10
Sacatepéquez,Casado(a),25 - 44,89,58,31,10
Sacatepéquez,Casado(a),45 - 64,200,96,104,10
Sacatepéquez,Casado(a),65 y más,476,249,227,10
Sacatepéquez,Casado(a),Ignorado,0,0,0,10
Sacatepéquez,Todos los estados civiles,Todas las edades,4,3,1,10
Sacatepéquez,Unido(a),Menos de 15 años,0,0,0,10
Sacatepéquez,Unido(a),15 - 24,0,0,0,10
Sacatepéquez,Unido(a),25 - 44,0,0,0,10
Sacatepéquez,Unido(a),45 - 64,1,1,0,10
Sacatepéquez,Unido(a),65 y más,3,2,1,10
Sacatepéquez,Unido(a),Ignorado,0,0,0,10
Sacatepéquez,Todos los estados civiles,Todas las edades,13,5,8,10
Sacatepéquez,Ignorado(a),Menos de 15 años,6,3,3,10
Sacatepéquez,Ignorado(a),15 - 24,1,0,1,10
Sacatepéquez,Ignorado(a),25 - 44,0,0,0,10
Sacatepéquez,Ignorado(a),45 - 64,0,0,0,10
Sacatepéquez,Ignorado(a),65 y más,4,1,3,10
Sacatepéquez,Ignorado(a),Ignorado,2,1,1,10
Chimaltenango,Todos los estados civiles,Todas las edades,2612,1501,1111,10
Chimaltenango,Todos los estados civiles,Menos de 15 años,473,276,197,10
Chimaltenango,Todos los estados civiles,15 - 24,152,114,38,10
Chimaltenango,Todos los estados civiles,25 - 44,380,284,96,10
Chimaltenango,Todos los estados civiles,45 - 64,530,291,239,10
Chimaltenango,Todos los estados civiles,65 y más,1049,515,534,10
Chimaltenango,Todos los estados civiles,Ignorado,28,21,7,10
Chimaltenango,Todos los estados civiles,Todas las edades,1239,710,529,10
Chimaltenango,Soltero(a),Menos de 15 años,434,253,181,10
Chimaltenango,Soltero(a),15 - 24,131,103,28,10
Chimaltenango,Soltero(a),25 - 44,158,119,39,10
Chimaltenango,Soltero(a),45 - 64,149,77,72,10
Chimaltenango,Soltero(a),65 y más,345,139,206,10
Chimaltenango,Soltero(a),Ignorado,22,19,3,10
Chimaltenango,Todos los estados civiles,Todas las edades,1301,751,550,10
Chimaltenango,Casado(a),Menos de 15 años,1,1,0,10
Chimaltenango,Casado(a),15 - 24,19,11,8,10
Chimaltenango,Casado(a),25 - 44,219,163,56,10
Chimaltenango,Casado(a),45 - 64,378,211,167,10
Chimaltenango,Casado(a),65 y más,682,365,317,10
Chimaltenango,Casado(a),Ignorado,2,0,2,10
Chimaltenango,Todos los estados civiles,Todas las edades,17,9,8,10
Chimaltenango,Unido(a),Menos de 15 años,0,0,0,10
Chimaltenango,Unido(a),15 - 24,0,0,0,10
Chimaltenango,Unido(a),25 - 44,0,0,0,10
Chimaltenango,Unido(a),45 - 64,2,2,0,10
Chimaltenango,Unido(a),65 y más,15,7,8,10
Chimaltenango,Unido(a),Ignorado,0,0,0,10
Chimaltenango,Todos los estados civiles,Todas las edades,55,31,24,10
Chimaltenango,Ignorado(a),Menos de 15 años,38,22,16,10
Chimaltenango,Ignorado(a),15 - 24,2,0,2,10
Chimaltenango,Ignorado(a),25 - 44,3,2,1,10
Chimaltenango,Ignorado(a),45 - 64,1,1,0,10
Chimaltenango,Ignorado(a),65 y más,7,4,3,10
Chimaltenango,Ignorado(a),Ignorado,4,2,2,10
Escuintla,Todos los estados civiles,Todas las edades,3915,2385,1530,10
Escuintla,Todos los estados civiles,Menos de 15 años,479,256,223,10
Escuintla,Todos los estados civiles,15 - 24,304,251,53,10
Escuintla,Todos los estados civiles,25 - 44,704,522,182,10
Escuintla,Todos los estados civiles,45 - 64,878,500,378,10
Escuintla,Todos los estados civiles,65 y más,1473,802,671,10
Escuintla,Todos los estados civiles,Ignorado,77,54,23,10
Escuintla,Todos los estados civiles,Todas las edades,2595,1569,1026,10
Escuintla,Soltero(a),Menos de 15 años,437,231,206,10
Escuintla,Soltero(a),15 - 24,282,230,52,10
Escuintla,Soltero(a),25 - 44,491,370,121,10
Escuintla,Soltero(a),45 - 64,497,281,216,10
Escuintla,Soltero(a),65 y más,834,419,415,10
Escuintla,Soltero(a),Ignorado,54,38,16,10
Escuintla,Todos los estados civiles,Todas las edades,1243,771,472,10
Escuintla,Casado(a),Menos de 15 años,0,0,0,10
Escuintla,Casado(a),15 - 24,22,21,1,10
Escuintla,Casado(a),25 - 44,210,150,60,10
Escuintla,Casado(a),45 - 64,379,218,161,10
Escuintla,Casado(a),65 y más,625,379,246,10
Escuintla,Casado(a),Ignorado,7,3,4,10
Escuintla,Todos los estados civiles,Todas las edades,14,4,10,10
Escuintla,Unido(a),Menos de 15 años,0,0,0,10
Escuintla,Unido(a),15 - 24,0,0,0,10
Escuintla,Unido(a),25 - 44,1,0,1,10
Escuintla,Unido(a),45 - 64,1,0,1,10
Escuintla,Unido(a),65 y más,12,4,8,10
Escuintla,Unido(a),Ignorado,0,0,0,10
Escuintla,Todos los estados civiles,Todas las edades,63,41,22,10
Escuintla,Ignorado(a),Menos de 15 años,42,25,17,10
Escuintla,Ignorado(a),15 - 24,0,0,0,10
Escuintla,Ignorado(a),25 - 44,2,2,0,10
Escuintla,Ignorado(a),45 - 64,1,1,0,10
Escuintla,Ignorado(a),65 y más,2,0,2,10
Escuintla,Ignorado(a),Ignorado,16,13,3,10
Santa Rosa,Todos los estados civiles,Todas las edades,2134,1268,866,10
Santa Rosa,Todos los estados civiles,Menos de 15 años,184,100,84,10
Santa Rosa,Todos los estados civiles,15 - 24,137,98,39,10
Santa Rosa,Todos los estados civiles,25 - 44,365,278,87,10
Santa Rosa,Todos los estados civiles,45 - 64,446,258,188,10
Santa Rosa,Todos los estados civiles,65 y más,978,516,462,10
Santa Rosa,Todos los estados civiles,Ignorado,24,18,6,10
Santa Rosa,Todos los estados civiles,Todas las edades,1285,785,500,10
Santa Rosa,Soltero(a),Menos de 15 años,183,100,83,10
Santa Rosa,Soltero(a),15 - 24,127,89,38,10
Santa Rosa,Soltero(a),25 - 44,247,197,50,10
Santa Rosa,Soltero(a),45 - 64,221,134,87,10
Santa Rosa,Soltero(a),65 y más,489,251,238,10
Santa Rosa,Soltero(a),Ignorado,18,14,4,10
Santa Rosa,Todos los estados civiles,Todas las edades,819,465,354,10
Santa Rosa,Casado(a),Menos de 15 años,0,0,0,10
Santa Rosa,Casado(a),15 - 24,10,9,1,10
Santa Rosa,Casado(a),25 - 44,115,78,37,10
Santa Rosa,Casado(a),45 - 64,223,123,100,10
Santa Rosa,Casado(a),65 y más,467,252,215,10
Santa Rosa,Casado(a),Ignorado,4,3,1,10
Santa Rosa,Todos los estados civiles,Todas las edades,22,14,8,10
Santa Rosa,Unido(a),Menos de 15 años,0,0,0,10
Santa Rosa,Unido(a),15 - 24,0,0,0,10
Santa Rosa,Unido(a),25 - 44,3,3,0,10
Santa Rosa,Unido(a),45 - 64,2,1,1,10
Santa Rosa,Unido(a),65 y más,17,10,7,10
Santa Rosa,Unido(a),Ignorado,0,0,0,10
Santa Rosa,Todos los estados civiles,Todas las edades,8,4,4,10
Santa Rosa,Ignorado(a),Menos de 15 años,1,0,1,10
Santa Rosa,Ignorado(a),15 - 24,0,0,0,10
Santa Rosa,Ignorado(a),25 - 44,0,0,0,10
Santa Rosa,Ignorado(a),45 - 64,0,0,0,10
Santa Rosa,Ignorado(a),65 y más,5,3,2,10
Santa Rosa,Ignorado(a),Ignorado,2,1,1,10
Sololá,Todos los estados civiles,Todas las edades,1543,879,664,10
Sololá,Todos los estados civiles,Menos de 15 años,313,176,137,10
Sololá,Todos los estados civiles,15 - 24,84,52,32,10
Sololá,Todos los estados civiles,25 - 44,257,187,70,10
Sololá,Todos los estados civiles,45 - 64,277,154,123,10
Sololá,Todos los estados civiles,65 y más,585,300,285,10
Sololá,Todos los estados civiles,Ignorado,27,10,17,10
Sololá,Todos los estados civiles,Todas las edades,933,518,415,10
Sololá,Soltero(a),Menos de 15 años,298,164,134,10
Sololá,Soltero(a),15 - 24,78,49,29,10
Sololá,Soltero(a),25 - 44,155,119,36,10
Sololá,Soltero(a),45 - 64,104,56,48,10
Sololá,Soltero(a),65 y más,285,128,157,10
Sololá,Soltero(a),Ignorado,13,2,11,10
Sololá,Todos los estados civiles,Todas las edades,524,307,217,10
Sololá,Casado(a),Menos de 15 años,0,0,0,10
Sololá,Casado(a),15 - 24,6,3,3,10
Sololá,Casado(a),25 - 44,101,67,34,10
Sololá,Casado(a),45 - 64,154,87,67,10
Sololá,Casado(a),65 y más,260,148,112,10
Sololá,Casado(a),Ignorado,3,2,1,10
Sololá,Todos los estados civiles,Todas las edades,51,29,22,10
Sololá,Unido(a),Menos de 15 años,0,0,0,10
Sololá,Unido(a),15 - 24,0,0,0,10
Sololá,Unido(a),25 - 44,1,1,0,10
Sololá,Unido(a),45 - 64,14,8,6,10
Sololá,Unido(a),65 y más,35,20,15,10
Sololá,Unido(a),Ignorado,1,0,1,10
Sololá,Todos los estados civiles,Todas las edades,35,25,10,10
Sololá,Ignorado(a),Menos de 15 años,15,12,3,10
Sololá,Ignorado(a),15 - 24,0,0,0,10
Sololá,Ignorado(a),25 - 44,0,0,0,10
Sololá,Ignorado(a),45 - 64,5,3,2,10
Sololá,Ignorado(a),65 y más,5,4,1,10
Sololá,Ignorado(a),Ignorado,10,6,4,10
Totonicapán,Todos los estados civiles,Todas las edades,2269,1227,1042,10
Totonicapán,Todos los estados civiles,Menos de 15 años,478,245,233,10
Totonicapán,Todos los estados civiles,15 - 24,113,64,49,10
Totonicapán,Todos los estados civiles,25 - 44,370,225,145,10
Totonicapán,Todos los estados civiles,45 - 64,405,260,145,10
Totonicapán,Todos los estados civiles,65 y más,877,424,453,10
Totonicapán,Todos los estados civiles,Ignorado,26,9,17,10
Totonicapán,Todos los estados civiles,Todas las edades,1227,610,617,10
Totonicapán,Soltero(a),Menos de 15 años,398,200,198,10
Totonicapán,Soltero(a),15 - 24,97,59,38,10
Totonicapán,Soltero(a),25 - 44,173,110,63,10
Totonicapán,Soltero(a),45 - 64,148,85,63,10
Totonicapán,Soltero(a),65 y más,400,151,249,10
Totonicapán,Soltero(a),Ignorado,11,5,6,10
Totonicapán,Todos los estados civiles,Todas las edades,897,534,363,10
Totonicapán,Casado(a),Menos de 15 años,2,1,1,10
Totonicapán,Casado(a),15 - 24,14,3,11,10
Totonicapán,Casado(a),25 - 44,192,113,79,10
Totonicapán,Casado(a),45 - 64,243,165,78,10
Totonicapán,Casado(a),65 y más,443,251,192,10
Totonicapán,Casado(a),Ignorado,3,1,2,10
Totonicapán,Todos los estados civiles,Todas las edades,49,30,19,10
Totonicapán,Unido(a),Menos de 15 años,0,0,0,10
Totonicapán,Unido(a),15 - 24,0,0,0,10
Totonicapán,Unido(a),25 - 44,4,1,3,10
Totonicapán,Unido(a),45 - 64,13,9,4,10
Totonicapán,Unido(a),65 y más,32,20,12,10
Totonicapán,Unido(a),Ignorado,0,0,0,10
Totonicapán,Todos los estados civiles,Todas las edades,96,53,43,10
Totonicapán,Ignorado(a),Menos de 15 años,78,44,34,10
Totonicapán,Ignorado(a),15 - 24,2,2,0,10
Totonicapán,Ignorado(a),25 - 44,1,1,0,10
Totonicapán,Ignorado(a),45 - 64,1,1,0,10
Totonicapán,Ignorado(a),65 y más,2,2,0,10
Totonicapán,Ignorado(a),Ignorado,12,3,9,10
Quetzaltenango,Todos los estados civiles,Todas las edades,3901,2233,1668,10
Quetzaltenango,Todos los estados civiles,Menos de 15 años,643,370,273,10
Quetzaltenango,Todos los estados civiles,15 - 24,232,164,68,10
Quetzaltenango,Todos los estados civiles,25 - 44,514,385,129,10
Quetzaltenango,Todos los estados civiles,45 - 64,784,457,327,10
Quetzaltenango,Todos los estados civiles,65 y más,1662,815,847,10
Quetzaltenango,Todos los estados civiles,Ignorado,66,42,24,10
Quetzaltenango,Todos los estados civiles,Todas las edades,2227,1234,993,10
Quetzaltenango,Soltero(a),Menos de 15 años,543,308,235,10
Quetzaltenango,Soltero(a),15 - 24,202,147,55,10
Quetzaltenango,Soltero(a),25 - 44,312,232,80,10
Quetzaltenango,Soltero(a),45 - 64,341,191,150,10
Quetzaltenango,Soltero(a),65 y más,790,333,457,10
Quetzaltenango,Soltero(a),Ignorado,39,23,16,10
Quetzaltenango,Todos los estados civiles,Todas las edades,1512,893,619,10
Quetzaltenango,Casado(a),Menos de 15 años,0,0,0,10
Quetzaltenango,Casado(a),15 - 24,29,17,12,10
Quetzaltenango,Casado(a),25 - 44,195,147,48,10
Quetzaltenango,Casado(a),45 - 64,436,261,175,10
Quetzaltenango,Casado(a),65 y más,833,457,376,10
Quetzaltenango,Casado(a),Ignorado,19,11,8,10
Quetzaltenango,Todos los estados civiles,Todas las edades,34,26,8,10
Quetzaltenango,Unido(a),Menos de 15 años,0,0,0,10
Quetzaltenango,Unido(a),15 - 24,0,0,0,10
Quetzaltenango,Unido(a),25 - 44,6,5,1,10
Quetzaltenango,Unido(a),45 - 64,6,5,1,10
Quetzaltenango,Unido(a),65 y más,22,16,6,10
Quetzaltenango,Unido(a),Ignorado,0,0,0,10
Quetzaltenango,Todos los estados civiles,Todas las edades,128,80,48,10
Quetzaltenango,Ignorado(a),Menos de 15 años,100,62,38,10
Quetzaltenango,Ignorado(a),15 - 24,1,0,1,10
Quetzaltenango,Ignorado(a),25 - 44,1,1,0,10
Quetzaltenango,Ignorado(a),45 - 64,1,0,1,10
Quetzaltenango,Ignorado(a),65 y más,17,9,8,10
Quetzaltenango,Ignorado(a),Ignorado,8,8,0,10
Suchitepéquez,Todos los estados civiles,Todas las edades,2794,1634,1160,10
Suchitepéquez,Todos los estados civiles,Menos de 15 años,421,244,177,10
Suchitepéquez,Todos los estados civiles,15 - 24,168,113,55,10
Suchitepéquez,Todos los estados civiles,25 - 44,445,316,129,10
Suchitepéquez,Todos los estados civiles,45 - 64,577,314,263,10
Suchitepéquez,Todos los estados civiles,65 y más,1132,617,515,10
Suchitepéquez,Todos los estados civiles,Ignorado,51,30,21,10
Suchitepéquez,Todos los estados civiles,Todas las edades,1712,994,718,10
Suchitepéquez,Soltero(a),Menos de 15 años,416,241,175,10
Suchitepéquez,Soltero(a),15 - 24,146,97,49,10
Suchitepéquez,Soltero(a),25 - 44,259,196,63,10
Suchitepéquez,Soltero(a),45 - 64,258,142,116,10
Suchitepéquez,Soltero(a),65 y más,598,297,301,10
Suchitepéquez,Soltero(a),Ignorado,35,21,14,10
Suchitepéquez,Todos los estados civiles,Todas las edades,1043,621,422,10
Suchitepéquez,Casado(a),Menos de 15 años,0,0,0,10
Suchitepéquez,Casado(a),15 - 24,20,15,5,10
Suchitepéquez,Casado(a),25 - 44,185,119,66,10
Suchitepéquez,Casado(a),45 - 64,314,171,143,10
Suchitepéquez,Casado(a),65 y más,515,312,203,10
Suchitepéquez,Casado(a),Ignorado,9,4,5,10
Suchitepéquez,Todos los estados civiles,Todas las edades,19,8,11,10
Suchitepéquez,Unido(a),Menos de 15 años,0,0,0,10
Suchitepéquez,Unido(a),15 - 24,1,0,1,10
Suchitepéquez,Unido(a),25 - 44,1,1,0,10
Suchitepéquez,Unido(a),45 - 64,3,1,2,10
Suchitepéquez,Unido(a),65 y más,13,6,7,10
Suchitepéquez,Unido(a),Ignorado,1,0,1,10
Suchitepéquez,Todos los estados civiles,Todas las edades,20,11,9,10
Suchitepéquez,Ignorado(a),Menos de 15 años,5,3,2,10
Suchitepéquez,Ignorado(a),15 - 24,1,1,0,10
Suchitepéquez,Ignorado(a),25 - 44,0,0,0,10
Suchitepéquez,Ignorado(a),45 - 64,2,0,2,10
Suchitepéquez,Ignorado(a),65 y más,6,2,4,10
Suchitepéquez,Ignorado(a),Ignorado,6,5,1,10
Retalhuleu,Todos los estados civiles,Todas las edades,1512,899,613,10
Retalhuleu,Todos los estados civiles,Menos de 15 años,164,92,72,10
Retalhuleu,Todos los estados civiles,15 - 24,84,64,20,10
Retalhuleu,Todos los estados civiles,25 - 44,245,177,68,10
Retalhuleu,Todos los estados civiles,45 - 64,344,197,147,10
Retalhuleu,Todos los estados civiles,65 y más,659,359,300,10
Retalhuleu,Todos los estados civiles,Ignorado,16,10,6,10
Retalhuleu,Todos los estados civiles,Todas las edades,880,519,361,10
Retalhuleu,Soltero(a),Menos de 15 años,157,89,68,10
Retalhuleu,Soltero(a),15 - 24,74,58,16,10
Retalhuleu,Soltero(a),25 - 44,160,115,45,10
Retalhuleu,Soltero(a),45 - 64,155,90,65,10
Retalhuleu,Soltero(a),65 y más,323,161,162,10
Retalhuleu,Soltero(a),Ignorado,11,6,5,10
Retalhuleu,Todos los estados civiles,Todas las edades,572,345,227,10
Retalhuleu,Casado(a),Menos de 15 años,0,0,0,10
Retalhuleu,Casado(a),15 - 24,10,6,4,10
Retalhuleu,Casado(a),25 - 44,83,60,23,10
Retalhuleu,Casado(a),45 - 64,173,97,76,10
Retalhuleu,Casado(a),65 y más,304,181,123,10
Retalhuleu,Casado(a),Ignorado,2,1,1,10
Retalhuleu,Todos los estados civiles,Todas las edades,45,26,19,10
Retalhuleu,Unido(a),Menos de 15 años,0,0,0,10
Retalhuleu,Unido(a),15 - 24,0,0,0,10
Retalhuleu,Unido(a),25 - 44,0,0,0,10
Retalhuleu,Unido(a),45 - 64,14,8,6,10
Retalhuleu,Unido(a),65 y más,30,17,13,10
Retalhuleu,Unido(a),Ignorado,1,1,0,10
Retalhuleu,Todos los estados civiles,Todas las edades,15,9,6,10
Retalhuleu,Ignorado(a),Menos de 15 años,7,3,4,10
Retalhuleu,Ignorado(a),15 - 24,0,0,0,10
Retalhuleu,Ignorado(a),25 - 44,2,2,0,10
Retalhuleu,Ignorado(a),45 - 64,2,2,0,10
Retalhuleu,Ignorado(a),65 y más,2,0,2,10
Retalhuleu,Ignorado(a),Ignorado,2,2,0,10
San Marcos,Todos los estados civiles,Todas las edades,4586,2639,1947,10
San Marcos,Todos los estados civiles,Menos de 15 años,768,443,325,10
San Marcos,Todos los estados civiles,15 - 24,263,173,90,10
San Marcos,Todos los estados civiles,25 - 44,725,483,242,10
San Marcos,Todos los estados civiles,45 - 64,887,494,393,10
San Marcos,Todos los estados civiles,65 y más,1781,948,833,10
San Marcos,Todos los estados civiles,Ignorado,162,98,64,10
San Marcos,Todos los estados civiles,Todas las edades,2956,1712,1244,10
San Marcos,Soltero(a),Menos de 15 años,721,415,306,10
San Marcos,Soltero(a),15 - 24,241,161,80,10
San Marcos,Soltero(a),25 - 44,490,328,162,10
San Marcos,Soltero(a),45 - 64,448,261,187,10
San Marcos,Soltero(a),65 y más,968,493,475,10
San Marcos,Soltero(a),Ignorado,88,54,34,10
San Marcos,Todos los estados civiles,Todas las edades,1492,847,645,10
San Marcos,Casado(a),Menos de 15 años,1,1,0,10
San Marcos,Casado(a),15 - 24,22,12,10,10
San Marcos,Casado(a),25 - 44,222,145,77,10
San Marcos,Casado(a),45 - 64,426,226,200,10
San Marcos,Casado(a),65 y más,791,445,346,10
San Marcos,Casado(a),Ignorado,30,18,12,10
San Marcos,Todos los estados civiles,Todas las edades,40,18,22,10
San Marcos,Unido(a),Menos de 15 años,0,0,0,10
San Marcos,Unido(a),15 - 24,0,0,0,10
San Marcos,Unido(a),25 - 44,6,4,2,10
San Marcos,Unido(a),45 - 64,10,4,6,10
San Marcos,Unido(a),65 y más,18,9,9,10
San Marcos,Unido(a),Ignorado,6,1,5,10
San Marcos,Todos los estados civiles,Todas las edades,98,62,36,10
San Marcos,Ignorado(a),Menos de 15 años,46,27,19,10
San Marcos,Ignorado(a),15 - 24,0,0,0,10
San Marcos,Ignorado(a),25 - 44,7,6,1,10
San Marcos,Ignorado(a),45 - 64,3,3,0,10
San Marcos,Ignorado(a),65 y más,4,1,3,10
San Marcos,Ignorado(a),Ignorado,38,25,13,10
Huehuetenango,Todos los estados civiles,Todas las edades,4266,2376,1890,10
Huehuetenango,Todos los estados civiles,Menos de 15 años,918,517,401,10
Huehuetenango,Todos los estados civiles,15 - 24,335,185,150,10
Huehuetenango,Todos los estados civiles,25 - 44,609,364,245,10
Huehuetenango,Todos los estados civiles,45 - 64,775,425,350,10
Huehuetenango,Todos los estados civiles,65 y más,1586,855,731,10
Huehuetenango,Todos los estados civiles,Ignorado,43,30,13,10
Huehuetenango,Todos los estados civiles,Todas las edades,2946,1635,1311,10
Huehuetenango,Soltero(a),Menos de 15 años,849,476,373,10
Huehuetenango,Soltero(a),15 - 24,305,170,135,10
Huehuetenango,Soltero(a),25 - 44,362,214,148,10
Huehuetenango,Soltero(a),45 - 64,409,226,183,10
Huehuetenango,Soltero(a),65 y más,988,528,460,10
Huehuetenango,Soltero(a),Ignorado,33,21,12,10
Huehuetenango,Todos los estados civiles,Todas las edades,1211,682,529,10
Huehuetenango,Casado(a),Menos de 15 años,0,0,0,10
Huehuetenango,Casado(a),15 - 24,29,15,14,10
Huehuetenango,Casado(a),25 - 44,244,147,97,10
Huehuetenango,Casado(a),45 - 64,360,196,164,10
Huehuetenango,Casado(a),65 y más,575,321,254,10
Huehuetenango,Casado(a),Ignorado,3,3,0,10
Huehuetenango,Todos los estados civiles,Todas las edades,23,6,17,10
Huehuetenango,Unido(a),Menos de 15 años,0,0,0,10
Huehuetenango,Unido(a),15 - 24,0,0,0,10
Huehuetenango,Unido(a),25 - 44,0,0,0,10
Huehuetenango,Unido(a),45 - 64,4,2,2,10
Huehuetenango,Unido(a),65 y más,19,4,15,10
Huehuetenango,Unido(a),Ignorado,0,0,0,10
Huehuetenango,Todos los estados civiles,Todas las edades,86,53,33,10
Huehuetenango,Ignorado(a),Menos de 15 años,69,41,28,10
Huehuetenango,Ignorado(a),15 - 24,1,0,1,10
Huehuetenango,Ignorado(a),25 - 44,3,3,0,10
Huehuetenango,Ignorado(a),45 - 64,2,1,1,10
Huehuetenango,Ignorado(a),65 y más,4,2,2,10
Huehuetenango,Ignorado(a),Ignorado,7,6,1,10
Quiché,Todos los estados civiles,Todas las edades,3967,2107,1860,10
Quiché,Todos los estados civiles,Menos de 15 años,1009,540,469,10
Quiché,Todos los estados civiles,15 - 24,210,129,81,10
Quiché,Todos los estados civiles,25 - 44,614,391,223,10
Quiché,Todos los estados civiles,45 - 64,732,399,333,10
Quiché,Todos los estados civiles,65 y más,1353,630,723,10
Quiché,Todos los estados civiles,Ignorado,49,18,31,10
Quiché,Todos los estados civiles,Todas las edades,2873,1482,1391,10
Quiché,Soltero(a),Menos de 15 años,971,518,453,10
Quiché,Soltero(a),15 - 24,189,118,71,10
Quiché,Soltero(a),25 - 44,374,254,120,10
Quiché,Soltero(a),45 - 64,395,203,192,10
Quiché,Soltero(a),65 y más,904,374,530,10
Quiché,Soltero(a),Ignorado,40,15,25,10
Quiché,Todos los estados civiles,Todas las edades,1019,590,429,10
Quiché,Casado(a),Menos de 15 años,0,0,0,10
Quiché,Casado(a),15 - 24,21,11,10,10
Quiché,Casado(a),25 - 44,238,135,103,10
Quiché,Casado(a),45 - 64,336,196,140,10
Quiché,Casado(a),65 y más,422,247,175,10
Quiché,Casado(a),Ignorado,2,1,1,10
Quiché,Todos los estados civiles,Todas las edades,18,8,10,10
Quiché,Unido(a),Menos de 15 años,0,0,0,10
Quiché,Unido(a),15 - 24,0,0,0,10
Quiché,Unido(a),25 - 44,1,1,0,10
Quiché,Unido(a),45 - 64,0,0,0,10
Quiché,Unido(a),65 y más,16,7,9,10
Quiché,Unido(a),Ignorado,1,0,1,10
Quiché,Todos los estados civiles,Todas las edades,57,27,30,10
Quiché,Ignorado(a),Menos de 15 años,38,22,16,10
Quiché,Ignorado(a),15 - 24,0,0,0,10
Quiché,Ignorado(a),25 - 44,1,1,0,10
Quiché,Ignorado(a),45 - 64,1,0,1,10
Quiché,Ignorado(a),65 y más,11,2,9,10
Quiché,Ignorado(a),Ignorado,6,2,4,10
Baja Verapaz,Todos los estados civiles,Todas las edades,1285,697,588,10
Baja Verapaz,Todos los estados civiles,Menos de 15 años,216,125,91,10
Baja Verapaz,Todos los estados civiles,15 - 24,70,47,23,10
Baja Verapaz,Todos los estados civiles,25 - 44,174,108,66,10
Baja Verapaz,Todos los estados civiles,45 - 64,217,122,95,10
Baja Verapaz,Todos los estados civiles,65 y más,594,287,307,10
Baja Verapaz,Todos los estados civiles,Ignorado,14,8,6,10
Baja Verapaz,Todos los estados civiles,Todas las edades,713,378,335,10
Baja Verapaz,Soltero(a),Menos de 15 años,212,121,91,10
Baja Verapaz,Soltero(a),15 - 24,65,44,21,10
Baja Verapaz,Soltero(a),25 - 44,94,56,38,10
Baja Verapaz,Soltero(a),45 - 64,82,43,39,10
Baja Verapaz,Soltero(a),65 y más,250,110,140,10
Baja Verapaz,Soltero(a),Ignorado,10,4,6,10
Baja Verapaz,Todos los estados civiles,Todas las edades,537,301,236,10
Baja Verapaz,Casado(a),Menos de 15 años,0,0,0,10
Baja Verapaz,Casado(a),15 - 24,5,3,2,10
Baja Verapaz,Casado(a),25 - 44,80,52,28,10
Baja Verapaz,Casado(a),45 - 64,133,78,55,10
Baja Verapaz,Casado(a),65 y más,317,166,151,10
Baja Verapaz,Casado(a),Ignorado,2,2,0,10
Baja Verapaz,Todos los estados civiles,Todas las edades,29,12,17,10
Baja Verapaz,Unido(a),Menos de 15 años,0,0,0,10
Baja Verapaz,Unido(a),15 - 24,0,0,0,10
Baja Verapaz,Unido(a),25 - 44,0,0,0,10
Baja Verapaz,Unido(a),45 - 64,2,1,1,10
Baja Verapaz,Unido(a),65 y más,27,11,16,10
Baja Verapaz,Unido(a),Ignorado,0,0,0,10
Baja Verapaz,Todos los estados civiles,Todas las edades,6,6,0,10
Baja Verapaz,Ignorado(a),Menos de 15 años,4,4,0,10
Baja Verapaz,Ignorado(a),15 - 24,0,0,0,10
Baja Verapaz,Ignorado(a),25 - 44,0,0,0,10
Baja Verapaz,Ignorado(a),45 - 64,0,0,0,10
Baja Verapaz,Ignorado(a),65 y más,0,0,0,10
Baja Verapaz,Ignorado(a),Ignorado,2,2,0,10
Alta Verapaz,Todos los estados civiles,Todas las edades,4694,2506,2188,10
Alta Verapaz,Todos los estados civiles,Menos de 15 años,1445,781,664,10
Alta Verapaz,Todos los estados civiles,15 - 24,297,185,112,10
Alta Verapaz,Todos los estados civiles,25 - 44,643,415,228,10
Alta Verapaz,Todos los estados civiles,45 - 64,693,353,340,10
Alta Verapaz,Todos los estados civiles,65 y más,1537,717,820,10
Alta Verapaz,Todos los estados civiles,Ignorado,79,55,24,10
Alta Verapaz,Todos los estados civiles,Todas las edades,2861,1509,1352,10
Alta Verapaz,Soltero(a),Menos de 15 años,1371,738,633,10
Alta Verapaz,Soltero(a),15 - 24,254,168,86,10
Alta Verapaz,Soltero(a),25 - 44,329,227,102,10
Alta Verapaz,Soltero(a),45 - 64,201,86,115,10
Alta Verapaz,Soltero(a),65 y más,646,249,397,10
Alta Verapaz,Soltero(a),Ignorado,60,41,19,10
Alta Verapaz,Todos los estados civiles,Todas las edades,1704,924,780,10
Alta Verapaz,Casado(a),Menos de 15 años,0,0,0,10
Alta Verapaz,Casado(a),15 - 24,41,15,26,10
Alta Verapaz,Casado(a),25 - 44,306,185,121,10
Alta Verapaz,Casado(a),45 - 64,478,262,216,10
Alta Verapaz,Casado(a),65 y más,871,457,414,10
Alta Verapaz,Casado(a),Ignorado,8,5,3,10
Alta Verapaz,Todos los estados civiles,Todas las edades,30,14,16,10
Alta Verapaz,Unido(a),Menos de 15 años,0,0,0,10
Alta Verapaz,Unido(a),15 - 24,1,1,0,10
Alta Verapaz,Unido(a),25 - 44,6,3,3,10
Alta Verapaz,Unido(a),45 - 64,9,2,7,10
Alta Verapaz,Unido(a),65 y más,14,8,6,10
Alta Verapaz,Unido(a),Ignorado,0,0,0,10
Alta Verapaz,Todos los estados civiles,Todas las edades,99,59,40,10
Alta Verapaz,Ignorado(a),Menos de 15 años,74,43,31,10
Alta Verapaz,Ignorado(a),15 - 24,1,1,0,10
Alta Verapaz,Ignorado(a),25 - 44,2,0,2,10
Alta Verapaz,Ignorado(a),45 - 64,5,3,2,10
Alta Verapaz,Ignorado(a),65 y más,6,3,3,10
Alta Verapaz,Ignorado(a),Ignorado,11,9,2,10
Petén,Todos los estados civiles,Todas las edades,1755,1117,638,10
Petén,Todos los estados civiles,Menos de 15 años,310,173,137,10
Petén,Todos los estados civiles,15 - 24,174,132,42,10
Petén,Todos los estados civiles,25 - 44,342,244,98,10
Petén,Todos los estados civiles,45 - 64,336,197,139,10
Petén,Todos los estados civiles,65 y más,517,309,208,10
Petén,Todos los estados civiles,Ignorado,76,62,14,10
Petén,Todos los estados civiles,Todas las edades,1123,735,388,10
Petén,Soltero(a),Menos de 15 años,305,170,135,10
Petén,Soltero(a),15 - 24,161,127,34,10
Petén,Soltero(a),25 - 44,227,179,48,10
Petén,Soltero(a),45 - 64,136,83,53,10
Petén,Soltero(a),65 y más,236,128,108,10
Petén,Soltero(a),Ignorado,58,48,10,10
Petén,Todos los estados civiles,Todas las edades,550,330,220,10
Petén,Casado(a),Menos de 15 años,1,1,0,10
Petén,Casado(a),15 - 24,11,4,7,10
Petén,Casado(a),25 - 44,105,59,46,10
Petén,Casado(a),45 - 64,176,103,73,10
Petén,Casado(a),65 y más,248,154,94,10
Petén,Casado(a),Ignorado,9,9,0,10
Petén,Todos los estados civiles,Todas las edades,67,43,24,10
Petén,Unido(a),Menos de 15 años,0,0,0,10
Petén,Unido(a),15 - 24,1,0,1,10
Petén,Unido(a),25 - 44,10,6,4,10
Petén,Unido(a),45 - 64,22,10,12,10
Petén,Unido(a),65 y más,33,27,6,10
Petén,Unido(a),Ignorado,1,0,1,10
Petén,Todos los estados civiles,Todas las edades,15,9,6,10
Petén,Ignorado(a),Menos de 15 años,4,2,2,10
Petén,Ignorado(a),15 - 24,1,1,0,10
Petén,Ignorado(a),25 - 44,0,0,0,10
Petén,Ignorado(a),45 - 64,2,1,1,10
Petén,Ignorado(a),65 y más,0,0,0,10
Petén,Ignorado(a),Ignorado,8,5,3,10
Izabal,Todos los estados civiles,Todas las edades,1874,1133,741,10
Izabal,Todos los estados civiles,Menos de 15 años,267,152,115,10
Izabal,Todos los estados civiles,15 - 24,130,90,40,10
Izabal,Todos los estados civiles,25 - 44,351,265,86,10
Izabal,Todos los estados civiles,45 - 64,402,213,189,10
Izabal,Todos los estados civiles,65 y más,717,410,307,10
Izabal,Todos los estados civiles,Ignorado,7,3,4,10
Izabal,Todos los estados civiles,Todas las edades,1207,715,492,10
Izabal,Soltero(a),Menos de 15 años,262,149,113,10
Izabal,Soltero(a),15 - 24,128,90,38,10
Izabal,Soltero(a),25 - 44,251,192,59,10
Izabal,Soltero(a),45 - 64,203,108,95,10
Izabal,Soltero(a),65 y más,359,175,184,10
Izabal,Soltero(a),Ignorado,4,1,3,10
Izabal,Todos los estados civiles,Todas las edades,615,388,227,10
Izabal,Casado(a),Menos de 15 años,0,0,0,10
Izabal,Casado(a),15 - 24,2,0,2,10
Izabal,Casado(a),25 - 44,98,72,26,10
Izabal,Casado(a),45 - 64,190,100,90,10
Izabal,Casado(a),65 y más,325,216,109,10
Izabal,Casado(a),Ignorado,0,0,0,10
Izabal,Todos los estados civiles,Todas las edades,41,24,17,10
Izabal,Unido(a),Menos de 15 años,0,0,0,10
Izabal,Unido(a),15 - 24,0,0,0,10
Izabal,Unido(a),25 - 44,0,0,0,10
Izabal,Unido(a),45 - 64,8,5,3,10
Izabal,Unido(a),65 y más,33,19,14,10
Izabal,Unido(a),Ignorado,0,0,0,10
Izabal,Todos los estados civiles,Todas las edades,11,6,5,10
Izabal,Ignorado(a),Menos de 15 años,5,3,2,10
Izabal,Ignorado(a),15 - 24,0,0,0,10
Izabal,Ignorado(a),25 - 44,2,1,1,10
Izabal,Ignorado(a),45 - 64,1,0,1,10
Izabal,Ignorado(a),65 y más,0,0,0,10
Izabal,Ignorado(a),Ignorado,3,2,1,10
Zacapa,Todos los estados civiles,Todas las edades,1357,806,551,10
Zacapa,Todos los estados civiles,Menos de 15 años,110,62,48,10
Zacapa,Todos los estados civiles,15 - 24,88,67,21,10
Zacapa,Todos los estados civiles,25 - 44,192,138,54,10
Zacapa,Todos los estados civiles,45 - 64,285,159,126,10
Zacapa,Todos los estados civiles,65 y más,672,374,298,10
Zacapa,Todos los estados civiles,Ignorado,10,6,4,10
Zacapa,Todos los estados civiles,Todas las edades,812,477,335,10
Zacapa,Soltero(a),Menos de 15 años,93,53,40,10
Zacapa,Soltero(a),15 - 24,81,62,19,10
Zacapa,Soltero(a),25 - 44,134,98,36,10
Zacapa,Soltero(a),45 - 64,147,78,69,10
Zacapa,Soltero(a),65 y más,351,181,170,10
Zacapa,Soltero(a),Ignorado,6,5,1,10
Zacapa,Todos los estados civiles,Todas las edades,513,310,203,10
Zacapa,Casado(a),Menos de 15 años,0,0,0,10
Zacapa,Casado(a),15 - 24,6,4,2,10
Zacapa,Casado(a),25 - 44,56,38,18,10
Zacapa,Casado(a),45 - 64,138,81,57,10
Zacapa,Casado(a),65 y más,312,187,125,10
Zacapa,Casado(a),Ignorado,1,0,1,10
Zacapa,Todos los estados civiles,Todas las edades,7,4,3,10
Zacapa,Unido(a),Menos de 15 años,0,0,0,10
Zacapa,Unido(a),15 - 24,0,0,0,10
Zacapa,Unido(a),25 - 44,0,0,0,10
Zacapa,Unido(a),45 - 64,0,0,0,10
Zacapa,Unido(a),65 y más,7,4,3,10
Zacapa,Unido(a),Ignorado,0,0,0,10
Zacapa,Todos los estados civiles,Todas las edades,25,15,10,10
Zacapa,Ignorado(a),Menos de 15 años,17,9,8,10
Zacapa,Ignorado(a),15 - 24,1,1,0,10
Zacapa,Ignorado(a),25 - 44,2,2,0,10
Zacapa,Ignorado(a),45 - 64,0,0,0,10
Zacapa,Ignorado(a),65 y más,2,2,0,10
Zacapa,Ignorado(a),Ignorado,3,1,2,10
Chiquimula,Todos los estados civiles,Todas las edades,2085,1262,823,10
Chiquimula,Todos los estados civiles,Menos de 15 años,294,175,119,10
Chiquimula,Todos los estados civiles,15 - 24,156,125,31,10
Chiquimula,Todos los estados civiles,25 - 44,309,229,80,10
Chiquimula,Todos los estados civiles,45 - 64,384,210,174,10
Chiquimula,Todos los estados civiles,65 y más,909,500,409,10
Chiquimula,Todos los estados civiles,Ignorado,33,23,10,10
Chiquimula,Todos los estados civiles,Todas las edades,1328,818,510,10
Chiquimula,Soltero(a),Menos de 15 años,276,165,111,10
Chiquimula,Soltero(a),15 - 24,145,122,23,10
Chiquimula,Soltero(a),25 - 44,206,152,54,10
Chiquimula,Soltero(a),45 - 64,193,107,86,10
Chiquimula,Soltero(a),65 y más,484,255,229,10
Chiquimula,Soltero(a),Ignorado,24,17,7,10
Chiquimula,Todos los estados civiles,Todas las edades,724,427,297,10
Chiquimula,Casado(a),Menos de 15 años,0,0,0,10
Chiquimula,Casado(a),15 - 24,11,3,8,10
Chiquimula,Casado(a),25 - 44,102,76,26,10
Chiquimula,Casado(a),45 - 64,190,102,88,10
Chiquimula,Casado(a),65 y más,415,241,174,10
Chiquimula,Casado(a),Ignorado,6,5,1,10
Chiquimula,Todos los estados civiles,Todas las edades,8,3,5,10
Chiquimula,Unido(a),Menos de 15 años,0,0,0,10
Chiquimula,Unido(a),15 - 24,0,0,0,10
Chiquimula,Unido(a),25 - 44,1,1,0,10
Chiquimula,Unido(a),45 - 64,0,0,0,10
Chiquimula,Unido(a),65 y más,7,2,5,10
Chiquimula,Unido(a),Ignorado,0,0,0,10
Chiquimula,Todos los estados civiles,Todas las edades,25,14,11,10
Chiquimula,Ignorado(a),Menos de 15 años,18,10,8,10
Chiquimula,Ignorado(a),15 - 24,0,0,0,10
Chiquimula,Ignorado(a),25 - 44,0,0,0,10
Chiquimula,Ignorado(a),45 - 64,1,1,0,10
Chiquimula,Ignorado(a),65 y más,3,2,1,10
Chiquimula,Ignorado(a),Ignorado,3,1,2,10
Jalapa,Todos los estados civiles,Todas las edades,1638,941,697,10
Jalapa,Todos los estados civiles,Menos de 15 años,264,136,128,10
Jalapa,Todos los estados civiles,15 - 24,134,96,38,10
Jalapa,Todos los estados civiles,25 - 44,246,179,67,10
Jalapa,Todos los estados civiles,45 - 64,331,196,135,10
Jalapa,Todos los estados civiles,65 y más,647,327,320,10
Jalapa,Todos los estados civiles,Ignorado,16,7,9,10
Jalapa,Todos los estados civiles,Todas las edades,891,509,382,10
Jalapa,Soltero(a),Menos de 15 años,228,115,113,10
Jalapa,Soltero(a),15 - 24,126,94,32,10
Jalapa,Soltero(a),25 - 44,134,101,33,10
Jalapa,Soltero(a),45 - 64,126,67,59,10
Jalapa,Soltero(a),65 y más,264,126,138,10
Jalapa,Soltero(a),Ignorado,13,6,7,10
Jalapa,Todos los estados civiles,Todas las edades,700,407,293,10
Jalapa,Casado(a),Menos de 15 años,0,0,0,10
Jalapa,Casado(a),15 - 24,6,2,4,10
Jalapa,Casado(a),25 - 44,111,77,34,10
Jalapa,Casado(a),45 - 64,204,129,75,10
Jalapa,Casado(a),65 y más,378,199,179,10
Jalapa,Casado(a),Ignorado,1,0,1,10
Jalapa,Todos los estados civiles,Todas las edades,6,0,6,10
Jalapa,Unido(a),Menos de 15 años,0,0,0,10
Jalapa,Unido(a),15 - 24,2,0,2,10
Jalapa,Unido(a),25 - 44,0,0,0,10
Jalapa,Unido(a),45 - 64,1,0,1,10
Jalapa,Unido(a),65 y más,3,0,3,10
Jalapa,Unido(a),Ignorado,0,0,0,10
Jalapa,Todos los estados civiles,Todas las edades,41,25,16,10
Jalapa,Ignorado(a),Menos de 15 años,36,21,15,10
Jalapa,Ignorado(a),15 - 24,0,0,0,10
Jalapa,Ignorado(a),25 - 44,1,1,0,10
Jalapa,Ignorado(a),45 - 64,0,0,0,10
Jalapa,Ignorado(a),65 y más,2,2,0,10
Jalapa,Ignorado(a),Ignorado,2,1,1,10
Jutiapa,Todos los estados civiles,Todas las edades,2589,1522,1067,10
Jutiapa,Todos los estados civiles,Menos de 15 años,240,135,105,10
Jutiapa,Todos los estados civiles,15 - 24,189,136,53,10
Jutiapa,Todos los estados civiles,25 - 44,458,344,114,10
Jutiapa,Todos los estados civiles,45 - 64,551,310,241,10
Jutiapa,Todos los estados civiles,65 y más,1142,593,549,10
Jutiapa,Todos los estados civiles,Ignorado,9,4,5,10
Jutiapa,Todos los estados civiles,Todas las edades,1568,899,669,10
Jutiapa,Soltero(a),Menos de 15 años,237,133,104,10
Jutiapa,Soltero(a),15 - 24,177,127,50,10
Jutiapa,Soltero(a),25 - 44,304,232,72,10
Jutiapa,Soltero(a),45 - 64,250,147,103,10
Jutiapa,Soltero(a),65 y más,594,258,336,10
Jutiapa,Soltero(a),Ignorado,6,2,4,10
Jutiapa,Todos los estados civiles,Todas las edades,997,606,391,10
Jutiapa,Casado(a),Menos de 15 años,0,0,0,10
Jutiapa,Casado(a),15 - 24,11,8,3,10
Jutiapa,Casado(a),25 - 44,152,111,41,10
Jutiapa,Casado(a),45 - 64,297,160,137,10
Jutiapa,Casado(a),65 y más,535,325,210,10
Jutiapa,Casado(a),Ignorado,2,2,0,10
Jutiapa,Todos los estados civiles,Todas las edades,13,11,2,10
Jutiapa,Unido(a),Menos de 15 años,0,0,0,10
Jutiapa,Unido(a),15 - 24,0,0,0,10
Jutiapa,Unido(a),25 - 44,0,0,0,10
Jutiapa,Unido(a),45 - 64,3,3,0,10
Jutiapa,Unido(a),65 y más,10,8,2,10
Jutiapa,Unido(a),Ignorado,0,0,0,10
Jutiapa,Todos los estados civiles,Todas las edades,11,6,5,10
Jutiapa,Ignorado(a),Menos de 15 años,3,2,1,10
Jutiapa,Ignorado(a),15 - 24,1,1,0,10
Jutiapa,Ignorado(a),25 - 44,2,1,1,10
Jutiapa,Ignorado(a),45 - 64,1,0,1,10
Jutiapa,Ignorado(a),65 y más,3,2,1,10
Jutiapa,Ignorado(a),Ignorado,1,0,1,10
Extranjero,Todos los estados civiles,Todas las edades,136,94,42,10
Extranjero,Todos los estados civiles,Menos de 15 años,8,6,2,10
Extranjero,Todos los estados civiles,15 - 24,17,13,4,10
Extranjero,Todos los estados civiles,25 - 44,52,42,10,10
Extranjero,Todos los estados civiles,45 - 64,34,23,11,10
Extranjero,Todos los estados civiles,65 y más,20,8,12,10
Extranjero,Todos los estados civiles,Ignorado,5,2,3,10
Extranjero,Todos los estados civiles,Todas las edades,95,61,34,10
Extranjero,Soltero(a),Menos de 15 años,6,4,2,10
Extranjero,Soltero(a),15 - 24,15,11,4,10
Extranjero,Soltero(a),25 - 44,36,29,7,10
Extranjero,Soltero(a),45 - 64,24,14,10,10
Extranjero,Soltero(a),65 y más,13,3,10,10
Extranjero,Soltero(a),Ignorado,1,0,1,10
Extranjero,Todos los estados civiles,Todas las edades,24,19,5,10
Extranjero,Casado(a),Menos de 15 años,0,0,0,10
Extranjero,Casado(a),15 - 24,1,1,0,10
Extranjero,Casado(a),25 - 44,10,8,2,10
Extranjero,Casado(a),45 - 64,6,5,1,10
Extranjero,Casado(a),65 y más,6,4,2,10
Extranjero,Casado(a),Ignorado,1,1,0,10
Extranjero,Todos los estados civiles,Todas las edades,1,1,0,10
Extranjero,Unido(a),Menos de 15 años,0,0,0,10
Extranjero,Unido(a),15 - 24,0,0,0,10
Extranjero,Unido(a),25 - 44,1,1,0,10
Extranjero,Unido(a),45 - 64,0,0,0,10
Extranjero,Unido(a),65 y más,0,0,0,10
Extranjero,Unido(a),Ignorado,0,0,0,10
Extranjero,Todos los estados civiles,Todas las edades,16,13,3,10
Extranjero,Ignorado(a),Menos de 15 años,2,2,0,10
Extranjero,Ignorado(a),15 - 24,1,1,0,10
Extranjero,Ignorado(a),25 - 44,5,4,1,10
Extranjero,Ignorado(a),45 - 64,4,4,0,10
Extranjero,Ignorado(a),65 y más,1,1,0,10
Extranjero,Ignorado(a),Ignorado,3,1,2,10
Ignorado,Todos los estados civiles,Todas las edades,1121,830,291,10
Ignorado,Todos los estados civiles,Menos de 15 años,377,209,168,10
Ignorado,Todos los estados civiles,15 - 24,112,85,27,10
Ignorado,Todos los estados civiles,25 - 44,242,204,38,10
Ignorado,Todos los estados civiles,45 - 64,97,90,7,10
Ignorado,Todos los estados civiles,65 y más,70,50,20,10
Ignorado,Todos los estados civiles,Ignorado,223,192,31,10
Ignorado,Todos los estados civiles,Todas las edades,596,384,212,10
Ignorado,Soltero(a),Menos de 15 años,355,195,160,10
Ignorado,Soltero(a),15 - 24,79,62,17,10
Ignorado,Soltero(a),25 - 44,59,46,13,10
Ignorado,Soltero(a),45 - 64,17,14,3,10
Ignorado,Soltero(a),65 y más,29,16,13,10
Ignorado,Soltero(a),Ignorado,57,51,6,10
Ignorado,Todos los estados civiles,Todas las edades,26,21,5,10
Ignorado,Casado(a),Menos de 15 años,0,0,0,10
Ignorado,Casado(a),15 - 24,0,0,0,10
Ignorado,Casado(a),25 - 44,12,9,3,10
Ignorado,Casado(a),45 - 64,7,6,1,10
Ignorado,Casado(a),65 y más,7,6,1,10
Ignorado,Casado(a),Ignorado,0,0,0,10
Ignorado,Todos los estados civiles,Todas las edades,0,0,0,10
Ignorado,Unido(a),Menos de 15 años,0,0,0,10
Ignorado,Unido(a),15 - 24,0,0,0,10
Ignorado,Unido(a),25 - 44,0,0,0,10
Ignorado,Unido(a),45 - 64,0,0,0,10
Ignorado,Unido(a),65 y más,0,0,0,10
Ignorado,Unido(a),Ignorado,0,0,0,10
Ignorado,Todos los estados civiles,Todas las edades,499,425,74,10
Ignorado,Ignorado(a),Menos de 15 años,22,14,8,10
Ignorado,Ignorado(a),15 - 24,33,23,10,10
Ignorado,Ignorado(a),25 - 44,171,149,22,10
Ignorado,Ignorado(a),45 - 64,73,70,3,10
Ignorado,Ignorado(a),65 y más,34,28,6,10
Ignorado,Ignorado(a),Ignorado,166,141,25,10
Todos los departamentos,Todos los estados civiles,Todas las edades,72354,41295,31059,11
Todos los departamentos,Todos los estados civiles,Menos de 15 años,11577,6404,5173,11
Todos los departamentos,Todos los estados civiles,15 - 24,5019,3692,1327,11
Todos los departamentos,Todos los estados civiles,25 - 44,11022,7851,3171,11
Todos los departamentos,Todos los estados civiles,45 - 64,14202,7916,6286,11
Todos los departamentos,Todos los estados civiles,65 y más,29586,14801,14785,11
Todos los departamentos,Todos los estados civiles,Ignorado,948,631,317,11
Todos los departamentos,Soltero(a),Todas las edades,44494,25332,19162,11
Todos los departamentos,Soltero(a),Menos de 15 años,11266,6238,5028,11
Todos los departamentos,Soltero(a),15 - 24,4564,3415,1149,11
Todos los departamentos,Soltero(a),25 - 44,6850,5068,1782,11
Todos los departamentos,Soltero(a),45 - 64,6440,3548,2892,11
Todos los departamentos,Soltero(a),65 y más,14803,6711,8092,11
Todos los departamentos,Soltero(a),Ignorado,571,352,219,11
Todos los departamentos,Casado(a),Todas las edades,26043,14816,11227,11
Todos los departamentos,Casado(a),Menos de 15 años,0,0,0,11
Todos los departamentos,Casado(a),15 - 24,367,211,156,11
Todos los departamentos,Casado(a),25 - 44,3904,2582,1322,11
Todos los departamentos,Casado(a),45 - 64,7457,4163,3294,11
Todos los departamentos,Casado(a),65 y más,14222,7798,6424,11
Todos los departamentos,Casado(a),Ignorado,93,62,31,11
Todos los departamentos,Unido(a),Todas las edades,662,349,313,11
Todos los departamentos,Unido(a),Menos de 15 años,0,0,0,11
Todos los departamentos,Unido(a),15 - 24,9,5,4,11
Todos los departamentos,Unido(a),25 - 44,61,35,26,11
Todos los departamentos,Unido(a),45 - 64,139,75,64,11
Todos los departamentos,Unido(a),65 y más,446,228,218,11
Todos los departamentos,Unido(a),Ignorado,7,6,1,11
Todos los departamentos,Ignorado(a),Todas las edades,1155,798,357,11
Todos los departamentos,Ignorado(a),Menos de 15 años,311,166,145,11
Todos los departamentos,Ignorado(a),15 - 24,79,61,18,11
Todos los departamentos,Ignorado(a),25 - 44,207,166,41,11
Todos los departamentos,Ignorado(a),45 - 64,166,130,36,11
Todos los departamentos,Ignorado(a),65 y más,115,64,51,11
Todos los departamentos,Ignorado(a),Ignorado,277,211,66,11
Guatemala,Todos los estados civiles,Todas las edades,17275,9720,7555,11
Guatemala,Todos los estados civiles,Menos de 15 años,2179,1257,922,11
Guatemala,Todos los estados civiles,15 - 24,1356,1105,251,11
Guatemala,Todos los estados civiles,25 - 44,2546,1896,650,11
Guatemala,Todos los estados civiles,45 - 64,3512,1968,1544,11
Guatemala,Todos los estados civiles,65 y más,7619,3455,4164,11
Guatemala,Todos los estados civiles,Ignorado,63,39,24,11
Guatemala,Soltero(a),Todas las edades,9847,5639,4208,11
Guatemala,Soltero(a),Menos de 15 años,2023,1170,853,11
Guatemala,Soltero(a),15 - 24,1270,1044,226,11
Guatemala,Soltero(a),25 - 44,1639,1271,368,11
Guatemala,Soltero(a),45 - 64,1623,903,720,11
Guatemala,Soltero(a),65 y más,3249,1228,2021,11
Guatemala,Soltero(a),Ignorado,43,23,20,11
Guatemala,Casado(a),Todas las edades,7051,3854,3197,11
Guatemala,Casado(a),Menos de 15 años,0,0,0,11
Guatemala,Casado(a),15 - 24,63,44,19,11
Guatemala,Casado(a),25 - 44,851,581,270,11
Guatemala,Casado(a),45 - 64,1840,1032,808,11
Guatemala,Casado(a),65 y más,4288,2190,2098,11
Guatemala,Casado(a),Ignorado,9,7,2,11
Guatemala,Unido(a),Todas las edades,57,18,39,11
Guatemala,Unido(a),Menos de 15 años,0,0,0,11
Guatemala,Unido(a),15 - 24,0,0,0,11
Guatemala,Unido(a),25 - 44,5,2,3,11
Guatemala,Unido(a),45 - 64,8,2,6,11
Guatemala,Unido(a),65 y más,43,13,30,11
Guatemala,Unido(a),Ignorado,1,1,0,11
Guatemala,Ignorado(a),Todas las edades,320,209,111,11
Guatemala,Ignorado(a),Menos de 15 años,156,87,69,11
Guatemala,Ignorado(a),15 - 24,23,17,6,11
Guatemala,Ignorado(a),25 - 44,51,42,9,11
Guatemala,Ignorado(a),45 - 64,41,31,10,11
Guatemala,Ignorado(a),65 y más,39,24,15,11
Guatemala,Ignorado(a),Ignorado,10,8,2,11
El Progreso,Todos los estados civiles,Todas las edades,919,522,397,11
El Progreso,Todos los estados civiles,Menos de 15 años,82,44,38,11
El Progreso,Todos los estados civiles,15 - 24,47,33,14,11
El Progreso,Todos los estados civiles,25 - 44,140,101,39,11
El Progreso,Todos los estados civiles,45 - 64,178,94,84,11
El Progreso,Todos los estados civiles,65 y más,468,246,222,11
El Progreso,Todos los estados civiles,Ignorado,4,4,0,11
El Progreso,Soltero(a),Todas las edades,544,315,229,11
El Progreso,Soltero(a),Menos de 15 años,80,43,37,11
El Progreso,Soltero(a),15 - 24,44,30,14,11
El Progreso,Soltero(a),25 - 44,85,67,18,11
El Progreso,Soltero(a),45 - 64,90,49,41,11
El Progreso,Soltero(a),65 y más,241,122,119,11
El Progreso,Soltero(a),Ignorado,4,4,0,11
El Progreso,Casado(a),Todas las edades,365,201,164,11
El Progreso,Casado(a),Menos de 15 años,0,0,0,11
El Progreso,Casado(a),15 - 24,3,3,0,11
El Progreso,Casado(a),25 - 44,55,34,21,11
El Progreso,Casado(a),45 - 64,87,44,43,11
El Progreso,Casado(a),65 y más,220,120,100,11
El Progreso,Casado(a),Ignorado,0,0,0,11
El Progreso,Unido(a),Todas las edades,7,5,2,11
El Progreso,Unido(a),Menos de 15 años,0,0,0,11
El Progreso,Unido(a),15 - 24,0,0,0,11
El Progreso,Unido(a),25 - 44,0,0,0,11
El Progreso,Unido(a),45 - 64,1,1,0,11
El Progreso,Unido(a),65 y más,6,4,2,11
El Progreso,Unido(a),Ignorado,0,0,0,11
El Progreso,Ignorado(a),Todas las edades,3,1,2,11
El Progreso,Ignorado(a),Menos de 15 años,2,1,1,11
El Progreso,Ignorado(a),15 - 24,0,0,0,11
El Progreso,Ignorado(a),25 - 44,0,0,0,11
El Progreso,Ignorado(a),45 - 64,0,0,0,11
El Progreso,Ignorado(a),65 y más,1,0,1,11
El Progreso,Ignorado(a),Ignorado,0,0,0,11
Sacatepéquez,Todos los estados civiles,Todas las edades,1481,816,665,11
Sacatepéquez,Todos los estados civiles,Menos de 15 años,85,41,44,11
Sacatepéquez,Todos los estados civiles,15 - 24,69,51,18,11
Sacatepéquez,Todos los estados civiles,25 - 44,209,155,54,11
Sacatepéquez,Todos los estados civiles,45 - 64,338,184,154,11
Sacatepéquez,Todos los estados civiles,65 y más,769,379,390,11
Sacatepéquez,Todos los estados civiles,Ignorado,11,6,5,11
Sacatepéquez,Soltero(a),Todas las edades,645,356,289,11
Sacatepéquez,Soltero(a),Menos de 15 años,81,38,43,11
Sacatepéquez,Soltero(a),15 - 24,57,45,12,11
Sacatepéquez,Soltero(a),25 - 44,114,89,25,11
Sacatepéquez,Soltero(a),45 - 64,108,62,46,11
Sacatepéquez,Soltero(a),65 y más,281,119,162,11
Sacatepéquez,Soltero(a),Ignorado,4,3,1,11
Sacatepéquez,Casado(a),Todas las edades,805,445,360,11
Sacatepéquez,Casado(a),Menos de 15 años,0,0,0,11
Sacatepéquez,Casado(a),15 - 24,11,6,5,11
Sacatepéquez,Casado(a),25 - 44,93,65,28,11
Sacatepéquez,Casado(a),45 - 64,224,117,107,11
Sacatepéquez,Casado(a),65 y más,476,256,220,11
Sacatepéquez,Casado(a),Ignorado,1,1,0,11
Sacatepéquez,Unido(a),Todas las edades,5,2,3,11
Sacatepéquez,Unido(a),Menos de 15 años,0,0,0,11
Sacatepéquez,Unido(a),15 - 24,0,0,0,11
Sacatepéquez,Unido(a),25 - 44,0,0,0,11
Sacatepéquez,Unido(a),45 - 64,2,2,0,11
Sacatepéquez,Unido(a),65 y más,3,0,3,11
Sacatepéquez,Unido(a),Ignorado,0,0,0,11
Sacatepéquez,Ignorado(a),Todas las edades,26,13,13,11
Sacatepéquez,Ignorado(a),Menos de 15 años,4,3,1,11
Sacatepéquez,Ignorado(a),15 - 24,1,0,1,11
Sacatepéquez,Ignorado(a),25 - 44,2,1,1,11
Sacatepéquez,Ignorado(a),45 - 64,4,3,1,11
Sacatepéquez,Ignorado(a),65 y más,9,4,5,11
Sacatepéquez,Ignorado(a),Ignorado,6,2,4,11
Chimaltenango,Todos los estados civiles,Todas las edades,2459,1377,1082,11
Chimaltenango,Todos los estados civiles,Menos de 15 años,319,182,137,11
Chimaltenango,Todos los estados civiles,15 - 24,137,88,49,11
Chimaltenango,Todos los estados civiles,25 - 44,368,261,107,11
Chimaltenango,Todos los estados civiles,45 - 64,477,271,206,11
Chimaltenango,Todos los estados civiles,65 y más,1143,564,579,11
Chimaltenango,Todos los estados civiles,Ignorado,15,11,4,11
Chimaltenango,Soltero(a),Todas las edades,1171,660,511,11
Chimaltenango,Soltero(a),Menos de 15 años,306,173,133,11
Chimaltenango,Soltero(a),15 - 24,108,75,33,11
Chimaltenango,Soltero(a),25 - 44,189,136,53,11
Chimaltenango,Soltero(a),45 - 64,124,69,55,11
Chimaltenango,Soltero(a),65 y más,432,199,233,11
Chimaltenango,Soltero(a),Ignorado,12,8,4,11
Chimaltenango,Casado(a),Todas las edades,1248,693,555,11
Chimaltenango,Casado(a),Menos de 15 años,0,0,0,11
Chimaltenango,Casado(a),15 - 24,26,12,14,11
Chimaltenango,Casado(a),25 - 44,177,123,54,11
Chimaltenango,Casado(a),45 - 64,349,199,150,11
Chimaltenango,Casado(a),65 y más,694,357,337,11
Chimaltenango,Casado(a),Ignorado,2,2,0,11
Chimaltenango,Unido(a),Todas las edades,10,7,3,11
Chimaltenango,Unido(a),Menos de 15 años,0,0,0,11
Chimaltenango,Unido(a),15 - 24,0,0,0,11
Chimaltenango,Unido(a),25 - 44,0,0,0,11
Chimaltenango,Unido(a),45 - 64,0,0,0,11
Chimaltenango,Unido(a),65 y más,10,7,3,11
Chimaltenango,Unido(a),Ignorado,0,0,0,11
Chimaltenango,Ignorado(a),Todas las edades,30,17,13,11
Chimaltenango,Ignorado(a),Menos de 15 años,13,9,4,11
Chimaltenango,Ignorado(a),15 - 24,3,1,2,11
Chimaltenango,Ignorado(a),25 - 44,2,2,0,11
Chimaltenango,Ignorado(a),45 - 64,4,3,1,11
Chimaltenango,Ignorado(a),65 y más,7,1,6,11
Chimaltenango,Ignorado(a),Ignorado,1,1,0,11
Escuintla,Todos los estados civiles,Todas las edades,3742,2271,1471,11
Escuintla,Todos los estados civiles,Menos de 15 años,210,115,95,11
Escuintla,Todos los estados civiles,15 - 24,275,230,45,11
Escuintla,Todos los estados civiles,25 - 44,710,518,192,11
Escuintla,Todos los estados civiles,45 - 64,911,505,406,11
Escuintla,Todos los estados civiles,65 y más,1559,846,713,11
Escuintla,Todos los estados civiles,Ignorado,77,57,20,11
Escuintla,Soltero(a),Todas las edades,2434,1511,923,11
Escuintla,Soltero(a),Menos de 15 años,207,114,93,11
Escuintla,Soltero(a),15 - 24,263,225,38,11
Escuintla,Soltero(a),25 - 44,502,383,119,11
Escuintla,Soltero(a),45 - 64,491,280,211,11
Escuintla,Soltero(a),65 y más,913,466,447,11
Escuintla,Soltero(a),Ignorado,58,43,15,11
Escuintla,Casado(a),Todas las edades,1257,733,524,11
Escuintla,Casado(a),Menos de 15 años,0,0,0,11
Escuintla,Casado(a),15 - 24,10,4,6,11
Escuintla,Casado(a),25 - 44,203,130,73,11
Escuintla,Casado(a),45 - 64,417,224,193,11
Escuintla,Casado(a),65 y más,620,370,250,11
Escuintla,Casado(a),Ignorado,7,5,2,11
Escuintla,Unido(a),Todas las edades,28,11,17,11
Escuintla,Unido(a),Menos de 15 años,0,0,0,11
Escuintla,Unido(a),15 - 24,2,1,1,11
Escuintla,Unido(a),25 - 44,1,1,0,11
Escuintla,Unido(a),45 - 64,3,1,2,11
Escuintla,Unido(a),65 y más,22,8,14,11
Escuintla,Unido(a),Ignorado,0,0,0,11
Escuintla,Ignorado(a),Todas las edades,23,16,7,11
Escuintla,Ignorado(a),Menos de 15 años,3,1,2,11
Escuintla,Ignorado(a),15 - 24,0,0,0,11
Escuintla,Ignorado(a),25 - 44,4,4,0,11
Escuintla,Ignorado(a),45 - 64,0,0,0,11
Escuintla,Ignorado(a),65 y más,4,2,2,11
Escuintla,Ignorado(a),Ignorado,12,9,3,11
Santa Rosa,Todos los estados civiles,Todas las edades,2023,1208,815,11
Santa Rosa,Todos los estados civiles,Menos de 15 años,108,68,40,11
Santa Rosa,Todos los estados civiles,15 - 24,160,122,38,11
Santa Rosa,Todos los estados civiles,25 - 44,355,277,78,11
Santa Rosa,Todos los estados civiles,45 - 64,418,233,185,11
Santa Rosa,Todos los estados civiles,65 y más,976,504,472,11
Santa Rosa,Todos los estados civiles,Ignorado,6,4,2,11
Santa Rosa,Soltero(a),Todas las edades,1265,760,505,11
Santa Rosa,Soltero(a),Menos de 15 años,101,64,37,11
Santa Rosa,Soltero(a),15 - 24,149,117,32,11
Santa Rosa,Soltero(a),25 - 44,259,203,56,11
Santa Rosa,Soltero(a),45 - 64,202,113,89,11
Santa Rosa,Soltero(a),65 y más,549,260,289,11
Santa Rosa,Soltero(a),Ignorado,5,3,2,11
Santa Rosa,Casado(a),Todas las edades,726,431,295,11
Santa Rosa,Casado(a),Menos de 15 años,0,0,0,11
Santa Rosa,Casado(a),15 - 24,8,4,4,11
Santa Rosa,Casado(a),25 - 44,92,70,22,11
Santa Rosa,Casado(a),45 - 64,215,119,96,11
Santa Rosa,Casado(a),65 y más,411,238,173,11
Santa Rosa,Casado(a),Ignorado,0,0,0,11
Santa Rosa,Unido(a),Todas las edades,21,9,12,11
Santa Rosa,Unido(a),Menos de 15 años,0,0,0,11
Santa Rosa,Unido(a),15 - 24,3,1,2,11
Santa Rosa,Unido(a),25 - 44,3,3,0,11
Santa Rosa,Unido(a),45 - 64,1,1,0,11
Santa Rosa,Unido(a),65 y más,14,4,10,11
Santa Rosa,Unido(a),Ignorado,0,0,0,11
Santa Rosa,Ignorado(a),Todas las edades,11,8,3,11
Santa Rosa,Ignorado(a),Menos de 15 años,7,4,3,11
Santa Rosa,Ignorado(a),15 - 24,0,0,0,11
Santa Rosa,Ignorado(a),25 - 44,1,1,0,11
Santa Rosa,Ignorado(a),45 - 64,0,0,0,11
Santa Rosa,Ignorado(a),65 y más,2,2,0,11
Santa Rosa,Ignorado(a),Ignorado,1,1,0,11
Sololá,Todos los estados civiles,Todas las edades,1432,794,638,11
Sololá,Todos los estados civiles,Menos de 15 años,186,94,92,11
Sololá,Todos los estados civiles,15 - 24,91,72,19,11
Sololá,Todos los estados civiles,25 - 44,211,141,70,11
Sololá,Todos los estados civiles,45 - 64,283,166,117,11
Sololá,Todos los estados civiles,65 y más,651,316,335,11
Sololá,Todos los estados civiles,Ignorado,10,5,5,11
Sololá,Soltero(a),Todas las edades,839,445,394,11
Sololá,Soltero(a),Menos de 15 años,184,92,92,11
Sololá,Soltero(a),15 - 24,79,61,18,11
Sololá,Soltero(a),25 - 44,124,90,34,11
Sololá,Soltero(a),45 - 64,109,61,48,11
Sololá,Soltero(a),65 y más,339,140,199,11
Sololá,Soltero(a),Ignorado,4,1,3,11
Sololá,Casado(a),Todas las edades,493,293,200,11
Sololá,Casado(a),Menos de 15 años,0,0,0,11
Sololá,Casado(a),15 - 24,12,11,1,11
Sololá,Casado(a),25 - 44,78,47,31,11
Sololá,Casado(a),45 - 64,153,93,60,11
Sololá,Casado(a),65 y más,247,141,106,11
Sololá,Casado(a),Ignorado,3,1,2,11
Sololá,Unido(a),Todas las edades,91,48,43,11
Sololá,Unido(a),Menos de 15 años,0,0,0,11
Sololá,Unido(a),15 - 24,0,0,0,11
Sololá,Unido(a),25 - 44,8,4,4,11
Sololá,Unido(a),45 - 64,21,12,9,11
Sololá,Unido(a),65 y más,62,32,30,11
Sololá,Unido(a),Ignorado,0,0,0,11
Sololá,Ignorado(a),Todas las edades,9,8,1,11
Sololá,Ignorado(a),Menos de 15 años,2,2,0,11
Sololá,Ignorado(a),15 - 24,0,0,0,11
Sololá,Ignorado(a),25 - 44,1,0,1,11
Sololá,Ignorado(a),45 - 64,0,0,0,11
Sololá,Ignorado(a),65 y más,3,3,0,11
Sololá,Ignorado(a),Ignorado,3,3,0,11
Totonicapán,Todos los estados civiles,Todas las edades,1995,1083,912,11
Totonicapán,Todos los estados civiles,Menos de 15 años,206,119,87,11
Totonicapán,Todos los estados civiles,15 - 24,107,62,45,11
Totonicapán,Todos los estados civiles,25 - 44,331,219,112,11
Totonicapán,Todos los estados civiles,45 - 64,432,242,190,11
Totonicapán,Todos los estados civiles,65 y más,900,436,464,11
Totonicapán,Todos los estados civiles,Ignorado,19,5,14,11
Totonicapán,Soltero(a),Todas las edades,1054,540,514,11
Totonicapán,Soltero(a),Menos de 15 años,198,116,82,11
Totonicapán,Soltero(a),15 - 24,87,54,33,11
Totonicapán,Soltero(a),25 - 44,180,119,61,11
Totonicapán,Soltero(a),45 - 64,147,69,78,11
Totonicapán,Soltero(a),65 y más,431,181,250,11
Totonicapán,Soltero(a),Ignorado,11,1,10,11
Totonicapán,Casado(a),Todas las edades,871,496,375,11
Totonicapán,Casado(a),Menos de 15 años,0,0,0,11
Totonicapán,Casado(a),15 - 24,18,7,11,11
Totonicapán,Casado(a),25 - 44,148,98,50,11
Totonicapán,Casado(a),45 - 64,275,165,110,11
Totonicapán,Casado(a),65 y más,426,224,202,11
Totonicapán,Casado(a),Ignorado,4,2,2,11
Totonicapán,Unido(a),Todas las edades,55,41,14,11
Totonicapán,Unido(a),Menos de 15 años,0,0,0,11
Totonicapán,Unido(a),15 - 24,0,0,0,11
Totonicapán,Unido(a),25 - 44,3,2,1,11
Totonicapán,Unido(a),45 - 64,10,8,2,11
Totonicapán,Unido(a),65 y más,42,31,11,11
Totonicapán,Unido(a),Ignorado,0,0,0,11
Totonicapán,Ignorado(a),Todas las edades,15,6,9,11
Totonicapán,Ignorado(a),Menos de 15 años,8,3,5,11
Totonicapán,Ignorado(a),15 - 24,2,1,1,11
Totonicapán,Ignorado(a),25 - 44,0,0,0,11
Totonicapán,Ignorado(a),45 - 64,0,0,0,11
Totonicapán,Ignorado(a),65 y más,1,0,1,11
Totonicapán,Ignorado(a),Ignorado,4,2,2,11
Quetzaltenango,Todos los estados civiles,Todas las edades,3708,2133,1575,11
Quetzaltenango,Todos los estados civiles,Menos de 15 años,275,145,130,11
Quetzaltenango,Todos los estados civiles,15 - 24,211,160,51,11
Quetzaltenango,Todos los estados civiles,25 - 44,571,414,157,11
Quetzaltenango,Todos los estados civiles,45 - 64,808,483,325,11
Quetzaltenango,Todos los estados civiles,65 y más,1792,906,886,11
Quetzaltenango,Todos los estados civiles,Ignorado,51,25,26,11
Quetzaltenango,Soltero(a),Todas las edades,2099,1193,906,11
Quetzaltenango,Soltero(a),Menos de 15 años,273,144,129,11
Quetzaltenango,Soltero(a),15 - 24,190,145,45,11
Quetzaltenango,Soltero(a),25 - 44,341,256,85,11
Quetzaltenango,Soltero(a),45 - 64,359,214,145,11
Quetzaltenango,Soltero(a),65 y más,907,421,486,11
Quetzaltenango,Soltero(a),Ignorado,29,13,16,11
Quetzaltenango,Casado(a),Todas las edades,1554,909,645,11
Quetzaltenango,Casado(a),Menos de 15 años,0,0,0,11
Quetzaltenango,Casado(a),15 - 24,20,14,6,11
Quetzaltenango,Casado(a),25 - 44,224,152,72,11
Quetzaltenango,Casado(a),45 - 64,440,265,175,11
Quetzaltenango,Casado(a),65 y más,855,469,386,11
Quetzaltenango,Casado(a),Ignorado,15,9,6,11
Quetzaltenango,Unido(a),Todas las edades,37,20,17,11
Quetzaltenango,Unido(a),Menos de 15 años,0,0,0,11
Quetzaltenango,Unido(a),15 - 24,0,0,0,11
Quetzaltenango,Unido(a),25 - 44,3,3,0,11
Quetzaltenango,Unido(a),45 - 64,9,4,5,11
Quetzaltenango,Unido(a),65 y más,25,13,12,11
Quetzaltenango,Unido(a),Ignorado,0,0,0,11
Quetzaltenango,Ignorado(a),Todas las edades,18,11,7,11
Quetzaltenango,Ignorado(a),Menos de 15 años,2,1,1,11
Quetzaltenango,Ignorado(a),15 - 24,1,1,0,11
Quetzaltenango,Ignorado(a),25 - 44,3,3,0,11
Quetzaltenango,Ignorado(a),45 - 64,0,0,0,11
Quetzaltenango,Ignorado(a),65 y más,5,3,2,11
Quetzaltenango,Ignorado(a),Ignorado,7,3,4,11
Suchitepéquez,Todos los estados civiles,Todas las edades,2564,1468,1096,11
Suchitepéquez,Todos los estados civiles,Menos de 15 años,180,102,78,11
Suchitepéquez,Todos los estados civiles,15 - 24,166,112,54,11
Suchitepéquez,Todos los estados civiles,25 - 44,425,315,110,11
Suchitepéquez,Todos los estados civiles,45 - 64,567,323,244,11
Suchitepéquez,Todos los estados civiles,65 y más,1199,603,596,11
Suchitepéquez,Todos los estados civiles,Ignorado,27,13,14,11
Suchitepéquez,Soltero(a),Todas las edades,1481,840,641,11
Suchitepéquez,Soltero(a),Menos de 15 años,177,100,77,11
Suchitepéquez,Soltero(a),15 - 24,140,99,41,11
Suchitepéquez,Soltero(a),25 - 44,247,195,52,11
Suchitepéquez,Soltero(a),45 - 64,255,145,110,11
Suchitepéquez,Soltero(a),65 y más,641,289,352,11
Suchitepéquez,Soltero(a),Ignorado,21,12,9,11
Suchitepéquez,Casado(a),Todas las edades,1061,618,443,11
Suchitepéquez,Casado(a),Menos de 15 años,0,0,0,11
Suchitepéquez,Casado(a),15 - 24,24,13,11,11
Suchitepéquez,Casado(a),25 - 44,176,118,58,11
Suchitepéquez,Casado(a),45 - 64,312,178,134,11
Suchitepéquez,Casado(a),65 y más,545,308,237,11
Suchitepéquez,Casado(a),Ignorado,4,1,3,11
Suchitepéquez,Unido(a),Todas las edades,12,5,7,11
Suchitepéquez,Unido(a),Menos de 15 años,0,0,0,11
Suchitepéquez,Unido(a),15 - 24,1,0,1,11
Suchitepéquez,Unido(a),25 - 44,0,0,0,11
Suchitepéquez,Unido(a),45 - 64,0,0,0,11
Suchitepéquez,Unido(a),65 y más,11,5,6,11
Suchitepéquez,Unido(a),Ignorado,0,0,0,11
Suchitepéquez,Ignorado(a),Todas las edades,10,5,5,11
Suchitepéquez,Ignorado(a),Menos de 15 años,3,2,1,11
Suchitepéquez,Ignorado(a),15 - 24,1,0,1,11
Suchitepéquez,Ignorado(a),25 - 44,2,2,0,11
Suchitepéquez,Ignorado(a),45 - 64,0,0,0,11
Suchitepéquez,Ignorado(a),65 y más,2,1,1,11
Suchitepéquez,Ignorado(a),Ignorado,2,0,2,11
Retalhuleu,Todos los estados civiles,Todas las edades,1483,891,592,11
Retalhuleu,Todos los estados civiles,Menos de 15 años,85,42,43,11
Retalhuleu,Todos los estados civiles,15 - 24,74,57,17,11
Retalhuleu,Todos los estados civiles,25 - 44,252,184,68,11
Retalhuleu,Todos los estados civiles,45 - 64,363,218,145,11
Retalhuleu,Todos los estados civiles,65 y más,694,380,314,11
Retalhuleu,Todos los estados civiles,Ignorado,15,10,5,11
Retalhuleu,Soltero(a),Todas las edades,856,508,348,11
Retalhuleu,Soltero(a),Menos de 15 años,85,42,43,11
Retalhuleu,Soltero(a),15 - 24,62,49,13,11
Retalhuleu,Soltero(a),25 - 44,155,119,36,11
Retalhuleu,Soltero(a),45 - 64,180,102,78,11
Retalhuleu,Soltero(a),65 y más,364,191,173,11
Retalhuleu,Soltero(a),Ignorado,10,5,5,11
Retalhuleu,Casado(a),Todas las edades,589,362,227,11
Retalhuleu,Casado(a),Menos de 15 años,0,0,0,11
Retalhuleu,Casado(a),15 - 24,11,7,4,11
Retalhuleu,Casado(a),25 - 44,96,65,31,11
Retalhuleu,Casado(a),45 - 64,178,114,64,11
Retalhuleu,Casado(a),65 y más,303,175,128,11
Retalhuleu,Casado(a),Ignorado,1,1,0,11
Retalhuleu,Unido(a),Todas las edades,30,14,16,11
Retalhuleu,Unido(a),Menos de 15 años,0,0,0,11
Retalhuleu,Unido(a),15 - 24,0,0,0,11
Retalhuleu,Unido(a),25 - 44,1,0,1,11
Retalhuleu,Unido(a),45 - 64,4,1,3,11
Retalhuleu,Unido(a),65 y más,24,12,12,11
Retalhuleu,Unido(a),Ignorado,1,1,0,11
Retalhuleu,Ignorado(a),Todas las edades,8,7,1,11
Retalhuleu,Ignorado(a),Menos de 15 años,0,0,0,11
Retalhuleu,Ignorado(a),15 - 24,1,1,0,11
Retalhuleu,Ignorado(a),25 - 44,0,0,0,11
Retalhuleu,Ignorado(a),45 - 64,1,1,0,11
Retalhuleu,Ignorado(a),65 y más,3,2,1,11
Retalhuleu,Ignorado(a),Ignorado,3,3,0,11
San Marcos,Todos los estados civiles,Todas las edades,4213,2495,1718,11
San Marcos,Todos los estados civiles,Menos de 15 años,251,132,119,11
San Marcos,Todos los estados civiles,15 - 24,238,166,72,11
San Marcos,Todos los estados civiles,25 - 44,757,528,229,11
San Marcos,Todos los estados civiles,45 - 64,971,568,403,11
San Marcos,Todos los estados civiles,65 y más,1950,1072,878,11
San Marcos,Todos los estados civiles,Ignorado,46,29,17,11
San Marcos,Soltero(a),Todas las edades,2556,1508,1048,11
San Marcos,Soltero(a),Menos de 15 años,243,127,116,11
San Marcos,Soltero(a),15 - 24,218,151,67,11
San Marcos,Soltero(a),25 - 44,504,360,144,11
San Marcos,Soltero(a),45 - 64,489,288,201,11
San Marcos,Soltero(a),65 y más,1076,566,510,11
San Marcos,Soltero(a),Ignorado,26,16,10,11
San Marcos,Casado(a),Todas las edades,1586,943,643,11
San Marcos,Casado(a),Menos de 15 años,0,0,0,11
San Marcos,Casado(a),15 - 24,19,14,5,11
San Marcos,Casado(a),25 - 44,246,163,83,11
San Marcos,Casado(a),45 - 64,468,272,196,11
San Marcos,Casado(a),65 y más,845,488,357,11
San Marcos,Casado(a),Ignorado,8,6,2,11
San Marcos,Unido(a),Todas las edades,43,28,15,11
San Marcos,Unido(a),Menos de 15 años,0,0,0,11
San Marcos,Unido(a),15 - 24,1,1,0,11
San Marcos,Unido(a),25 - 44,5,4,1,11
San Marcos,Unido(a),45 - 64,11,6,5,11
San Marcos,Unido(a),65 y más,26,17,9,11
San Marcos,Unido(a),Ignorado,0,0,0,11
San Marcos,Ignorado(a),Todas las edades,28,16,12,11
San Marcos,Ignorado(a),Menos de 15 años,8,5,3,11
San Marcos,Ignorado(a),15 - 24,0,0,0,11
San Marcos,Ignorado(a),25 - 44,2,1,1,11
San Marcos,Ignorado(a),45 - 64,3,2,1,11
San Marcos,Ignorado(a),65 y más,3,1,2,11
San Marcos,Ignorado(a),Ignorado,12,7,5,11
Huehuetenango,Todos los estados civiles,Todas las edades,3865,2181,1684,11
Huehuetenango,Todos los estados civiles,Menos de 15 años,484,270,214,11
Huehuetenango,Todos los estados civiles,15 - 24,304,190,114,11
Huehuetenango,Todos los estados civiles,25 - 44,639,380,259,11
Huehuetenango,Todos los estados civiles,45 - 64,780,420,360,11
Huehuetenango,Todos los estados civiles,65 y más,1624,897,727,11
Huehuetenango,Todos los estados civiles,Ignorado,34,24,10,11
Huehuetenango,Soltero(a),Todas las edades,2515,1423,1092,11
Huehuetenango,Soltero(a),Menos de 15 años,458,258,200,11
Huehuetenango,Soltero(a),15 - 24,271,175,96,11
Huehuetenango,Soltero(a),25 - 44,397,239,158,11
Huehuetenango,Soltero(a),45 - 64,394,214,180,11
Huehuetenango,Soltero(a),65 y más,968,517,451,11
Huehuetenango,Soltero(a),Ignorado,27,20,7,11
Huehuetenango,Casado(a),Todas las edades,1293,733,560,11
Huehuetenango,Casado(a),Menos de 15 años,0,0,0,11
Huehuetenango,Casado(a),15 - 24,33,15,18,11
Huehuetenango,Casado(a),25 - 44,241,140,101,11
Huehuetenango,Casado(a),45 - 64,382,205,177,11
Huehuetenango,Casado(a),65 y más,633,371,262,11
Huehuetenango,Casado(a),Ignorado,4,2,2,11
Huehuetenango,Unido(a),Todas las edades,26,10,16,11
Huehuetenango,Unido(a),Menos de 15 años,0,0,0,11
Huehuetenango,Unido(a),15 - 24,0,0,0,11
Huehuetenango,Unido(a),25 - 44,0,0,0,11
Huehuetenango,Unido(a),45 - 64,4,1,3,11
Huehuetenango,Unido(a),65 y más,22,9,13,11
Huehuetenango,Unido(a),Ignorado,0,0,0,11
Huehuetenango,Ignorado(a),Todas las edades,31,15,16,11
Huehuetenango,Ignorado(a),Menos de 15 años,26,12,14,11
Huehuetenango,Ignorado(a),15 - 24,0,0,0,11
Huehuetenango,Ignorado(a),25 - 44,1,1,0,11
Huehuetenango,Ignorado(a),45 - 64,0,0,0,11
Huehuetenango,Ignorado(a),65 y más,1,0,1,11
Huehuetenango,Ignorado(a),Ignorado,3,2,1,11
Quiché,Todos los estados civiles,Todas las edades,3394,1839,1555,11
Quiché,Todos los estados civiles,Menos de 15 años,543,316,227,11
Quiché,Todos los estados civiles,15 - 24,199,132,67,11
Quiché,Todos los estados civiles,25 - 44,553,338,215,11
Quiché,Todos los estados civiles,45 - 64,665,361,304,11
Quiché,Todos los estados civiles,65 y más,1401,672,729,11
Quiché,Todos los estados civiles,Ignorado,33,20,13,11
Quiché,Soltero(a),Todas las edades,2306,1227,1079,11
Quiché,Soltero(a),Menos de 15 años,526,308,218,11
Quiché,Soltero(a),15 - 24,177,122,55,11
Quiché,Soltero(a),25 - 44,318,208,110,11
Quiché,Soltero(a),45 - 64,323,170,153,11
Quiché,Soltero(a),65 y más,940,406,534,11
Quiché,Soltero(a),Ignorado,22,13,9,11
Quiché,Casado(a),Todas las edades,1036,583,453,11
Quiché,Casado(a),Menos de 15 años,0,0,0,11
Quiché,Casado(a),15 - 24,21,10,11,11
Quiché,Casado(a),25 - 44,231,126,105,11
Quiché,Casado(a),45 - 64,339,191,148,11
Quiché,Casado(a),65 y más,440,252,188,11
Quiché,Casado(a),Ignorado,5,4,1,11
Quiché,Unido(a),Todas las edades,20,14,6,11
Quiché,Unido(a),Menos de 15 años,0,0,0,11
Quiché,Unido(a),15 - 24,0,0,0,11
Quiché,Unido(a),25 - 44,1,1,0,11
Quiché,Unido(a),45 - 64,3,0,3,11
Quiché,Unido(a),65 y más,15,12,3,11
Quiché,Unido(a),Ignorado,1,1,0,11
Quiché,Ignorado(a),Todas las edades,32,15,17,11
Quiché,Ignorado(a),Menos de 15 años,17,8,9,11
Quiché,Ignorado(a),15 - 24,1,0,1,11
Quiché,Ignorado(a),25 - 44,3,3,0,11
Quiché,Ignorado(a),45 - 64,0,0,0,11
Quiché,Ignorado(a),65 y más,6,2,4,11
Quiché,Ignorado(a),Ignorado,5,2,3,11
Baja Verapaz,Todos los estados civiles,Todas las edades,1197,654,543,11
Baja Verapaz,Todos los estados civiles,Menos de 15 años,158,87,71,11
Baja Verapaz,Todos los estados civiles,15 - 24,71,45,26,11
Baja Verapaz,Todos los estados civiles,25 - 44,164,113,51,11
Baja Verapaz,Todos los estados civiles,45 - 64,227,116,111,11
Baja Verapaz,Todos los estados civiles,65 y más,565,285,280,11
Baja Verapaz,Todos los estados civiles,Ignorado,12,8,4,11
Baja Verapaz,Soltero(a),Todas las edades,685,362,323,11
Baja Verapaz,Soltero(a),Menos de 15 años,158,87,71,11
Baja Verapaz,Soltero(a),15 - 24,60,39,21,11
Baja Verapaz,Soltero(a),25 - 44,89,61,28,11
Baja Verapaz,Soltero(a),45 - 64,96,45,51,11
Baja Verapaz,Soltero(a),65 y más,275,126,149,11
Baja Verapaz,Soltero(a),Ignorado,7,4,3,11
Baja Verapaz,Casado(a),Todas las edades,494,283,211,11
Baja Verapaz,Casado(a),Menos de 15 años,0,0,0,11
Baja Verapaz,Casado(a),15 - 24,11,6,5,11
Baja Verapaz,Casado(a),25 - 44,75,52,23,11
Baja Verapaz,Casado(a),45 - 64,128,69,59,11
Baja Verapaz,Casado(a),65 y más,276,153,123,11
Baja Verapaz,Casado(a),Ignorado,4,3,1,11
Baja Verapaz,Unido(a),Todas las edades,17,8,9,11
Baja Verapaz,Unido(a),Menos de 15 años,0,0,0,11
Baja Verapaz,Unido(a),15 - 24,0,0,0,11
Baja Verapaz,Unido(a),25 - 44,0,0,0,11
Baja Verapaz,Unido(a),45 - 64,3,2,1,11
Baja Verapaz,Unido(a),65 y más,14,6,8,11
Baja Verapaz,Unido(a),Ignorado,0,0,0,11
Baja Verapaz,Ignorado(a),Todas las edades,1,1,0,11
Baja Verapaz,Ignorado(a),Menos de 15 años,0,0,0,11
Baja Verapaz,Ignorado(a),15 - 24,0,0,0,11
Baja Verapaz,Ignorado(a),25 - 44,0,0,0,11
Baja Verapaz,Ignorado(a),45 - 64,0,0,0,11
Baja Verapaz,Ignorado(a),65 y más,0,0,0,11
Baja Verapaz,Ignorado(a),Ignorado,1,1,0,11
Alta Verapaz,Todos los estados civiles,Todas las edades,3736,1966,1770,11
Alta Verapaz,Todos los estados civiles,Menos de 15 años,673,370,303,11
Alta Verapaz,Todos los estados civiles,15 - 24,279,167,112,11
Alta Verapaz,Todos los estados civiles,25 - 44,537,331,206,11
Alta Verapaz,Todos los estados civiles,45 - 64,728,366,362,11
Alta Verapaz,Todos los estados civiles,65 y más,1465,694,771,11
Alta Verapaz,Todos los estados civiles,Ignorado,54,38,16,11
Alta Verapaz,Soltero(a),Todas las edades,2059,1055,1004,11
Alta Verapaz,Soltero(a),Menos de 15 años,664,364,300,11
Alta Verapaz,Soltero(a),15 - 24,255,156,99,11
Alta Verapaz,Soltero(a),25 - 44,269,172,97,11
Alta Verapaz,Soltero(a),45 - 64,220,106,114,11
Alta Verapaz,Soltero(a),65 y más,610,228,382,11
Alta Verapaz,Soltero(a),Ignorado,41,29,12,11
Alta Verapaz,Casado(a),Todas las edades,1638,885,753,11
Alta Verapaz,Casado(a),Menos de 15 años,0,0,0,11
Alta Verapaz,Casado(a),15 - 24,24,11,13,11
Alta Verapaz,Casado(a),25 - 44,263,157,106,11
Alta Verapaz,Casado(a),45 - 64,497,252,245,11
Alta Verapaz,Casado(a),65 y más,846,461,385,11
Alta Verapaz,Casado(a),Ignorado,8,4,4,11
Alta Verapaz,Unido(a),Todas las edades,26,16,10,11
Alta Verapaz,Unido(a),Menos de 15 años,0,0,0,11
Alta Verapaz,Unido(a),15 - 24,0,0,0,11
Alta Verapaz,Unido(a),25 - 44,5,2,3,11
Alta Verapaz,Unido(a),45 - 64,10,7,3,11
Alta Verapaz,Unido(a),65 y más,9,5,4,11
Alta Verapaz,Unido(a),Ignorado,2,2,0,11
Alta Verapaz,Ignorado(a),Todas las edades,13,10,3,11
Alta Verapaz,Ignorado(a),Menos de 15 años,9,6,3,11
Alta Verapaz,Ignorado(a),15 - 24,0,0,0,11
Alta Verapaz,Ignorado(a),25 - 44,0,0,0,11
Alta Verapaz,Ignorado(a),45 - 64,1,1,0,11
Alta Verapaz,Ignorado(a),65 y más,0,0,0,11
Alta Verapaz,Ignorado(a),Ignorado,3,3,0,11
Petén,Todos los estados civiles,Todas las edades,1669,1028,641,11
Petén,Todos los estados civiles,Menos de 15 años,165,90,75,11
Petén,Todos los estados civiles,15 - 24,175,135,40,11
Petén,Todos los estados civiles,25 - 44,322,231,91,11
Petén,Todos los estados civiles,45 - 64,357,182,175,11
Petén,Todos los estados civiles,65 y más,577,331,246,11
Petén,Todos los estados civiles,Ignorado,73,59,14,11
Petén,Soltero(a),Todas las edades,1018,640,378,11
Petén,Soltero(a),Menos de 15 años,163,89,74,11
Petén,Soltero(a),15 - 24,163,127,36,11
Petén,Soltero(a),25 - 44,220,165,55,11
Petén,Soltero(a),45 - 64,150,80,70,11
Petén,Soltero(a),65 y más,282,148,134,11
Petén,Soltero(a),Ignorado,40,31,9,11
Petén,Casado(a),Todas las edades,538,314,224,11
Petén,Casado(a),Menos de 15 años,0,0,0,11
Petén,Casado(a),15 - 24,9,5,4,11
Petén,Casado(a),25 - 44,82,56,26,11
Petén,Casado(a),45 - 64,176,83,93,11
Petén,Casado(a),65 y más,263,164,99,11
Petén,Casado(a),Ignorado,8,6,2,11
Petén,Unido(a),Todas las edades,85,51,34,11
Petén,Unido(a),Menos de 15 años,0,0,0,11
Petén,Unido(a),15 - 24,2,2,0,11
Petén,Unido(a),25 - 44,20,10,10,11
Petén,Unido(a),45 - 64,31,19,12,11
Petén,Unido(a),65 y más,30,19,11,11
Petén,Unido(a),Ignorado,2,1,1,11
Petén,Ignorado(a),Todas las edades,28,23,5,11
Petén,Ignorado(a),Menos de 15 años,2,1,1,11
Petén,Ignorado(a),15 - 24,1,1,0,11
Petén,Ignorado(a),25 - 44,0,0,0,11
Petén,Ignorado(a),45 - 64,0,0,0,11
Petén,Ignorado(a),65 y más,2,0,2,11
Petén,Ignorado(a),Ignorado,23,21,2,11
Izabal,Todos los estados civiles,Todas las edades,1783,1039,744,11
Izabal,Todos los estados civiles,Menos de 15 años,162,94,68,11
Izabal,Todos los estados civiles,15 - 24,138,105,33,11
Izabal,Todos los estados civiles,25 - 44,329,233,96,11
Izabal,Todos los estados civiles,45 - 64,391,199,192,11
Izabal,Todos los estados civiles,65 y más,758,405,353,11
Izabal,Todos los estados civiles,Ignorado,5,3,2,11
Izabal,Soltero(a),Todas las edades,1129,669,460,11
Izabal,Soltero(a),Menos de 15 años,160,93,67,11
Izabal,Soltero(a),15 - 24,134,102,32,11
Izabal,Soltero(a),25 - 44,228,167,61,11
Izabal,Soltero(a),45 - 64,204,104,100,11
Izabal,Soltero(a),65 y más,401,202,199,11
Izabal,Soltero(a),Ignorado,2,1,1,11
Izabal,Casado(a),Todas las edades,596,346,250,11
Izabal,Casado(a),Menos de 15 años,0,0,0,11
Izabal,Casado(a),15 - 24,4,3,1,11
Izabal,Casado(a),25 - 44,101,66,35,11
Izabal,Casado(a),45 - 64,177,93,84,11
Izabal,Casado(a),65 y más,311,182,129,11
Izabal,Casado(a),Ignorado,3,2,1,11
Izabal,Unido(a),Todas las edades,54,22,32,11
Izabal,Unido(a),Menos de 15 años,0,0,0,11
Izabal,Unido(a),15 - 24,0,0,0,11
Izabal,Unido(a),25 - 44,0,0,0,11
Izabal,Unido(a),45 - 64,9,2,7,11
Izabal,Unido(a),65 y más,45,20,25,11
Izabal,Unido(a),Ignorado,0,0,0,11
Izabal,Ignorado(a),Todas las edades,4,2,2,11
Izabal,Ignorado(a),Menos de 15 años,2,1,1,11
Izabal,Ignorado(a),15 - 24,0,0,0,11
Izabal,Ignorado(a),25 - 44,0,0,0,11
Izabal,Ignorado(a),45 - 64,1,0,1,11
Izabal,Ignorado(a),65 y más,1,1,0,11
Izabal,Ignorado(a),Ignorado,0,0,0,11
Zacapa,Todos los estados civiles,Todas las edades,1366,801,565,11
Zacapa,Todos los estados civiles,Menos de 15 años,74,44,30,11
Zacapa,Todos los estados civiles,15 - 24,96,68,28,11
Zacapa,Todos los estados civiles,25 - 44,251,191,60,11
Zacapa,Todos los estados civiles,45 - 64,301,161,140,11
Zacapa,Todos los estados civiles,65 y más,640,334,306,11
Zacapa,Todos los estados civiles,Ignorado,4,3,1,11
Zacapa,Soltero(a),Todas las edades,846,484,362,11
Zacapa,Soltero(a),Menos de 15 años,72,44,28,11
Zacapa,Soltero(a),15 - 24,90,65,25,11
Zacapa,Soltero(a),25 - 44,177,137,40,11
Zacapa,Soltero(a),45 - 64,149,79,70,11
Zacapa,Soltero(a),65 y más,356,158,198,11
Zacapa,Soltero(a),Ignorado,2,1,1,11
Zacapa,Casado(a),Todas las edades,514,313,201,11
Zacapa,Casado(a),Menos de 15 años,0,0,0,11
Zacapa,Casado(a),15 - 24,6,3,3,11
Zacapa,Casado(a),25 - 44,74,54,20,11
Zacapa,Casado(a),45 - 64,152,82,70,11
Zacapa,Casado(a),65 y más,282,174,108,11
Zacapa,Casado(a),Ignorado,0,0,0,11
Zacapa,Unido(a),Todas las edades,1,1,0,11
Zacapa,Unido(a),Menos de 15 años,0,0,0,11
Zacapa,Unido(a),15 - 24,0,0,0,11
Zacapa,Unido(a),25 - 44,0,0,0,11
Zacapa,Unido(a),45 - 64,0,0,0,11
Zacapa,Unido(a),65 y más,1,1,0,11
Zacapa,Unido(a),Ignorado,0,0,0,11
Zacapa,Ignorado(a),Todas las edades,5,3,2,11
Zacapa,Ignorado(a),Menos de 15 años,2,0,2,11
Zacapa,Ignorado(a),15 - 24,0,0,0,11
Zacapa,Ignorado(a),25 - 44,0,0,0,11
Zacapa,Ignorado(a),45 - 64,0,0,0,11
Zacapa,Ignorado(a),65 y más,1,1,0,11
Zacapa,Ignorado(a),Ignorado,2,2,0,11
Chiquimula,Todos los estados civiles,Todas las edades,1929,1094,835,11
Chiquimula,Todos los estados civiles,Menos de 15 años,215,96,119,11
Chiquimula,Todos los estados civiles,15 - 24,144,97,47,11
Chiquimula,Todos los estados civiles,25 - 44,328,250,78,11
Chiquimula,Todos los estados civiles,45 - 64,424,225,199,11
Chiquimula,Todos los estados civiles,65 y más,791,412,379,11
Chiquimula,Todos los estados civiles,Ignorado,27,14,13,11
Chiquimula,Soltero(a),Todas las edades,1258,704,554,11
Chiquimula,Soltero(a),Menos de 15 años,202,92,110,11
Chiquimula,Soltero(a),15 - 24,137,94,43,11
Chiquimula,Soltero(a),25 - 44,210,168,42,11
Chiquimula,Soltero(a),45 - 64,246,117,129,11
Chiquimula,Soltero(a),65 y más,447,225,222,11
Chiquimula,Soltero(a),Ignorado,16,8,8,11
Chiquimula,Casado(a),Todas las edades,640,380,260,11
Chiquimula,Casado(a),Menos de 15 años,0,0,0,11
Chiquimula,Casado(a),15 - 24,7,3,4,11
Chiquimula,Casado(a),25 - 44,116,81,35,11
Chiquimula,Casado(a),45 - 64,175,107,68,11
Chiquimula,Casado(a),65 y más,339,186,153,11
Chiquimula,Casado(a),Ignorado,3,3,0,11
Chiquimula,Unido(a),Todas las edades,10,3,7,11
Chiquimula,Unido(a),Menos de 15 años,0,0,0,11
Chiquimula,Unido(a),15 - 24,0,0,0,11
Chiquimula,Unido(a),25 - 44,2,1,1,11
Chiquimula,Unido(a),45 - 64,3,1,2,11
Chiquimula,Unido(a),65 y más,5,1,4,11
Chiquimula,Unido(a),Ignorado,0,0,0,11
Chiquimula,Ignorado(a),Todas las edades,21,7,14,11
Chiquimula,Ignorado(a),Menos de 15 años,13,4,9,11
Chiquimula,Ignorado(a),15 - 24,0,0,0,11
Chiquimula,Ignorado(a),25 - 44,0,0,0,11
Chiquimula,Ignorado(a),45 - 64,0,0,0,11
Chiquimula,Ignorado(a),65 y más,0,0,0,11
Chiquimula,Ignorado(a),Ignorado,8,3,5,11
Jalapa,Todos los estados civiles,Todas las edades,1571,884,687,11
Jalapa,Todos los estados civiles,Menos de 15 años,207,109,98,11
Jalapa,Todos los estados civiles,15 - 24,122,92,30,11
Jalapa,Todos los estados civiles,25 - 44,291,212,79,11
Jalapa,Todos los estados civiles,45 - 64,289,162,127,11
Jalapa,Todos los estados civiles,65 y más,652,305,347,11
Jalapa,Todos los estados civiles,Ignorado,10,4,6,11
Jalapa,Soltero(a),Todas las edades,896,498,398,11
Jalapa,Soltero(a),Menos de 15 años,200,106,94,11
Jalapa,Soltero(a),15 - 24,111,84,27,11
Jalapa,Soltero(a),25 - 44,168,122,46,11
Jalapa,Soltero(a),45 - 64,103,59,44,11
Jalapa,Soltero(a),65 y más,305,124,181,11
Jalapa,Soltero(a),Ignorado,9,3,6,11
Jalapa,Casado(a),Todas las edades,662,379,283,11
Jalapa,Casado(a),Menos de 15 años,0,0,0,11
Jalapa,Casado(a),15 - 24,11,8,3,11
Jalapa,Casado(a),25 - 44,123,90,33,11
Jalapa,Casado(a),45 - 64,186,103,83,11
Jalapa,Casado(a),65 y más,342,178,164,11
Jalapa,Casado(a),Ignorado,0,0,0,11
Jalapa,Unido(a),Todas las edades,4,3,1,11
Jalapa,Unido(a),Menos de 15 años,0,0,0,11
Jalapa,Unido(a),15 - 24,0,0,0,11
Jalapa,Unido(a),25 - 44,0,0,0,11
Jalapa,Unido(a),45 - 64,0,0,0,11
Jalapa,Unido(a),65 y más,4,3,1,11
Jalapa,Unido(a),Ignorado,0,0,0,11
Jalapa,Ignorado(a),Todas las edades,9,4,5,11
Jalapa,Ignorado(a),Menos de 15 años,7,3,4,11
Jalapa,Ignorado(a),15 - 24,0,0,0,11
Jalapa,Ignorado(a),25 - 44,0,0,0,11
Jalapa,Ignorado(a),45 - 64,0,0,0,11
Jalapa,Ignorado(a),65 y más,1,0,1,11
Jalapa,Ignorado(a),Ignorado,1,1,0,11
Jutiapa,Todos los estados civiles,Todas las edades,2481,1485,996,11
Jutiapa,Todos los estados civiles,Menos de 15 años,92,49,43,11
Jutiapa,Todos los estados civiles,15 - 24,177,129,48,11
Jutiapa,Todos los estados civiles,25 - 44,400,305,95,11
Jutiapa,Todos los estados civiles,45 - 64,559,305,254,11
Jutiapa,Todos los estados civiles,65 y más,1244,692,552,11
Jutiapa,Todos los estados civiles,Ignorado,9,5,4,11
Jutiapa,Soltero(a),Todas las edades,1485,892,593,11
Jutiapa,Soltero(a),Menos de 15 años,87,48,39,11
Jutiapa,Soltero(a),15 - 24,160,120,40,11
Jutiapa,Soltero(a),25 - 44,263,209,54,11
Jutiapa,Soltero(a),45 - 64,282,154,128,11
Jutiapa,Soltero(a),65 y más,687,358,329,11
Jutiapa,Soltero(a),Ignorado,6,3,3,11
Jutiapa,Casado(a),Todas las edades,962,577,385,11
Jutiapa,Casado(a),Menos de 15 años,0,0,0,11
Jutiapa,Casado(a),15 - 24,14,7,7,11
Jutiapa,Casado(a),25 - 44,133,95,38,11
Jutiapa,Casado(a),45 - 64,271,146,125,11
Jutiapa,Casado(a),65 y más,541,327,214,11
Jutiapa,Casado(a),Ignorado,3,2,1,11
Jutiapa,Unido(a),Todas las edades,22,12,10,11
Jutiapa,Unido(a),Menos de 15 años,0,0,0,11
Jutiapa,Unido(a),15 - 24,0,0,0,11
Jutiapa,Unido(a),25 - 44,3,1,2,11
Jutiapa,Unido(a),45 - 64,6,5,1,11
Jutiapa,Unido(a),65 y más,13,6,7,11
Jutiapa,Unido(a),Ignorado,0,0,0,11
Jutiapa,Ignorado(a),Todas las edades,12,4,8,11
Jutiapa,Ignorado(a),Menos de 15 años,5,1,4,11
Jutiapa,Ignorado(a),15 - 24,3,2,1,11
Jutiapa,Ignorado(a),25 - 44,1,0,1,11
Jutiapa,Ignorado(a),45 - 64,0,0,0,11
Jutiapa,Ignorado(a),65 y más,3,1,2,11
Jutiapa,Ignorado(a),Ignorado,0,0,0,11
Extranjero,Todos los estados civiles,Todas las edades,144,91,53,11
Extranjero,Todos los estados civiles,Menos de 15 años,10,2,8,11
Extranjero,Todos los estados civiles,15 - 24,16,12,4,11
Extranjero,Todos los estados civiles,25 - 44,64,43,21,11
Extranjero,Todos los estados civiles,45 - 64,30,20,10,11
Extranjero,Todos los estados civiles,65 y más,20,11,9,11
Extranjero,Todos los estados civiles,Ignorado,4,3,1,11
Extranjero,Soltero(a),Todas las edades,104,63,41,11
Extranjero,Soltero(a),Menos de 15 años,8,2,6,11
Extranjero,Soltero(a),15 - 24,15,11,4,11
Extranjero,Soltero(a),25 - 44,51,35,16,11
Extranjero,Soltero(a),45 - 64,20,12,8,11
Extranjero,Soltero(a),65 y más,8,2,6,11
Extranjero,Soltero(a),Ignorado,2,1,1,11
Extranjero,Casado(a),Todas las edades,23,17,6,11
Extranjero,Casado(a),Menos de 15 años,0,0,0,11
Extranjero,Casado(a),15 - 24,0,0,0,11
Extranjero,Casado(a),25 - 44,9,6,3,11
Extranjero,Casado(a),45 - 64,3,3,0,11
Extranjero,Casado(a),65 y más,10,7,3,11
Extranjero,Casado(a),Ignorado,1,1,0,11
Extranjero,Unido(a),Todas las edades,1,1,0,11
Extranjero,Unido(a),Menos de 15 años,0,0,0,11
Extranjero,Unido(a),15 - 24,0,0,0,11
Extranjero,Unido(a),25 - 44,1,1,0,11
Extranjero,Unido(a),45 - 64,0,0,0,11
Extranjero,Unido(a),65 y más,0,0,0,11
Extranjero,Unido(a),Ignorado,0,0,0,11
Extranjero,Ignorado(a),Todas las edades,16,10,6,11
Extranjero,Ignorado(a),Menos de 15 años,2,0,2,11
Extranjero,Ignorado(a),15 - 24,1,1,0,11
Extranjero,Ignorado(a),25 - 44,3,1,2,11
Extranjero,Ignorado(a),45 - 64,7,5,2,11
Extranjero,Ignorado(a),65 y más,2,2,0,11
Extranjero,Ignorado(a),Ignorado,1,1,0,11
Ignorado,Todos los estados civiles,Todas las edades,5925,3455,2470,11
Ignorado,Todos los estados civiles,Menos de 15 años,4628,2536,2092,11
Ignorado,Todos los estados civiles,15 - 24,367,262,105,11
Ignorado,Todos los estados civiles,25 - 44,269,215,54,11
Ignorado,Todos los estados civiles,45 - 64,193,144,49,11
Ignorado,Todos los estados civiles,65 y más,129,56,73,11
Ignorado,Todos los estados civiles,Ignorado,339,242,97,11
Ignorado,Soltero(a),Todas las edades,5402,3040,2362,11
Ignorado,Soltero(a),Menos de 15 años,4610,2524,2086,11
Ignorado,Soltero(a),15 - 24,324,225,99,11
Ignorado,Soltero(a),25 - 44,121,97,24,11
Ignorado,Soltero(a),45 - 64,76,53,23,11
Ignorado,Soltero(a),65 y más,101,35,66,11
Ignorado,Soltero(a),Ignorado,170,106,64,11
Ignorado,Casado(a),Todas las edades,41,28,13,11
Ignorado,Casado(a),Menos de 15 años,0,0,0,11
Ignorado,Casado(a),15 - 24,2,1,1,11
Ignorado,Casado(a),25 - 44,17,13,4,11
Ignorado,Casado(a),45 - 64,13,7,6,11
Ignorado,Casado(a),65 y más,9,7,2,11
Ignorado,Casado(a),Ignorado,0,0,0,11
Ignorado,Unido(a),Todas las edades,0,0,0,11
Ignorado,Unido(a),Menos de 15 años,0,0,0,11
Ignorado,Unido(a),15 - 24,0,0,0,11
Ignorado,Unido(a),25 - 44,0,0,0,11
Ignorado,Unido(a),45 - 64,0,0,0,11
Ignorado,Unido(a),65 y más,0,0,0,11
Ignorado,Unido(a),Ignorado,0,0,0,11
Ignorado,Ignorado(a),Todas las edades,482,387,95,11
Ignorado,Ignorado(a),Menos de 15 años,18,12,6,11
Ignorado,Ignorado(a),15 - 24,41,36,5,11
Ignorado,Ignorado(a),25 - 44,131,105,26,11
Ignorado,Ignorado(a),45 - 64,104,84,20,11
Ignorado,Ignorado(a),65 y más,19,14,5,11
Ignorado,Ignorado(a),Ignorado,169,136,33,11
Todos los departamentos,Todos los estados civiles,Todas las edades,72657,41099,31558,12
Todos los departamentos,Todos los estados civiles,Menos de 15 años,11168,6128,5040,12
Todos los departamentos,Todos los estados civiles,15 - 24,4819,3468,1351,12
Todos los departamentos,Todos los estados civiles,25 - 44,10831,7620,3211,12
Todos los departamentos,Todos los estados civiles,45 - 64,14357,7978,6379,12
Todos los departamentos,Todos los estados civiles,65 y más,30583,15314,15269,12
Todos los departamentos,Todos los estados civiles,Ignorado,899,591,308,12
Todos los departamentos,Soltero(a),Todas las edades,45292,25364,19928,12
Todos los departamentos,Soltero(a),Menos de 15 años,11168,6128,5040,12
Todos los departamentos,Soltero(a),15 - 24,4383,3212,1171,12
Todos los departamentos,Soltero(a),25 - 44,6682,4841,1841,12
Todos los departamentos,Soltero(a),45 - 64,6552,3616,2936,12
Todos los departamentos,Soltero(a),65 y más,16022,7277,8745,12
Todos los departamentos,Soltero(a),Ignorado,485,290,195,12
Todos los departamentos,Casado(a),Todas las edades,25940,14811,11129,12
Todos los departamentos,Casado(a),Menos de 15 años,0,0,0,12
Todos los departamentos,Casado(a),15 - 24,374,212,162,12
Todos los departamentos,Casado(a),25 - 44,3941,2606,1335,12
Todos los departamentos,Casado(a),45 - 64,7562,4217,3345,12
Todos los departamentos,Casado(a),65 y más,13984,7732,6252,12
Todos los departamentos,Casado(a),Ignorado,79,44,35,12
Todos los departamentos,Unido(a),Todas las edades,670,342,328,12
Todos los departamentos,Unido(a),Menos de 15 años,0,0,0,12
Todos los departamentos,Unido(a),15 - 24,1,1,0,12
Todos los departamentos,Unido(a),25 - 44,34,20,14,12
Todos los departamentos,Unido(a),45 - 64,142,64,78,12
Todos los departamentos,Unido(a),65 y más,487,256,231,12
Todos los departamentos,Unido(a),Ignorado,6,1,5,12
Todos los departamentos,Ignorado(a),Todas las edades,755,582,173,12
Todos los departamentos,Ignorado(a),Menos de 15 años,0,0,0,12
Todos los departamentos,Ignorado(a),15 - 24,61,43,18,12
Todos los departamentos,Ignorado(a),25 - 44,174,153,21,12
Todos los departamentos,Ignorado(a),45 - 64,101,81,20,12
Todos los departamentos,Ignorado(a),65 y más,90,49,41,12
Todos los departamentos,Ignorado(a),Ignorado,329,256,73,12
Guatemala,Todos los estados civiles,Todas las edades,17302,9657,7645,12
Guatemala,Todos los estados civiles,Menos de 15 años,2206,1216,990,12
Guatemala,Todos los estados civiles,15 - 24,1282,1022,260,12
Guatemala,Todos los estados civiles,25 - 44,2540,1891,649,12
Guatemala,Todos los estados civiles,45 - 64,3518,1940,1578,12
Guatemala,Todos los estados civiles,65 y más,7665,3528,4137,12
Guatemala,Todos los estados civiles,Ignorado,91,60,31,12
Guatemala,Soltero(a),Todas las edades,10305,5765,4540,12
Guatemala,Soltero(a),Menos de 15 años,2206,1216,990,12
Guatemala,Soltero(a),15 - 24,1204,963,241,12
Guatemala,Soltero(a),25 - 44,1673,1269,404,12
Guatemala,Soltero(a),45 - 64,1665,893,772,12
Guatemala,Soltero(a),65 y más,3507,1391,2116,12
Guatemala,Soltero(a),Ignorado,50,33,17,12
Guatemala,Casado(a),Todas las edades,6808,3760,3048,12
Guatemala,Casado(a),Menos de 15 años,0,0,0,12
Guatemala,Casado(a),15 - 24,59,42,17,12
Guatemala,Casado(a),25 - 44,818,578,240,12
Guatemala,Casado(a),45 - 64,1817,1020,797,12
Guatemala,Casado(a),65 y más,4099,2112,1987,12
Guatemala,Casado(a),Ignorado,15,8,7,12
Guatemala,Unido(a),Todas las edades,38,14,24,12
Guatemala,Unido(a),Menos de 15 años,0,0,0,12
Guatemala,Unido(a),15 - 24,0,0,0,12
Guatemala,Unido(a),25 - 44,2,1,1,12
Guatemala,Unido(a),45 - 64,5,3,2,12
Guatemala,Unido(a),65 y más,31,10,21,12
Guatemala,Unido(a),Ignorado,0,0,0,12
Guatemala,Ignorado(a),Todas las edades,151,118,33,12
Guatemala,Ignorado(a),Menos de 15 años,0,0,0,12
Guatemala,Ignorado(a),15 - 24,19,17,2,12
Guatemala,Ignorado(a),25 - 44,47,43,4,12
Guatemala,Ignorado(a),45 - 64,31,24,7,12
Guatemala,Ignorado(a),65 y más,28,15,13,12
Guatemala,Ignorado(a),Ignorado,26,19,7,12
El Progreso,Todos los estados civiles,Todas las edades,964,529,435,12
El Progreso,Todos los estados civiles,Menos de 15 años,90,39,51,12
El Progreso,Todos los estados civiles,15 - 24,54,37,17,12
El Progreso,Todos los estados civiles,25 - 44,126,97,29,12
El Progreso,Todos los estados civiles,45 - 64,188,94,94,12
El Progreso,Todos los estados civiles,65 y más,502,261,241,12
El Progreso,Todos los estados civiles,Ignorado,4,1,3,12
El Progreso,Soltero(a),Todas las edades,635,342,293,12
El Progreso,Soltero(a),Menos de 15 años,90,39,51,12
El Progreso,Soltero(a),15 - 24,51,37,14,12
El Progreso,Soltero(a),25 - 44,78,62,16,12
El Progreso,Soltero(a),45 - 64,100,55,45,12
El Progreso,Soltero(a),65 y más,312,148,164,12
El Progreso,Soltero(a),Ignorado,4,1,3,12
El Progreso,Casado(a),Todas las edades,323,183,140,12
El Progreso,Casado(a),Menos de 15 años,0,0,0,12
El Progreso,Casado(a),15 - 24,3,0,3,12
El Progreso,Casado(a),25 - 44,48,35,13,12
El Progreso,Casado(a),45 - 64,88,39,49,12
El Progreso,Casado(a),65 y más,184,109,75,12
El Progreso,Casado(a),Ignorado,0,0,0,12
El Progreso,Unido(a),Todas las edades,6,4,2,12
El Progreso,Unido(a),Menos de 15 años,0,0,0,12
El Progreso,Unido(a),15 - 24,0,0,0,12
El Progreso,Unido(a),25 - 44,0,0,0,12
El Progreso,Unido(a),45 - 64,0,0,0,12
El Progreso,Unido(a),65 y más,6,4,2,12
El Progreso,Unido(a),Ignorado,0,0,0,12
El Progreso,Ignorado(a),Todas las edades,0,0,0,12
El Progreso,Ignorado(a),Menos de 15 años,0,0,0,12
El Progreso,Ignorado(a),15 - 24,0,0,0,12
El Progreso,Ignorado(a),25 - 44,0,0,0,12
El Progreso,Ignorado(a),45 - 64,0,0,0,12
El Progreso,Ignorado(a),65 y más,0,0,0,12
El Progreso,Ignorado(a),Ignorado,0,0,0,12
Sacatepéquez,Todos los estados civiles,Todas las edades,1605,862,743,12
Sacatepéquez,Todos los estados civiles,Menos de 15 años,193,107,86,12
Sacatepéquez,Todos los estados civiles,15 - 24,89,68,21,12
Sacatepéquez,Todos los estados civiles,25 - 44,192,138,54,12
Sacatepéquez,Todos los estados civiles,45 - 64,349,184,165,12
Sacatepéquez,Todos los estados civiles,65 y más,770,358,412,12
Sacatepéquez,Todos los estados civiles,Ignorado,12,7,5,12
Sacatepéquez,Soltero(a),Todas las edades,793,425,368,12
Sacatepéquez,Soltero(a),Menos de 15 años,193,107,86,12
Sacatepéquez,Soltero(a),15 - 24,82,64,18,12
Sacatepéquez,Soltero(a),25 - 44,93,73,20,12
Sacatepéquez,Soltero(a),45 - 64,118,57,61,12
Sacatepéquez,Soltero(a),65 y más,303,121,182,12
Sacatepéquez,Soltero(a),Ignorado,4,3,1,12
Sacatepéquez,Casado(a),Todas las edades,797,431,366,12
Sacatepéquez,Casado(a),Menos de 15 años,0,0,0,12
Sacatepéquez,Casado(a),15 - 24,6,3,3,12
Sacatepéquez,Casado(a),25 - 44,99,65,34,12
Sacatepéquez,Casado(a),45 - 64,231,127,104,12
Sacatepéquez,Casado(a),65 y más,460,236,224,12
Sacatepéquez,Casado(a),Ignorado,1,0,1,12
Sacatepéquez,Unido(a),Todas las edades,6,0,6,12
Sacatepéquez,Unido(a),Menos de 15 años,0,0,0,12
Sacatepéquez,Unido(a),15 - 24,0,0,0,12
Sacatepéquez,Unido(a),25 - 44,0,0,0,12
Sacatepéquez,Unido(a),45 - 64,0,0,0,12
Sacatepéquez,Unido(a),65 y más,6,0,6,12
Sacatepéquez,Unido(a),Ignorado,0,0,0,12
Sacatepéquez,Ignorado(a),Todas las edades,9,6,3,12
Sacatepéquez,Ignorado(a),Menos de 15 años,0,0,0,12
Sacatepéquez,Ignorado(a),15 - 24,1,1,0,12
Sacatepéquez,Ignorado(a),25 - 44,0,0,0,12
Sacatepéquez,Ignorado(a),45 - 64,0,0,0,12
Sacatepéquez,Ignorado(a),65 y más,1,1,0,12
Sacatepéquez,Ignorado(a),Ignorado,7,4,3,12
Chimaltenango,Todos los estados civiles,Todas las edades,2758,1546,1212,12
Chimaltenango,Todos los estados civiles,Menos de 15 años,529,283,246,12
Chimaltenango,Todos los estados civiles,15 - 24,143,95,48,12
Chimaltenango,Todos los estados civiles,25 - 44,367,256,111,12
Chimaltenango,Todos los estados civiles,45 - 64,552,310,242,12
Chimaltenango,Todos los estados civiles,65 y más,1146,591,555,12
Chimaltenango,Todos los estados civiles,Ignorado,21,11,10,12
Chimaltenango,Soltero(a),Todas las edades,1460,800,660,12
Chimaltenango,Soltero(a),Menos de 15 años,529,283,246,12
Chimaltenango,Soltero(a),15 - 24,122,84,38,12
Chimaltenango,Soltero(a),25 - 44,167,123,44,12
Chimaltenango,Soltero(a),45 - 64,165,80,85,12
Chimaltenango,Soltero(a),65 y más,465,223,242,12
Chimaltenango,Soltero(a),Ignorado,12,7,5,12
Chimaltenango,Casado(a),Todas las edades,1277,732,545,12
Chimaltenango,Casado(a),Menos de 15 años,0,0,0,12
Chimaltenango,Casado(a),15 - 24,20,10,10,12
Chimaltenango,Casado(a),25 - 44,200,133,67,12
Chimaltenango,Casado(a),45 - 64,384,228,156,12
Chimaltenango,Casado(a),65 y más,670,360,310,12
Chimaltenango,Casado(a),Ignorado,3,1,2,12
Chimaltenango,Unido(a),Todas las edades,11,8,3,12
Chimaltenango,Unido(a),Menos de 15 años,0,0,0,12
Chimaltenango,Unido(a),15 - 24,0,0,0,12
Chimaltenango,Unido(a),25 - 44,0,0,0,12
Chimaltenango,Unido(a),45 - 64,2,2,0,12
Chimaltenango,Unido(a),65 y más,8,6,2,12
Chimaltenango,Unido(a),Ignorado,1,0,1,12
Chimaltenango,Ignorado(a),Todas las edades,10,6,4,12
Chimaltenango,Ignorado(a),Menos de 15 años,0,0,0,12
Chimaltenango,Ignorado(a),15 - 24,1,1,0,12
Chimaltenango,Ignorado(a),25 - 44,0,0,0,12
Chimaltenango,Ignorado(a),45 - 64,1,0,1,12
Chimaltenango,Ignorado(a),65 y más,3,2,1,12
Chimaltenango,Ignorado(a),Ignorado,5,3,2,12
Escuintla,Todos los estados civiles,Todas las edades,4296,2581,1715,12
Escuintla,Todos los estados civiles,Menos de 15 años,526,307,219,12
Escuintla,Todos los estados civiles,15 - 24,353,272,81,12
Escuintla,Todos los estados civiles,25 - 44,751,566,185,12
Escuintla,Todos los estados civiles,45 - 64,930,514,416,12
Escuintla,Todos los estados civiles,65 y más,1678,877,801,12
Escuintla,Todos los estados civiles,Ignorado,58,45,13,12
Escuintla,Soltero(a),Todas las edades,2883,1797,1086,12
Escuintla,Soltero(a),Menos de 15 años,526,307,219,12
Escuintla,Soltero(a),15 - 24,322,251,71,12
Escuintla,Soltero(a),25 - 44,520,405,115,12
Escuintla,Soltero(a),45 - 64,517,299,218,12
Escuintla,Soltero(a),65 y más,954,500,454,12
Escuintla,Soltero(a),Ignorado,44,35,9,12
Escuintla,Casado(a),Todas las edades,1360,759,601,12
Escuintla,Casado(a),Menos de 15 años,0,0,0,12
Escuintla,Casado(a),15 - 24,29,21,8,12
Escuintla,Casado(a),25 - 44,227,158,69,12
Escuintla,Casado(a),45 - 64,407,213,194,12
Escuintla,Casado(a),65 y más,692,363,329,12
Escuintla,Casado(a),Ignorado,5,4,1,12
Escuintla,Unido(a),Todas las edades,32,14,18,12
Escuintla,Unido(a),Menos de 15 años,0,0,0,12
Escuintla,Unido(a),15 - 24,0,0,0,12
Escuintla,Unido(a),25 - 44,2,1,1,12
Escuintla,Unido(a),45 - 64,3,1,2,12
Escuintla,Unido(a),65 y más,26,12,14,12
Escuintla,Unido(a),Ignorado,1,0,1,12
Escuintla,Ignorado(a),Todas las edades,21,11,10,12
Escuintla,Ignorado(a),Menos de 15 años,0,0,0,12
Escuintla,Ignorado(a),15 - 24,2,0,2,12
Escuintla,Ignorado(a),25 - 44,2,2,0,12
Escuintla,Ignorado(a),45 - 64,3,1,2,12
Escuintla,Ignorado(a),65 y más,6,2,4,12
Escuintla,Ignorado(a),Ignorado,8,6,2,12
Santa Rosa,Todos los estados civiles,Todas las edades,2196,1350,846,12
Santa Rosa,Todos los estados civiles,Menos de 15 años,263,163,100,12
Santa Rosa,Todos los estados civiles,15 - 24,156,123,33,12
Santa Rosa,Todos los estados civiles,25 - 44,392,285,107,12
Santa Rosa,Todos los estados civiles,45 - 64,396,226,170,12
Santa Rosa,Todos los estados civiles,65 y más,975,546,429,12
Santa Rosa,Todos los estados civiles,Ignorado,14,7,7,12
Santa Rosa,Soltero(a),Todas las edades,1407,863,544,12
Santa Rosa,Soltero(a),Menos de 15 años,263,163,100,12
Santa Rosa,Soltero(a),15 - 24,146,115,31,12
Santa Rosa,Soltero(a),25 - 44,267,193,74,12
Santa Rosa,Soltero(a),45 - 64,185,110,75,12
Santa Rosa,Soltero(a),65 y más,536,278,258,12
Santa Rosa,Soltero(a),Ignorado,10,4,6,12
Santa Rosa,Casado(a),Todas las edades,761,469,292,12
Santa Rosa,Casado(a),Menos de 15 años,0,0,0,12
Santa Rosa,Casado(a),15 - 24,9,7,2,12
Santa Rosa,Casado(a),25 - 44,119,87,32,12
Santa Rosa,Casado(a),45 - 64,204,113,91,12
Santa Rosa,Casado(a),65 y más,429,262,167,12
Santa Rosa,Casado(a),Ignorado,0,0,0,12
Santa Rosa,Unido(a),Todas las edades,14,8,6,12
Santa Rosa,Unido(a),Menos de 15 años,0,0,0,12
Santa Rosa,Unido(a),15 - 24,0,0,0,12
Santa Rosa,Unido(a),25 - 44,2,1,1,12
Santa Rosa,Unido(a),45 - 64,3,1,2,12
Santa Rosa,Unido(a),65 y más,9,6,3,12
Santa Rosa,Unido(a),Ignorado,0,0,0,12
Santa Rosa,Ignorado(a),Todas las edades,14,10,4,12
Santa Rosa,Ignorado(a),Menos de 15 años,0,0,0,12
Santa Rosa,Ignorado(a),15 - 24,1,1,0,12
Santa Rosa,Ignorado(a),25 - 44,4,4,0,12
Santa Rosa,Ignorado(a),45 - 64,4,2,2,12
Santa Rosa,Ignorado(a),65 y más,1,0,1,12
Santa Rosa,Ignorado(a),Ignorado,4,3,1,12
Sololá,Todos los estados civiles,Todas las edades,1675,917,758,12
Sololá,Todos los estados civiles,Menos de 15 años,313,167,146,12
Sololá,Todos los estados civiles,15 - 24,96,60,36,12
Sololá,Todos los estados civiles,25 - 44,209,140,69,12
Sololá,Todos los estados civiles,45 - 64,335,179,156,12
Sololá,Todos los estados civiles,65 y más,710,362,348,12
Sololá,Todos los estados civiles,Ignorado,12,9,3,12
Sololá,Soltero(a),Todas las edades,1112,596,516,12
Sololá,Soltero(a),Menos de 15 años,313,167,146,12
Sololá,Soltero(a),15 - 24,88,56,32,12
Sololá,Soltero(a),25 - 44,132,90,42,12
Sololá,Soltero(a),45 - 64,157,91,66,12
Sololá,Soltero(a),65 y más,416,189,227,12
Sololá,Soltero(a),Ignorado,6,3,3,12
Sololá,Casado(a),Todas las edades,475,275,200,12
Sololá,Casado(a),Menos de 15 años,0,0,0,12
Sololá,Casado(a),15 - 24,8,4,4,12
Sololá,Casado(a),25 - 44,75,49,26,12
Sololá,Casado(a),45 - 64,155,76,79,12
Sololá,Casado(a),65 y más,235,144,91,12
Sololá,Casado(a),Ignorado,2,2,0,12
Sololá,Unido(a),Todas las edades,81,41,40,12
Sololá,Unido(a),Menos de 15 años,0,0,0,12
Sololá,Unido(a),15 - 24,0,0,0,12
Sololá,Unido(a),25 - 44,1,1,0,12
Sololá,Unido(a),45 - 64,23,12,11,12
Sololá,Unido(a),65 y más,57,28,29,12
Sololá,Unido(a),Ignorado,0,0,0,12
Sololá,Ignorado(a),Todas las edades,7,5,2,12
Sololá,Ignorado(a),Menos de 15 años,0,0,0,12
Sololá,Ignorado(a),15 - 24,0,0,0,12
Sololá,Ignorado(a),25 - 44,1,0,1,12
Sololá,Ignorado(a),45 - 64,0,0,0,12
Sololá,Ignorado(a),65 y más,2,1,1,12
Sololá,Ignorado(a),Ignorado,4,4,0,12
Totonicapán,Todos los estados civiles,Todas las edades,2359,1293,1066,12
Totonicapán,Todos los estados civiles,Menos de 15 años,431,230,201,12
Totonicapán,Todos los estados civiles,15 - 24,126,76,50,12
Totonicapán,Todos los estados civiles,25 - 44,339,217,122,12
Totonicapán,Todos los estados civiles,45 - 64,452,271,181,12
Totonicapán,Todos los estados civiles,65 y más,982,489,493,12
Totonicapán,Todos los estados civiles,Ignorado,29,10,19,12
Totonicapán,Soltero(a),Todas las edades,1391,703,688,12
Totonicapán,Soltero(a),Menos de 15 años,431,230,201,12
Totonicapán,Soltero(a),15 - 24,99,63,36,12
Totonicapán,Soltero(a),25 - 44,164,103,61,12
Totonicapán,Soltero(a),45 - 64,157,95,62,12
Totonicapán,Soltero(a),65 y más,521,206,315,12
Totonicapán,Soltero(a),Ignorado,19,6,13,12
Totonicapán,Casado(a),Todas las edades,886,541,345,12
Totonicapán,Casado(a),Menos de 15 años,0,0,0,12
Totonicapán,Casado(a),15 - 24,26,12,14,12
Totonicapán,Casado(a),25 - 44,171,112,59,12
Totonicapán,Casado(a),45 - 64,282,167,115,12
Totonicapán,Casado(a),65 y más,407,250,157,12
Totonicapán,Casado(a),Ignorado,0,0,0,12
Totonicapán,Unido(a),Todas las edades,64,39,25,12
Totonicapán,Unido(a),Menos de 15 años,0,0,0,12
Totonicapán,Unido(a),15 - 24,0,0,0,12
Totonicapán,Unido(a),25 - 44,1,0,1,12
Totonicapán,Unido(a),45 - 64,12,8,4,12
Totonicapán,Unido(a),65 y más,51,31,20,12
Totonicapán,Unido(a),Ignorado,0,0,0,12
Totonicapán,Ignorado(a),Todas las edades,18,10,8,12
Totonicapán,Ignorado(a),Menos de 15 años,0,0,0,12
Totonicapán,Ignorado(a),15 - 24,1,1,0,12
Totonicapán,Ignorado(a),25 - 44,3,2,1,12
Totonicapán,Ignorado(a),45 - 64,1,1,0,12
Totonicapán,Ignorado(a),65 y más,3,2,1,12
Totonicapán,Ignorado(a),Ignorado,10,4,6,12
Quetzaltenango,Todos los estados civiles,Todas las edades,4076,2274,1802,12
Quetzaltenango,Todos los estados civiles,Menos de 15 años,611,349,262,12
Quetzaltenango,Todos los estados civiles,15 - 24,247,195,52,12
Quetzaltenango,Todos los estados civiles,25 - 44,548,396,152,12
Quetzaltenango,Todos los estados civiles,45 - 64,828,445,383,12
Quetzaltenango,Todos los estados civiles,65 y más,1800,860,940,12
Quetzaltenango,Todos los estados civiles,Ignorado,42,29,13,12
Quetzaltenango,Soltero(a),Todas las edades,2426,1333,1093,12
Quetzaltenango,Soltero(a),Menos de 15 años,611,349,262,12
Quetzaltenango,Soltero(a),15 - 24,213,173,40,12
Quetzaltenango,Soltero(a),25 - 44,328,242,86,12
Quetzaltenango,Soltero(a),45 - 64,356,184,172,12
Quetzaltenango,Soltero(a),65 y más,890,367,523,12
Quetzaltenango,Soltero(a),Ignorado,28,18,10,12
Quetzaltenango,Casado(a),Todas las edades,1574,901,673,12
Quetzaltenango,Casado(a),Menos de 15 años,0,0,0,12
Quetzaltenango,Casado(a),15 - 24,28,18,10,12
Quetzaltenango,Casado(a),25 - 44,216,152,64,12
Quetzaltenango,Casado(a),45 - 64,457,254,203,12
Quetzaltenango,Casado(a),65 y más,867,474,393,12
Quetzaltenango,Casado(a),Ignorado,6,3,3,12
Quetzaltenango,Unido(a),Todas las edades,56,25,31,12
Quetzaltenango,Unido(a),Menos de 15 años,0,0,0,12
Quetzaltenango,Unido(a),15 - 24,0,0,0,12
Quetzaltenango,Unido(a),25 - 44,2,1,1,12
Quetzaltenango,Unido(a),45 - 64,12,5,7,12
Quetzaltenango,Unido(a),65 y más,42,19,23,12
Quetzaltenango,Unido(a),Ignorado,0,0,0,12
Quetzaltenango,Ignorado(a),Todas las edades,20,15,5,12
Quetzaltenango,Ignorado(a),Menos de 15 años,0,0,0,12
Quetzaltenango,Ignorado(a),15 - 24,6,4,2,12
Quetzaltenango,Ignorado(a),25 - 44,2,1,1,12
Quetzaltenango,Ignorado(a),45 - 64,3,2,1,12
Quetzaltenango,Ignorado(a),65 y más,1,0,1,12
Quetzaltenango,Ignorado(a),Ignorado,8,8,0,12
Suchitepéquez,Todos los estados civiles,Todas las edades,2852,1655,1197,12
Suchitepéquez,Todos los estados civiles,Menos de 15 años,432,234,198,12
Suchitepéquez,Todos los estados civiles,15 - 24,134,100,34,12
Suchitepéquez,Todos los estados civiles,25 - 44,394,277,117,12
Suchitepéquez,Todos los estados civiles,45 - 64,616,367,249,12
Suchitepéquez,Todos los estados civiles,65 y más,1250,660,590,12
Suchitepéquez,Todos los estados civiles,Ignorado,26,17,9,12
Suchitepéquez,Soltero(a),Todas las edades,1729,972,757,12
Suchitepéquez,Soltero(a),Menos de 15 años,432,234,198,12
Suchitepéquez,Soltero(a),15 - 24,128,96,32,12
Suchitepéquez,Soltero(a),25 - 44,224,163,61,12
Suchitepéquez,Soltero(a),45 - 64,252,150,102,12
Suchitepéquez,Soltero(a),65 y más,677,319,358,12
Suchitepéquez,Soltero(a),Ignorado,16,10,6,12
Suchitepéquez,Casado(a),Todas las edades,1100,670,430,12
Suchitepéquez,Casado(a),Menos de 15 años,0,0,0,12
Suchitepéquez,Casado(a),15 - 24,6,4,2,12
Suchitepéquez,Casado(a),25 - 44,169,113,56,12
Suchitepéquez,Casado(a),45 - 64,361,216,145,12
Suchitepéquez,Casado(a),65 y más,559,335,224,12
Suchitepéquez,Casado(a),Ignorado,5,2,3,12
Suchitepéquez,Unido(a),Todas las edades,12,5,7,12
Suchitepéquez,Unido(a),Menos de 15 años,0,0,0,12
Suchitepéquez,Unido(a),15 - 24,0,0,0,12
Suchitepéquez,Unido(a),25 - 44,1,1,0,12
Suchitepéquez,Unido(a),45 - 64,3,1,2,12
Suchitepéquez,Unido(a),65 y más,8,3,5,12
Suchitepéquez,Unido(a),Ignorado,0,0,0,12
Suchitepéquez,Ignorado(a),Todas las edades,11,8,3,12
Suchitepéquez,Ignorado(a),Menos de 15 años,0,0,0,12
Suchitepéquez,Ignorado(a),15 - 24,0,0,0,12
Suchitepéquez,Ignorado(a),25 - 44,0,0,0,12
Suchitepéquez,Ignorado(a),45 - 64,0,0,0,12
Suchitepéquez,Ignorado(a),65 y más,6,3,3,12
Suchitepéquez,Ignorado(a),Ignorado,5,5,0,12
Retalhuleu,Todos los estados civiles,Todas las edades,1667,948,719,12
Retalhuleu,Todos los estados civiles,Menos de 15 años,176,91,85,12
Retalhuleu,Todos los estados civiles,15 - 24,72,50,22,12
Retalhuleu,Todos los estados civiles,25 - 44,277,196,81,12
Retalhuleu,Todos los estados civiles,45 - 64,343,192,151,12
Retalhuleu,Todos los estados civiles,65 y más,766,399,367,12
Retalhuleu,Todos los estados civiles,Ignorado,33,20,13,12
Retalhuleu,Soltero(a),Todas las edades,1003,560,443,12
Retalhuleu,Soltero(a),Menos de 15 años,176,91,85,12
Retalhuleu,Soltero(a),15 - 24,61,44,17,12
Retalhuleu,Soltero(a),25 - 44,161,119,42,12
Retalhuleu,Soltero(a),45 - 64,145,78,67,12
Retalhuleu,Soltero(a),65 y más,440,216,224,12
Retalhuleu,Soltero(a),Ignorado,20,12,8,12
Retalhuleu,Casado(a),Todas las edades,617,361,256,12
Retalhuleu,Casado(a),Menos de 15 años,0,0,0,12
Retalhuleu,Casado(a),15 - 24,11,6,5,12
Retalhuleu,Casado(a),25 - 44,114,75,39,12
Retalhuleu,Casado(a),45 - 64,187,109,78,12
Retalhuleu,Casado(a),65 y más,298,167,131,12
Retalhuleu,Casado(a),Ignorado,7,4,3,12
Retalhuleu,Unido(a),Todas las edades,37,20,17,12
Retalhuleu,Unido(a),Menos de 15 años,0,0,0,12
Retalhuleu,Unido(a),15 - 24,0,0,0,12
Retalhuleu,Unido(a),25 - 44,1,1,0,12
Retalhuleu,Unido(a),45 - 64,10,4,6,12
Retalhuleu,Unido(a),65 y más,25,15,10,12
Retalhuleu,Unido(a),Ignorado,1,0,1,12
Retalhuleu,Ignorado(a),Todas las edades,10,7,3,12
Retalhuleu,Ignorado(a),Menos de 15 años,0,0,0,12
Retalhuleu,Ignorado(a),15 - 24,0,0,0,12
Retalhuleu,Ignorado(a),25 - 44,1,1,0,12
Retalhuleu,Ignorado(a),45 - 64,1,1,0,12
Retalhuleu,Ignorado(a),65 y más,3,1,2,12
Retalhuleu,Ignorado(a),Ignorado,5,4,1,12
San Marcos,Todos los estados civiles,Todas las edades,4846,2756,2090,12
San Marcos,Todos los estados civiles,Menos de 15 años,782,429,353,12
San Marcos,Todos los estados civiles,15 - 24,261,168,93,12
San Marcos,Todos los estados civiles,25 - 44,704,467,237,12
San Marcos,Todos los estados civiles,45 - 64,978,587,391,12
San Marcos,Todos los estados civiles,65 y más,2064,1074,990,12
San Marcos,Todos los estados civiles,Ignorado,57,31,26,12
San Marcos,Soltero(a),Todas las edades,3247,1847,1400,12
San Marcos,Soltero(a),Menos de 15 años,782,429,353,12
San Marcos,Soltero(a),15 - 24,238,159,79,12
San Marcos,Soltero(a),25 - 44,457,302,155,12
San Marcos,Soltero(a),45 - 64,505,322,183,12
San Marcos,Soltero(a),65 y más,1215,609,606,12
San Marcos,Soltero(a),Ignorado,50,26,24,12
San Marcos,Casado(a),Todas las edades,1539,880,659,12
San Marcos,Casado(a),Menos de 15 años,0,0,0,12
San Marcos,Casado(a),15 - 24,21,8,13,12
San Marcos,Casado(a),25 - 44,243,164,79,12
San Marcos,Casado(a),45 - 64,454,258,196,12
San Marcos,Casado(a),65 y más,818,448,370,12
San Marcos,Casado(a),Ignorado,3,2,1,12
San Marcos,Unido(a),Todas las edades,55,26,29,12
San Marcos,Unido(a),Menos de 15 años,0,0,0,12
San Marcos,Unido(a),15 - 24,0,0,0,12
San Marcos,Unido(a),25 - 44,4,1,3,12
San Marcos,Unido(a),45 - 64,19,7,12,12
San Marcos,Unido(a),65 y más,31,17,14,12
San Marcos,Unido(a),Ignorado,1,1,0,12
San Marcos,Ignorado(a),Todas las edades,5,3,2,12
San Marcos,Ignorado(a),Menos de 15 años,0,0,0,12
San Marcos,Ignorado(a),15 - 24,2,1,1,12
San Marcos,Ignorado(a),25 - 44,0,0,0,12
San Marcos,Ignorado(a),45 - 64,0,0,0,12
San Marcos,Ignorado(a),65 y más,0,0,0,12
San Marcos,Ignorado(a),Ignorado,3,2,1,12
Huehuetenango,Todos los estados civiles,Todas las edades,4158,2322,1836,12
Huehuetenango,Todos los estados civiles,Menos de 15 años,794,420,374,12
Huehuetenango,Todos los estados civiles,15 - 24,271,162,109,12
Huehuetenango,Todos los estados civiles,25 - 44,572,370,202,12
Huehuetenango,Todos los estados civiles,45 - 64,759,430,329,12
Huehuetenango,Todos los estados civiles,65 y más,1740,925,815,12
Huehuetenango,Todos los estados civiles,Ignorado,22,15,7,12
Huehuetenango,Soltero(a),Todas las edades,2960,1624,1336,12
Huehuetenango,Soltero(a),Menos de 15 años,794,420,374,12
Huehuetenango,Soltero(a),15 - 24,243,150,93,12
Huehuetenango,Soltero(a),25 - 44,344,220,124,12
Huehuetenango,Soltero(a),45 - 64,402,216,186,12
Huehuetenango,Soltero(a),65 y más,1159,606,553,12
Huehuetenango,Soltero(a),Ignorado,18,12,6,12
Huehuetenango,Casado(a),Todas las edades,1169,684,485,12
Huehuetenango,Casado(a),Menos de 15 años,0,0,0,12
Huehuetenango,Casado(a),15 - 24,28,12,16,12
Huehuetenango,Casado(a),25 - 44,227,149,78,12
Huehuetenango,Casado(a),45 - 64,353,211,142,12
Huehuetenango,Casado(a),65 y más,558,309,249,12
Huehuetenango,Casado(a),Ignorado,3,3,0,12
Huehuetenango,Unido(a),Todas las edades,23,11,12,12
Huehuetenango,Unido(a),Menos de 15 años,0,0,0,12
Huehuetenango,Unido(a),15 - 24,0,0,0,12
Huehuetenango,Unido(a),25 - 44,0,0,0,12
Huehuetenango,Unido(a),45 - 64,3,2,1,12
Huehuetenango,Unido(a),65 y más,20,9,11,12
Huehuetenango,Unido(a),Ignorado,0,0,0,12
Huehuetenango,Ignorado(a),Todas las edades,6,3,3,12
Huehuetenango,Ignorado(a),Menos de 15 años,0,0,0,12
Huehuetenango,Ignorado(a),15 - 24,0,0,0,12
Huehuetenango,Ignorado(a),25 - 44,1,1,0,12
Huehuetenango,Ignorado(a),45 - 64,1,1,0,12
Huehuetenango,Ignorado(a),65 y más,3,1,2,12
Huehuetenango,Ignorado(a),Ignorado,1,0,1,12
Quiché,Todos los estados civiles,Todas las edades,3912,2123,1789,12
Quiché,Todos los estados civiles,Menos de 15 años,908,481,427,12
Quiché,Todos los estados civiles,15 - 24,241,149,92,12
Quiché,Todos los estados civiles,25 - 44,543,336,207,12
Quiché,Todos los estados civiles,45 - 64,712,384,328,12
Quiché,Todos los estados civiles,65 y más,1460,751,709,12
Quiché,Todos los estados civiles,Ignorado,48,22,26,12
Quiché,Soltero(a),Todas las edades,2832,1495,1337,12
Quiché,Soltero(a),Menos de 15 años,908,481,427,12
Quiché,Soltero(a),15 - 24,218,137,81,12
Quiché,Soltero(a),25 - 44,307,196,111,12
Quiché,Soltero(a),45 - 64,386,208,178,12
Quiché,Soltero(a),65 y más,975,456,519,12
Quiché,Soltero(a),Ignorado,38,17,21,12
Quiché,Casado(a),Todas las edades,1048,615,433,12
Quiché,Casado(a),Menos de 15 años,0,0,0,12
Quiché,Casado(a),15 - 24,22,12,10,12
Quiché,Casado(a),25 - 44,235,140,95,12
Quiché,Casado(a),45 - 64,323,175,148,12
Quiché,Casado(a),65 y más,462,283,179,12
Quiché,Casado(a),Ignorado,6,5,1,12
Quiché,Unido(a),Todas las edades,24,12,12,12
Quiché,Unido(a),Menos de 15 años,0,0,0,12
Quiché,Unido(a),15 - 24,0,0,0,12
Quiché,Unido(a),25 - 44,1,0,1,12
Quiché,Unido(a),45 - 64,3,1,2,12
Quiché,Unido(a),65 y más,19,11,8,12
Quiché,Unido(a),Ignorado,1,0,1,12
Quiché,Ignorado(a),Todas las edades,8,1,7,12
Quiché,Ignorado(a),Menos de 15 años,0,0,0,12
Quiché,Ignorado(a),15 - 24,1,0,1,12
Quiché,Ignorado(a),25 - 44,0,0,0,12
Quiché,Ignorado(a),45 - 64,0,0,0,12
Quiché,Ignorado(a),65 y más,4,1,3,12
Quiché,Ignorado(a),Ignorado,3,0,3,12
Baja Verapaz,Todos los estados civiles,Todas las edades,1311,717,594,12
Baja Verapaz,Todos los estados civiles,Menos de 15 años,248,143,105,12
Baja Verapaz,Todos los estados civiles,15 - 24,71,45,26,12
Baja Verapaz,Todos los estados civiles,25 - 44,154,99,55,12
Baja Verapaz,Todos los estados civiles,45 - 64,224,123,101,12
Baja Verapaz,Todos los estados civiles,65 y más,601,299,302,12
Baja Verapaz,Todos los estados civiles,Ignorado,13,8,5,12
Baja Verapaz,Soltero(a),Todas las edades,829,433,396,12
Baja Verapaz,Soltero(a),Menos de 15 años,248,143,105,12
Baja Verapaz,Soltero(a),15 - 24,60,40,20,12
Baja Verapaz,Soltero(a),25 - 44,83,50,33,12
Baja Verapaz,Soltero(a),45 - 64,97,51,46,12
Baja Verapaz,Soltero(a),65 y más,332,145,187,12
Baja Verapaz,Soltero(a),Ignorado,9,4,5,12
Baja Verapaz,Casado(a),Todas las edades,460,273,187,12
Baja Verapaz,Casado(a),Menos de 15 años,0,0,0,12
Baja Verapaz,Casado(a),15 - 24,11,5,6,12
Baja Verapaz,Casado(a),25 - 44,71,49,22,12
Baja Verapaz,Casado(a),45 - 64,126,71,55,12
Baja Verapaz,Casado(a),65 y más,248,144,104,12
Baja Verapaz,Casado(a),Ignorado,4,4,0,12
Baja Verapaz,Unido(a),Todas las edades,20,10,10,12
Baja Verapaz,Unido(a),Menos de 15 años,0,0,0,12
Baja Verapaz,Unido(a),15 - 24,0,0,0,12
Baja Verapaz,Unido(a),25 - 44,0,0,0,12
Baja Verapaz,Unido(a),45 - 64,1,1,0,12
Baja Verapaz,Unido(a),65 y más,19,9,10,12
Baja Verapaz,Unido(a),Ignorado,0,0,0,12
Baja Verapaz,Ignorado(a),Todas las edades,2,1,1,12
Baja Verapaz,Ignorado(a),Menos de 15 años,0,0,0,12
Baja Verapaz,Ignorado(a),15 - 24,0,0,0,12
Baja Verapaz,Ignorado(a),25 - 44,0,0,0,12
Baja Verapaz,Ignorado(a),45 - 64,0,0,0,12
Baja Verapaz,Ignorado(a),65 y más,2,1,1,12
Baja Verapaz,Ignorado(a),Ignorado,0,0,0,12
Alta Verapaz,Todos los estados civiles,Todas las edades,4481,2295,2186,12
Alta Verapaz,Todos los estados civiles,Menos de 15 años,1211,664,547,12
Alta Verapaz,Todos los estados civiles,15 - 24,302,175,127,12
Alta Verapaz,Todos los estados civiles,25 - 44,560,317,243,12
Alta Verapaz,Todos los estados civiles,45 - 64,740,336,404,12
Alta Verapaz,Todos los estados civiles,65 y más,1613,775,838,12
Alta Verapaz,Todos los estados civiles,Ignorado,55,28,27,12
Alta Verapaz,Soltero(a),Todas las edades,2738,1377,1361,12
Alta Verapaz,Soltero(a),Menos de 15 años,1211,664,547,12
Alta Verapaz,Soltero(a),15 - 24,270,158,112,12
Alta Verapaz,Soltero(a),25 - 44,286,171,115,12
Alta Verapaz,Soltero(a),45 - 64,235,98,137,12
Alta Verapaz,Soltero(a),65 y más,691,261,430,12
Alta Verapaz,Soltero(a),Ignorado,45,25,20,12
Alta Verapaz,Casado(a),Todas las edades,1703,899,804,12
Alta Verapaz,Casado(a),Menos de 15 años,0,0,0,12
Alta Verapaz,Casado(a),15 - 24,31,16,15,12
Alta Verapaz,Casado(a),25 - 44,272,144,128,12
Alta Verapaz,Casado(a),45 - 64,494,234,260,12
Alta Verapaz,Casado(a),65 y más,900,503,397,12
Alta Verapaz,Casado(a),Ignorado,6,2,4,12
Alta Verapaz,Unido(a),Todas las edades,35,18,17,12
Alta Verapaz,Unido(a),Menos de 15 años,0,0,0,12
Alta Verapaz,Unido(a),15 - 24,1,1,0,12
Alta Verapaz,Unido(a),25 - 44,2,2,0,12
Alta Verapaz,Unido(a),45 - 64,10,4,6,12
Alta Verapaz,Unido(a),65 y más,21,11,10,12
Alta Verapaz,Unido(a),Ignorado,1,0,1,12
Alta Verapaz,Ignorado(a),Todas las edades,5,1,4,12
Alta Verapaz,Ignorado(a),Menos de 15 años,0,0,0,12
Alta Verapaz,Ignorado(a),15 - 24,0,0,0,12
Alta Verapaz,Ignorado(a),25 - 44,0,0,0,12
Alta Verapaz,Ignorado(a),45 - 64,1,0,1,12
Alta Verapaz,Ignorado(a),65 y más,1,0,1,12
Alta Verapaz,Ignorado(a),Ignorado,3,1,2,12
Petén,Todos los estados civiles,Todas las edades,1772,1086,686,12
Petén,Todos los estados civiles,Menos de 15 años,240,129,111,12
Petén,Todos los estados civiles,15 - 24,178,130,48,12
Petén,Todos los estados civiles,25 - 44,373,273,100,12
Petén,Todos los estados civiles,45 - 64,321,184,137,12
Petén,Todos los estados civiles,65 y más,624,341,283,12
Petén,Todos los estados civiles,Ignorado,36,29,7,12
Petén,Soltero(a),Todas las edades,1142,721,421,12
Petén,Soltero(a),Menos de 15 años,240,129,111,12
Petén,Soltero(a),15 - 24,165,125,40,12
Petén,Soltero(a),25 - 44,248,193,55,12
Petén,Soltero(a),45 - 64,140,83,57,12
Petén,Soltero(a),65 y más,323,168,155,12
Petén,Soltero(a),Ignorado,26,23,3,12
Petén,Casado(a),Todas las edades,541,311,230,12
Petén,Casado(a),Menos de 15 años,0,0,0,12
Petén,Casado(a),15 - 24,12,4,8,12
Petén,Casado(a),25 - 44,109,69,40,12
Petén,Casado(a),45 - 64,157,91,66,12
Petén,Casado(a),65 y más,258,146,112,12
Petén,Casado(a),Ignorado,5,1,4,12
Petén,Unido(a),Todas las edades,80,46,34,12
Petén,Unido(a),Menos de 15 años,0,0,0,12
Petén,Unido(a),15 - 24,0,0,0,12
Petén,Unido(a),25 - 44,13,9,4,12
Petén,Unido(a),45 - 64,24,10,14,12
Petén,Unido(a),65 y más,43,27,16,12
Petén,Unido(a),Ignorado,0,0,0,12
Petén,Ignorado(a),Todas las edades,9,8,1,12
Petén,Ignorado(a),Menos de 15 años,0,0,0,12
Petén,Ignorado(a),15 - 24,1,1,0,12
Petén,Ignorado(a),25 - 44,3,2,1,12
Petén,Ignorado(a),45 - 64,0,0,0,12
Petén,Ignorado(a),65 y más,0,0,0,12
Petén,Ignorado(a),Ignorado,5,5,0,12
Izabal,Todos los estados civiles,Todas las edades,1864,1068,796,12
Izabal,Todos los estados civiles,Menos de 15 años,212,108,104,12
Izabal,Todos los estados civiles,15 - 24,135,100,35,12
Izabal,Todos los estados civiles,25 - 44,340,235,105,12
Izabal,Todos los estados civiles,45 - 64,421,225,196,12
Izabal,Todos los estados civiles,65 y más,743,396,347,12
Izabal,Todos los estados civiles,Ignorado,13,4,9,12
Izabal,Soltero(a),Todas las edades,1232,716,516,12
Izabal,Soltero(a),Menos de 15 años,212,108,104,12
Izabal,Soltero(a),15 - 24,132,100,32,12
Izabal,Soltero(a),25 - 44,244,181,63,12
Izabal,Soltero(a),45 - 64,211,116,95,12
Izabal,Soltero(a),65 y más,427,210,217,12
Izabal,Soltero(a),Ignorado,6,1,5,12
Izabal,Casado(a),Todas las edades,582,331,251,12
Izabal,Casado(a),Menos de 15 años,0,0,0,12
Izabal,Casado(a),15 - 24,3,0,3,12
Izabal,Casado(a),25 - 44,94,53,41,12
Izabal,Casado(a),45 - 64,203,107,96,12
Izabal,Casado(a),65 y más,280,170,110,12
Izabal,Casado(a),Ignorado,2,1,1,12
Izabal,Unido(a),Todas las edades,39,16,23,12
Izabal,Unido(a),Menos de 15 años,0,0,0,12
Izabal,Unido(a),15 - 24,0,0,0,12
Izabal,Unido(a),25 - 44,0,0,0,12
Izabal,Unido(a),45 - 64,6,2,4,12
Izabal,Unido(a),65 y más,33,14,19,12
Izabal,Unido(a),Ignorado,0,0,0,12
Izabal,Ignorado(a),Todas las edades,11,5,6,12
Izabal,Ignorado(a),Menos de 15 años,0,0,0,12
Izabal,Ignorado(a),15 - 24,0,0,0,12
Izabal,Ignorado(a),25 - 44,2,1,1,12
Izabal,Ignorado(a),45 - 64,1,0,1,12
Izabal,Ignorado(a),65 y más,3,2,1,12
Izabal,Ignorado(a),Ignorado,5,2,3,12
Zacapa,Todos los estados civiles,Todas las edades,1468,852,616,12
Zacapa,Todos los estados civiles,Menos de 15 años,165,100,65,12
Zacapa,Todos los estados civiles,15 - 24,84,68,16,12
Zacapa,Todos los estados civiles,25 - 44,211,157,54,12
Zacapa,Todos los estados civiles,45 - 64,299,179,120,12
Zacapa,Todos los estados civiles,65 y más,703,343,360,12
Zacapa,Todos los estados civiles,Ignorado,6,5,1,12
Zacapa,Soltero(a),Todas las edades,947,553,394,12
Zacapa,Soltero(a),Menos de 15 años,165,100,65,12
Zacapa,Soltero(a),15 - 24,79,64,15,12
Zacapa,Soltero(a),25 - 44,146,114,32,12
Zacapa,Soltero(a),45 - 64,151,90,61,12
Zacapa,Soltero(a),65 y más,400,180,220,12
Zacapa,Soltero(a),Ignorado,6,5,1,12
Zacapa,Casado(a),Todas las edades,517,296,221,12
Zacapa,Casado(a),Menos de 15 años,0,0,0,12
Zacapa,Casado(a),15 - 24,5,4,1,12
Zacapa,Casado(a),25 - 44,64,42,22,12
Zacapa,Casado(a),45 - 64,148,89,59,12
Zacapa,Casado(a),65 y más,300,161,139,12
Zacapa,Casado(a),Ignorado,0,0,0,12
Zacapa,Unido(a),Todas las edades,3,2,1,12
Zacapa,Unido(a),Menos de 15 años,0,0,0,12
Zacapa,Unido(a),15 - 24,0,0,0,12
Zacapa,Unido(a),25 - 44,0,0,0,12
Zacapa,Unido(a),45 - 64,0,0,0,12
Zacapa,Unido(a),65 y más,3,2,1,12
Zacapa,Unido(a),Ignorado,0,0,0,12
Zacapa,Ignorado(a),Todas las edades,1,1,0,12
Zacapa,Ignorado(a),Menos de 15 años,0,0,0,12
Zacapa,Ignorado(a),15 - 24,0,0,0,12
Zacapa,Ignorado(a),25 - 44,1,1,0,12
Zacapa,Ignorado(a),45 - 64,0,0,0,12
Zacapa,Ignorado(a),65 y más,0,0,0,12
Zacapa,Ignorado(a),Ignorado,0,0,0,12
Chiquimula,Todos los estados civiles,Todas las edades,2116,1259,857,12
Chiquimula,Todos los estados civiles,Menos de 15 años,286,173,113,12
Chiquimula,Todos los estados civiles,15 - 24,189,142,47,12
Chiquimula,Todos los estados civiles,25 - 44,356,249,107,12
Chiquimula,Todos los estados civiles,45 - 64,420,237,183,12
Chiquimula,Todos los estados civiles,65 y más,834,447,387,12
Chiquimula,Todos los estados civiles,Ignorado,31,11,20,12
Chiquimula,Soltero(a),Todas las edades,1431,858,573,12
Chiquimula,Soltero(a),Menos de 15 años,286,173,113,12
Chiquimula,Soltero(a),15 - 24,169,127,42,12
Chiquimula,Soltero(a),25 - 44,247,181,66,12
Chiquimula,Soltero(a),45 - 64,209,116,93,12
Chiquimula,Soltero(a),65 y más,495,251,244,12
Chiquimula,Soltero(a),Ignorado,25,10,15,12
Chiquimula,Casado(a),Todas las edades,674,392,282,12
Chiquimula,Casado(a),Menos de 15 años,0,0,0,12
Chiquimula,Casado(a),15 - 24,20,15,5,12
Chiquimula,Casado(a),25 - 44,109,68,41,12
Chiquimula,Casado(a),45 - 64,211,121,90,12
Chiquimula,Casado(a),65 y más,331,188,143,12
Chiquimula,Casado(a),Ignorado,3,0,3,12
Chiquimula,Unido(a),Todas las edades,7,7,0,12
Chiquimula,Unido(a),Menos de 15 años,0,0,0,12
Chiquimula,Unido(a),15 - 24,0,0,0,12
Chiquimula,Unido(a),25 - 44,0,0,0,12
Chiquimula,Unido(a),45 - 64,0,0,0,12
Chiquimula,Unido(a),65 y más,7,7,0,12
Chiquimula,Unido(a),Ignorado,0,0,0,12
Chiquimula,Ignorado(a),Todas las edades,4,2,2,12
Chiquimula,Ignorado(a),Menos de 15 años,0,0,0,12
Chiquimula,Ignorado(a),15 - 24,0,0,0,12
Chiquimula,Ignorado(a),25 - 44,0,0,0,12
Chiquimula,Ignorado(a),45 - 64,0,0,0,12
Chiquimula,Ignorado(a),65 y más,1,1,0,12
Chiquimula,Ignorado(a),Ignorado,3,1,2,12
Jalapa,Todos los estados civiles,Todas las edades,1699,970,729,12
Jalapa,Todos los estados civiles,Menos de 15 años,231,120,111,12
Jalapa,Todos los estados civiles,15 - 24,132,89,43,12
Jalapa,Todos los estados civiles,25 - 44,302,205,97,12
Jalapa,Todos los estados civiles,45 - 64,326,202,124,12
Jalapa,Todos los estados civiles,65 y más,705,353,352,12
Jalapa,Todos los estados civiles,Ignorado,3,1,2,12
Jalapa,Soltero(a),Todas las edades,967,526,441,12
Jalapa,Soltero(a),Menos de 15 años,231,120,111,12
Jalapa,Soltero(a),15 - 24,121,82,39,12
Jalapa,Soltero(a),25 - 44,184,132,52,12
Jalapa,Soltero(a),45 - 64,107,67,40,12
Jalapa,Soltero(a),65 y más,323,124,199,12
Jalapa,Soltero(a),Ignorado,1,1,0,12
Jalapa,Casado(a),Todas las edades,720,437,283,12
Jalapa,Casado(a),Menos de 15 años,0,0,0,12
Jalapa,Casado(a),15 - 24,11,7,4,12
Jalapa,Casado(a),25 - 44,118,73,45,12
Jalapa,Casado(a),45 - 64,218,134,84,12
Jalapa,Casado(a),65 y más,372,223,149,12
Jalapa,Casado(a),Ignorado,1,0,1,12
Jalapa,Unido(a),Todas las edades,10,6,4,12
Jalapa,Unido(a),Menos de 15 años,0,0,0,12
Jalapa,Unido(a),15 - 24,0,0,0,12
Jalapa,Unido(a),25 - 44,0,0,0,12
Jalapa,Unido(a),45 - 64,0,0,0,12
Jalapa,Unido(a),65 y más,10,6,4,12
Jalapa,Unido(a),Ignorado,0,0,0,12
Jalapa,Ignorado(a),Todas las edades,2,1,1,12
Jalapa,Ignorado(a),Menos de 15 años,0,0,0,12
Jalapa,Ignorado(a),15 - 24,0,0,0,12
Jalapa,Ignorado(a),25 - 44,0,0,0,12
Jalapa,Ignorado(a),45 - 64,1,1,0,12
Jalapa,Ignorado(a),65 y más,0,0,0,12
Jalapa,Ignorado(a),Ignorado,1,0,1,12
Jutiapa,Todos los estados civiles,Todas las edades,2603,1514,1089,12
Jutiapa,Todos los estados civiles,Menos de 15 años,247,127,120,12
Jutiapa,Todos los estados civiles,15 - 24,157,113,44,12
Jutiapa,Todos los estados civiles,25 - 44,410,311,99,12
Jutiapa,Todos los estados civiles,45 - 64,573,306,267,12
Jutiapa,Todos los estados civiles,65 y más,1205,649,556,12
Jutiapa,Todos los estados civiles,Ignorado,11,8,3,12
Jutiapa,Soltero(a),Todas las edades,1592,903,689,12
Jutiapa,Soltero(a),Menos de 15 años,247,127,120,12
Jutiapa,Soltero(a),15 - 24,152,111,41,12
Jutiapa,Soltero(a),25 - 44,273,218,55,12
Jutiapa,Soltero(a),45 - 64,273,144,129,12
Jutiapa,Soltero(a),65 y más,638,297,341,12
Jutiapa,Soltero(a),Ignorado,9,6,3,12
Jutiapa,Casado(a),Todas las edades,989,597,392,12
Jutiapa,Casado(a),Menos de 15 años,0,0,0,12
Jutiapa,Casado(a),15 - 24,5,2,3,12
Jutiapa,Casado(a),25 - 44,135,92,43,12
Jutiapa,Casado(a),45 - 64,295,160,135,12
Jutiapa,Casado(a),65 y más,552,341,211,12
Jutiapa,Casado(a),Ignorado,2,2,0,12
Jutiapa,Unido(a),Todas las edades,17,10,7,12
Jutiapa,Unido(a),Menos de 15 años,0,0,0,12
Jutiapa,Unido(a),15 - 24,0,0,0,12
Jutiapa,Unido(a),25 - 44,2,1,1,12
Jutiapa,Unido(a),45 - 64,3,0,3,12
Jutiapa,Unido(a),65 y más,12,9,3,12
Jutiapa,Unido(a),Ignorado,0,0,0,12
Jutiapa,Ignorado(a),Todas las edades,5,4,1,12
Jutiapa,Ignorado(a),Menos de 15 años,0,0,0,12
Jutiapa,Ignorado(a),15 - 24,0,0,0,12
Jutiapa,Ignorado(a),25 - 44,0,0,0,12
Jutiapa,Ignorado(a),45 - 64,2,2,0,12
Jutiapa,Ignorado(a),65 y más,3,2,1,12
Jutiapa,Ignorado(a),Ignorado,0,0,0,12
Extranjero,Todos los estados civiles,Todas las edades,143,93,50,12
Extranjero,Todos los estados civiles,Menos de 15 años,8,2,6,12
Extranjero,Todos los estados civiles,15 - 24,17,11,6,12
Extranjero,Todos los estados civiles,25 - 44,60,45,15,12
Extranjero,Todos los estados civiles,45 - 64,26,16,10,12
Extranjero,Todos los estados civiles,65 y más,27,15,12,12
Extranjero,Todos los estados civiles,Ignorado,5,4,1,12
Extranjero,Soltero(a),Todas las edades,109,69,40,12
Extranjero,Soltero(a),Menos de 15 años,8,2,6,12
Extranjero,Soltero(a),15 - 24,14,8,6,12
Extranjero,Soltero(a),25 - 44,47,35,12,12
Extranjero,Soltero(a),45 - 64,15,9,6,12
Extranjero,Soltero(a),65 y más,20,11,9,12
Extranjero,Soltero(a),Ignorado,5,4,1,12
Extranjero,Casado(a),Todas las edades,20,14,6,12
Extranjero,Casado(a),Menos de 15 años,0,0,0,12
Extranjero,Casado(a),15 - 24,0,0,0,12
Extranjero,Casado(a),25 - 44,8,6,2,12
Extranjero,Casado(a),45 - 64,7,4,3,12
Extranjero,Casado(a),65 y más,5,4,1,12
Extranjero,Casado(a),Ignorado,0,0,0,12
Extranjero,Unido(a),Todas las edades,0,0,0,12
Extranjero,Unido(a),Menos de 15 años,0,0,0,12
Extranjero,Unido(a),15 - 24,0,0,0,12
Extranjero,Unido(a),25 - 44,0,0,0,12
Extranjero,Unido(a),45 - 64,0,0,0,12
Extranjero,Unido(a),65 y más,0,0,0,12
Extranjero,Unido(a),Ignorado,0,0,0,12
Extranjero,Ignorado(a),Todas las edades,14,10,4,12
Extranjero,Ignorado(a),Menos de 15 años,0,0,0,12
Extranjero,Ignorado(a),15 - 24,3,3,0,12
Extranjero,Ignorado(a),25 - 44,5,4,1,12
Extranjero,Ignorado(a),45 - 64,4,3,1,12
Extranjero,Ignorado(a),65 y más,2,0,2,12
Extranjero,Ignorado(a),Ignorado,0,0,0,12
Ignorado,Todos los estados civiles,Todas las edades,534,432,102,12
Ignorado,Todos los estados civiles,Menos de 15 años,66,46,20,12
Ignorado,Todos los estados civiles,15 - 24,29,18,11,12
Ignorado,Todos los estados civiles,25 - 44,111,97,14,12
Ignorado,Todos los estados civiles,45 - 64,51,47,4,12
Ignorado,Todos los estados civiles,65 y más,20,15,5,12
Ignorado,Todos los estados civiles,Ignorado,257,209,48,12
Ignorado,Todos los estados civiles,Todas las edades,122,86,36,12
Ignorado,Soltero(a),Menos de 15 años,66,46,20,12
Ignorado,Soltero(a),15 - 24,6,5,1,12
Ignorado,Soltero(a),25 - 44,9,6,3,12
Ignorado,Soltero(a),45 - 64,4,4,0,12
Ignorado,Soltero(a),65 y más,3,1,2,12
Ignorado,Soltero(a),Ignorado,34,24,10,12
Ignorado,Casado(a),Todas las edades,0,0,0,12
Ignorado,Casado(a),Menos de 15 años,0,0,0,12
Ignorado,Casado(a),15 - 24,0,0,0,12
Ignorado,Casado(a),25 - 44,0,0,0,12
Ignorado,Casado(a),45 - 64,0,0,0,12
Ignorado,Casado(a),65 y más,0,0,0,12
Ignorado,Casado(a),Ignorado,0,0,0,12
Ignorado,Unido(a),Todas las edades,0,0,0,12
Ignorado,Unido(a),Menos de 15 años,0,0,0,12
Ignorado,Unido(a),15 - 24,0,0,0,12
Ignorado,Unido(a),25 - 44,0,0,0,12
Ignorado,Unido(a),45 - 64,0,0,0,12
Ignorado,Unido(a),65 y más,0,0,0,12
Ignorado,Unido(a),Ignorado,0,0,0,12
Ignorado,Ignorado(a),Todas las edades,412,346,66,12
Ignorado,Ignorado(a),Menos de 15 años,0,0,0,12
Ignorado,Ignorado(a),15 - 24,23,13,10,12
Ignorado,Ignorado(a),25 - 44,102,91,11,12
Ignorado,Ignorado(a),45 - 64,47,43,4,12
Ignorado,Ignorado(a),65 y más,17,14,3,12
Ignorado,Ignorado(a),Ignorado,223,185,38,12
Todos los departamentos,Todos los estados civiles,Todas las edades,76639,43220,33419,13
Todos los departamentos,Todos los estados civiles,Menos de 15 años,11564,6359,5205,13
Todos los departamentos,Todos los estados civiles,15 - 24,4986,3592,1394,13
Todos los departamentos,Todos los estados civiles,25 - 44,11103,7856,3247,13
Todos los departamentos,Todos los estados civiles,45 - 64,15068,8400,6668,13
Todos los departamentos,Todos los estados civiles,65 y más,32198,15988,16210,13
Todos los departamentos,Todos los estados civiles,Ignorado,1720,1025,695,13
Todos los departamentos,Soltero(a),Todas las edades,50023,27527,22496,13
Todos los departamentos,Soltero(a),Menos de 15 años,11554,6353,5201,13
Todos los departamentos,Soltero(a),15 - 24,4573,3346,1227,13
Todos los departamentos,Soltero(a),25 - 44,6984,5058,1926,13
Todos los departamentos,Soltero(a),45 - 64,7051,3876,3175,13
Todos los departamentos,Soltero(a),65 y más,18598,8179,10419,13
Todos los departamentos,Soltero(a),Ignorado,1263,715,548,13
Todos los departamentos,Casado(a),Todas las edades,25029,14661,10368,13
Todos los departamentos,Casado(a),Menos de 15 años,0,0,0,13
Todos los departamentos,Casado(a),15 - 24,355,205,150,13
Todos los departamentos,Casado(a),25 - 44,3902,2636,1266,13
Todos los departamentos,Casado(a),45 - 64,7743,4348,3395,13
Todos los departamentos,Casado(a),65 y más,12977,7441,5536,13
Todos los departamentos,Casado(a),Ignorado,52,31,21,13
Todos los departamentos,Unido(a),Todas las edades,782,446,336,13
Todos los departamentos,Unido(a),Menos de 15 años,0,0,0,13
Todos los departamentos,Unido(a),15 - 24,4,3,1,13
Todos los departamentos,Unido(a),25 - 44,49,27,22,13
Todos los departamentos,Unido(a),45 - 64,182,94,88,13
Todos los departamentos,Unido(a),65 y más,541,320,221,13
Todos los departamentos,Unido(a),Ignorado,6,2,4,13
Todos los departamentos,Ignorado(a),Todas las edades,805,586,219,13
Todos los departamentos,Ignorado(a),Menos de 15 años,10,6,4,13
Todos los departamentos,Ignorado(a),15 - 24,54,38,16,13
Todos los departamentos,Ignorado(a),25 - 44,168,135,33,13
Todos los departamentos,Ignorado(a),45 - 64,92,82,10,13
Todos los departamentos,Ignorado(a),65 y más,82,48,34,13
Todos los departamentos,Ignorado(a),Ignorado,399,277,122,13
Guatemala,Todos los estados civiles,Todas las edades,17852,9808,8044,13
Guatemala,Todos los estados civiles,Menos de 15 años,1830,1013,817,13
Guatemala,Todos los estados civiles,15 - 24,1090,838,252,13
Guatemala,Todos los estados civiles,25 - 44,2598,1919,679,13
Guatemala,Todos los estados civiles,45 - 64,3875,2182,1693,13
Guatemala,Todos los estados civiles,65 y más,8216,3717,4499,13
Guatemala,Todos los estados civiles,Ignorado,243,139,104,13
Guatemala,Soltero(a),Todas las edades,10910,5790,5120,13
Guatemala,Soltero(a),Menos de 15 años,1825,1009,816,13
Guatemala,Soltero(a),15 - 24,1009,782,227,13
Guatemala,Soltero(a),25 - 44,1654,1234,420,13
Guatemala,Soltero(a),45 - 64,1860,1021,839,13
Guatemala,Soltero(a),65 y más,4382,1641,2741,13
Guatemala,Soltero(a),Ignorado,180,103,77,13
Guatemala,Casado(a),Todas las edades,6649,3813,2836,13
Guatemala,Casado(a),Menos de 15 años,0,0,0,13
Guatemala,Casado(a),15 - 24,56,38,18,13
Guatemala,Casado(a),25 - 44,859,615,244,13
Guatemala,Casado(a),45 - 64,1958,1115,843,13
Guatemala,Casado(a),65 y más,3770,2041,1729,13
Guatemala,Casado(a),Ignorado,6,4,2,13
Guatemala,Unido(a),Todas las edades,48,23,25,13
Guatemala,Unido(a),Menos de 15 años,0,0,0,13
Guatemala,Unido(a),15 - 24,2,2,0,13
Guatemala,Unido(a),25 - 44,2,2,0,13
Guatemala,Unido(a),45 - 64,9,4,5,13
Guatemala,Unido(a),65 y más,35,15,20,13
Guatemala,Unido(a),Ignorado,0,0,0,13
Guatemala,Ignorado(a),Todas las edades,245,182,63,13
Guatemala,Ignorado(a),Menos de 15 años,5,4,1,13
Guatemala,Ignorado(a),15 - 24,23,16,7,13
Guatemala,Ignorado(a),25 - 44,83,68,15,13
Guatemala,Ignorado(a),45 - 64,48,42,6,13
Guatemala,Ignorado(a),65 y más,29,20,9,13
Guatemala,Ignorado(a),Ignorado,57,32,25,13
El Progreso,Todos los estados civiles,Todas las edades,930,550,380,13
El Progreso,Todos los estados civiles,Menos de 15 años,53,31,22,13
El Progreso,Todos los estados civiles,15 - 24,48,36,12,13
El Progreso,Todos los estados civiles,25 - 44,118,93,25,13
El Progreso,Todos los estados civiles,45 - 64,190,118,72,13
El Progreso,Todos los estados civiles,65 y más,514,271,243,13
El Progreso,Todos los estados civiles,Ignorado,7,1,6,13
El Progreso,Soltero(a),Todas las edades,623,346,277,13
El Progreso,Soltero(a),Menos de 15 años,53,31,22,13
El Progreso,Soltero(a),15 - 24,42,33,9,13
El Progreso,Soltero(a),25 - 44,85,69,16,13
El Progreso,Soltero(a),45 - 64,101,60,41,13
El Progreso,Soltero(a),65 y más,335,152,183,13
El Progreso,Soltero(a),Ignorado,7,1,6,13
El Progreso,Casado(a),Todas las edades,298,199,99,13
El Progreso,Casado(a),Menos de 15 años,0,0,0,13
El Progreso,Casado(a),15 - 24,5,2,3,13
El Progreso,Casado(a),25 - 44,33,24,9,13
El Progreso,Casado(a),45 - 64,88,58,30,13
El Progreso,Casado(a),65 y más,172,115,57,13
El Progreso,Casado(a),Ignorado,0,0,0,13
El Progreso,Unido(a),Todas las edades,8,5,3,13
El Progreso,Unido(a),Menos de 15 años,0,0,0,13
El Progreso,Unido(a),15 - 24,1,1,0,13
El Progreso,Unido(a),25 - 44,0,0,0,13
El Progreso,Unido(a),45 - 64,0,0,0,13
El Progreso,Unido(a),65 y más,7,4,3,13
El Progreso,Unido(a),Ignorado,0,0,0,13
El Progreso,Ignorado(a),Todas las edades,1,0,1,13
El Progreso,Ignorado(a),Menos de 15 años,0,0,0,13
El Progreso,Ignorado(a),15 - 24,0,0,0,13
El Progreso,Ignorado(a),25 - 44,0,0,0,13
El Progreso,Ignorado(a),45 - 64,1,0,1,13
El Progreso,Ignorado(a),65 y más,0,0,0,13
El Progreso,Ignorado(a),Ignorado,0,0,0,13
Sacatepéquez,Todos los estados civiles,Todas las edades,1569,859,710,13
Sacatepéquez,Todos los estados civiles,Menos de 15 años,95,48,47,13
Sacatepéquez,Todos los estados civiles,15 - 24,87,63,24,13
Sacatepéquez,Todos los estados civiles,25 - 44,183,130,53,13
Sacatepéquez,Todos los estados civiles,45 - 64,349,176,173,13
Sacatepéquez,Todos los estados civiles,65 y más,830,428,402,13
Sacatepéquez,Todos los estados civiles,Ignorado,25,14,11,13
Sacatepéquez,Soltero(a),Todas las edades,830,442,388,13
Sacatepéquez,Soltero(a),Menos de 15 años,95,48,47,13
Sacatepéquez,Soltero(a),15 - 24,81,58,23,13
Sacatepéquez,Soltero(a),25 - 44,99,70,29,13
Sacatepéquez,Soltero(a),45 - 64,113,59,54,13
Sacatepéquez,Soltero(a),65 y más,431,200,231,13
Sacatepéquez,Soltero(a),Ignorado,11,7,4,13
Sacatepéquez,Casado(a),Todas las edades,717,404,313,13
Sacatepéquez,Casado(a),Menos de 15 años,0,0,0,13
Sacatepéquez,Casado(a),15 - 24,6,5,1,13
Sacatepéquez,Casado(a),25 - 44,84,60,24,13
Sacatepéquez,Casado(a),45 - 64,236,117,119,13
Sacatepéquez,Casado(a),65 y más,391,222,169,13
Sacatepéquez,Casado(a),Ignorado,0,0,0,13
Sacatepéquez,Unido(a),Todas las edades,2,1,1,13
Sacatepéquez,Unido(a),Menos de 15 años,0,0,0,13
Sacatepéquez,Unido(a),15 - 24,0,0,0,13
Sacatepéquez,Unido(a),25 - 44,0,0,0,13
Sacatepéquez,Unido(a),45 - 64,0,0,0,13
Sacatepéquez,Unido(a),65 y más,2,1,1,13
Sacatepéquez,Unido(a),Ignorado,0,0,0,13
Sacatepéquez,Ignorado(a),Todas las edades,20,12,8,13
Sacatepéquez,Ignorado(a),Menos de 15 años,0,0,0,13
Sacatepéquez,Ignorado(a),15 - 24,0,0,0,13
Sacatepéquez,Ignorado(a),25 - 44,0,0,0,13
Sacatepéquez,Ignorado(a),45 - 64,0,0,0,13
Sacatepéquez,Ignorado(a),65 y más,6,5,1,13
Sacatepéquez,Ignorado(a),Ignorado,14,7,7,13
Chimaltenango,Todos los estados civiles,Todas las edades,2573,1411,1162,13
Chimaltenango,Todos los estados civiles,Menos de 15 años,272,157,115,13
Chimaltenango,Todos los estados civiles,15 - 24,156,105,51,13
Chimaltenango,Todos los estados civiles,25 - 44,399,275,124,13
Chimaltenango,Todos los estados civiles,45 - 64,530,297,233,13
Chimaltenango,Todos los estados civiles,65 y más,1186,557,629,13
Chimaltenango,Todos los estados civiles,Ignorado,30,20,10,13
Chimaltenango,Soltero(a),Todas las edades,1375,723,652,13
Chimaltenango,Soltero(a),Menos de 15 años,271,156,115,13
Chimaltenango,Soltero(a),15 - 24,130,93,37,13
Chimaltenango,Soltero(a),25 - 44,186,129,57,13
Chimaltenango,Soltero(a),45 - 64,184,96,88,13
Chimaltenango,Soltero(a),65 y más,578,232,346,13
Chimaltenango,Soltero(a),Ignorado,26,17,9,13
Chimaltenango,Casado(a),Todas las edades,1182,682,500,13
Chimaltenango,Casado(a),Menos de 15 años,0,0,0,13
Chimaltenango,Casado(a),15 - 24,26,12,14,13
Chimaltenango,Casado(a),25 - 44,212,145,67,13
Chimaltenango,Casado(a),45 - 64,344,200,144,13
Chimaltenango,Casado(a),65 y más,598,323,275,13
Chimaltenango,Casado(a),Ignorado,2,2,0,13
Chimaltenango,Unido(a),Todas las edades,11,2,9,13
Chimaltenango,Unido(a),Menos de 15 años,0,0,0,13
Chimaltenango,Unido(a),15 - 24,0,0,0,13
Chimaltenango,Unido(a),25 - 44,0,0,0,13
Chimaltenango,Unido(a),45 - 64,1,0,1,13
Chimaltenango,Unido(a),65 y más,10,2,8,13
Chimaltenango,Unido(a),Ignorado,0,0,0,13
Chimaltenango,Ignorado(a),Todas las edades,5,4,1,13
Chimaltenango,Ignorado(a),Menos de 15 años,1,1,0,13
Chimaltenango,Ignorado(a),15 - 24,0,0,0,13
Chimaltenango,Ignorado(a),25 - 44,1,1,0,13
Chimaltenango,Ignorado(a),45 - 64,1,1,0,13
Chimaltenango,Ignorado(a),65 y más,0,0,0,13
Chimaltenango,Ignorado(a),Ignorado,2,1,1,13
Escuintla,Todos los estados civiles,Todas las edades,4085,2455,1630,13
Escuintla,Todos los estados civiles,Menos de 15 años,349,197,152,13
Escuintla,Todos los estados civiles,15 - 24,302,235,67,13
Escuintla,Todos los estados civiles,25 - 44,709,532,177,13
Escuintla,Todos los estados civiles,45 - 64,954,529,425,13
Escuintla,Todos los estados civiles,65 y más,1701,913,788,13
Escuintla,Todos los estados civiles,Ignorado,70,49,21,13
Escuintla,Soltero(a),Todas las edades,2808,1705,1103,13
Escuintla,Soltero(a),Menos de 15 años,349,197,152,13
Escuintla,Soltero(a),15 - 24,275,215,60,13
Escuintla,Soltero(a),25 - 44,507,385,122,13
Escuintla,Soltero(a),45 - 64,533,302,231,13
Escuintla,Soltero(a),65 y más,1080,562,518,13
Escuintla,Soltero(a),Ignorado,64,44,20,13
Escuintla,Casado(a),Todas las edades,1242,728,514,13
Escuintla,Casado(a),Menos de 15 años,0,0,0,13
Escuintla,Casado(a),15 - 24,24,17,7,13
Escuintla,Casado(a),25 - 44,198,146,52,13
Escuintla,Casado(a),45 - 64,417,225,192,13
Escuintla,Casado(a),65 y más,601,339,262,13
Escuintla,Casado(a),Ignorado,2,1,1,13
Escuintla,Unido(a),Todas las edades,14,8,6,13
Escuintla,Unido(a),Menos de 15 años,0,0,0,13
Escuintla,Unido(a),15 - 24,0,0,0,13
Escuintla,Unido(a),25 - 44,0,0,0,13
Escuintla,Unido(a),45 - 64,1,0,1,13
Escuintla,Unido(a),65 y más,13,8,5,13
Escuintla,Unido(a),Ignorado,0,0,0,13
Escuintla,Ignorado(a),Todas las edades,21,14,7,13
Escuintla,Ignorado(a),Menos de 15 años,0,0,0,13
Escuintla,Ignorado(a),15 - 24,3,3,0,13
Escuintla,Ignorado(a),25 - 44,4,1,3,13
Escuintla,Ignorado(a),45 - 64,3,2,1,13
Escuintla,Ignorado(a),65 y más,7,4,3,13
Escuintla,Ignorado(a),Ignorado,4,4,0,13
Santa Rosa,Todos los estados civiles,Todas las edades,2095,1270,825,13
Santa Rosa,Todos los estados civiles,Menos de 15 años,169,86,83,13
Santa Rosa,Todos los estados civiles,15 - 24,162,125,37,13
Santa Rosa,Todos los estados civiles,25 - 44,348,268,80,13
Santa Rosa,Todos los estados civiles,45 - 64,417,249,168,13
Santa Rosa,Todos los estados civiles,65 y más,983,532,451,13
Santa Rosa,Todos los estados civiles,Ignorado,16,10,6,13
Santa Rosa,Soltero(a),Todas las edades,1361,820,541,13
Santa Rosa,Soltero(a),Menos de 15 años,169,86,83,13
Santa Rosa,Soltero(a),15 - 24,153,121,32,13
Santa Rosa,Soltero(a),25 - 44,250,200,50,13
Santa Rosa,Soltero(a),45 - 64,210,125,85,13
Santa Rosa,Soltero(a),65 y más,567,279,288,13
Santa Rosa,Soltero(a),Ignorado,12,9,3,13
Santa Rosa,Casado(a),Todas las edades,702,433,269,13
Santa Rosa,Casado(a),Menos de 15 años,0,0,0,13
Santa Rosa,Casado(a),15 - 24,8,4,4,13
Santa Rosa,Casado(a),25 - 44,96,67,29,13
Santa Rosa,Casado(a),45 - 64,203,121,82,13
Santa Rosa,Casado(a),65 y más,394,241,153,13
Santa Rosa,Casado(a),Ignorado,1,0,1,13
Santa Rosa,Unido(a),Todas las edades,26,15,11,13
Santa Rosa,Unido(a),Menos de 15 años,0,0,0,13
Santa Rosa,Unido(a),15 - 24,0,0,0,13
Santa Rosa,Unido(a),25 - 44,1,0,1,13
Santa Rosa,Unido(a),45 - 64,4,3,1,13
Santa Rosa,Unido(a),65 y más,21,12,9,13
Santa Rosa,Unido(a),Ignorado,0,0,0,13
Santa Rosa,Ignorado(a),Todas las edades,6,2,4,13
Santa Rosa,Ignorado(a),Menos de 15 años,0,0,0,13
Santa Rosa,Ignorado(a),15 - 24,1,0,1,13
Santa Rosa,Ignorado(a),25 - 44,1,1,0,13
Santa Rosa,Ignorado(a),45 - 64,0,0,0,13
Santa Rosa,Ignorado(a),65 y más,1,0,1,13
Santa Rosa,Ignorado(a),Ignorado,3,1,2,13
Sololá,Todos los estados civiles,Todas las edades,1720,996,724,13
Sololá,Todos los estados civiles,Menos de 15 años,128,69,59,13
Sololá,Todos los estados civiles,15 - 24,93,70,23,13
Sololá,Todos los estados civiles,25 - 44,255,179,76,13
Sololá,Todos los estados civiles,45 - 64,397,228,169,13
Sololá,Todos los estados civiles,65 y más,820,436,384,13
Sololá,Todos los estados civiles,Ignorado,27,14,13,13
Sololá,Soltero(a),Todas las edades,1051,588,463,13
Sololá,Soltero(a),Menos de 15 años,128,69,59,13
Sololá,Soltero(a),15 - 24,86,66,20,13
Sololá,Soltero(a),25 - 44,163,117,46,13
Sololá,Soltero(a),45 - 64,174,96,78,13
Sololá,Soltero(a),65 y más,478,230,248,13
Sololá,Soltero(a),Ignorado,22,10,12,13
Sololá,Casado(a),Todas las edades,553,338,215,13
Sololá,Casado(a),Menos de 15 años,0,0,0,13
Sololá,Casado(a),15 - 24,6,4,2,13
Sololá,Casado(a),25 - 44,86,58,28,13
Sololá,Casado(a),45 - 64,195,116,79,13
Sololá,Casado(a),65 y más,264,159,105,13
Sololá,Casado(a),Ignorado,2,1,1,13
Sololá,Unido(a),Todas las edades,110,66,44,13
Sololá,Unido(a),Menos de 15 años,0,0,0,13
Sololá,Unido(a),15 - 24,0,0,0,13
Sololá,Unido(a),25 - 44,6,4,2,13
Sololá,Unido(a),45 - 64,28,16,12,13
Sololá,Unido(a),65 y más,76,46,30,13
Sololá,Unido(a),Ignorado,0,0,0,13
Sololá,Ignorado(a),Todas las edades,6,4,2,13
Sololá,Ignorado(a),Menos de 15 años,0,0,0,13
Sololá,Ignorado(a),15 - 24,1,0,1,13
Sololá,Ignorado(a),25 - 44,0,0,0,13
Sololá,Ignorado(a),45 - 64,0,0,0,13
Sololá,Ignorado(a),65 y más,2,1,1,13
Sololá,Ignorado(a),Ignorado,3,3,0,13
Totonicapán,Todos los estados civiles,Todas las edades,2042,1096,946,13
Totonicapán,Todos los estados civiles,Menos de 15 años,180,100,80,13
Totonicapán,Todos los estados civiles,15 - 24,83,49,34,13
Totonicapán,Todos los estados civiles,25 - 44,367,227,140,13
Totonicapán,Todos los estados civiles,45 - 64,472,272,200,13
Totonicapán,Todos los estados civiles,65 y más,909,431,478,13
Totonicapán,Todos los estados civiles,Ignorado,31,17,14,13
Totonicapán,Soltero(a),Todas las edades,1190,586,604,13
Totonicapán,Soltero(a),Menos de 15 años,180,100,80,13
Totonicapán,Soltero(a),15 - 24,72,46,26,13
Totonicapán,Soltero(a),25 - 44,194,114,80,13
Totonicapán,Soltero(a),45 - 64,192,108,84,13
Totonicapán,Soltero(a),65 y más,532,209,323,13
Totonicapán,Soltero(a),Ignorado,20,9,11,13
Totonicapán,Casado(a),Todas las edades,775,454,321,13
Totonicapán,Casado(a),Menos de 15 años,0,0,0,13
Totonicapán,Casado(a),15 - 24,11,3,8,13
Totonicapán,Casado(a),25 - 44,171,112,59,13
Totonicapán,Casado(a),45 - 64,267,156,111,13
Totonicapán,Casado(a),65 y más,324,183,141,13
Totonicapán,Casado(a),Ignorado,2,0,2,13
Totonicapán,Unido(a),Todas las edades,67,47,20,13
Totonicapán,Unido(a),Menos de 15 años,0,0,0,13
Totonicapán,Unido(a),15 - 24,0,0,0,13
Totonicapán,Unido(a),25 - 44,1,0,1,13
Totonicapán,Unido(a),45 - 64,13,8,5,13
Totonicapán,Unido(a),65 y más,53,39,14,13
Totonicapán,Unido(a),Ignorado,0,0,0,13
Totonicapán,Ignorado(a),Todas las edades,10,9,1,13
Totonicapán,Ignorado(a),Menos de 15 años,0,0,0,13
Totonicapán,Ignorado(a),15 - 24,0,0,0,13
Totonicapán,Ignorado(a),25 - 44,1,1,0,13
Totonicapán,Ignorado(a),45 - 64,0,0,0,13
Totonicapán,Ignorado(a),65 y más,0,0,0,13
Totonicapán,Ignorado(a),Ignorado,9,8,1,13
Quetzaltenango,Todos los estados civiles,Todas las edades,3744,2072,1672,13
Quetzaltenango,Todos los estados civiles,Menos de 15 años,260,145,115,13
Quetzaltenango,Todos los estados civiles,15 - 24,193,138,55,13
Quetzaltenango,Todos los estados civiles,25 - 44,549,401,148,13
Quetzaltenango,Todos los estados civiles,45 - 64,803,461,342,13
Quetzaltenango,Todos los estados civiles,65 y más,1902,912,990,13
Quetzaltenango,Todos los estados civiles,Ignorado,37,15,22,13
Quetzaltenango,Soltero(a),Todas las edades,2159,1147,1012,13
Quetzaltenango,Soltero(a),Menos de 15 años,259,145,114,13
Quetzaltenango,Soltero(a),15 - 24,170,122,48,13
Quetzaltenango,Soltero(a),25 - 44,335,253,82,13
Quetzaltenango,Soltero(a),45 - 64,338,187,151,13
Quetzaltenango,Soltero(a),65 y más,1030,427,603,13
Quetzaltenango,Soltero(a),Ignorado,27,13,14,13
Quetzaltenango,Casado(a),Todas las edades,1496,884,612,13
Quetzaltenango,Casado(a),Menos de 15 años,0,0,0,13
Quetzaltenango,Casado(a),15 - 24,23,16,7,13
Quetzaltenango,Casado(a),25 - 44,208,144,64,13
Quetzaltenango,Casado(a),45 - 64,448,264,184,13
Quetzaltenango,Casado(a),65 y más,815,460,355,13
Quetzaltenango,Casado(a),Ignorado,2,0,2,13
Quetzaltenango,Unido(a),Todas las edades,69,33,36,13
Quetzaltenango,Unido(a),Menos de 15 años,0,0,0,13
Quetzaltenango,Unido(a),15 - 24,0,0,0,13
Quetzaltenango,Unido(a),25 - 44,3,2,1,13
Quetzaltenango,Unido(a),45 - 64,15,8,7,13
Quetzaltenango,Unido(a),65 y más,51,23,28,13
Quetzaltenango,Unido(a),Ignorado,0,0,0,13
Quetzaltenango,Ignorado(a),Todas las edades,20,8,12,13
Quetzaltenango,Ignorado(a),Menos de 15 años,1,0,1,13
Quetzaltenango,Ignorado(a),15 - 24,0,0,0,13
Quetzaltenango,Ignorado(a),25 - 44,3,2,1,13
Quetzaltenango,Ignorado(a),45 - 64,2,2,0,13
Quetzaltenango,Ignorado(a),65 y más,6,2,4,13
Quetzaltenango,Ignorado(a),Ignorado,8,2,6,13
Suchitepéquez,Todos los estados civiles,Todas las edades,2694,1553,1141,13
Suchitepéquez,Todos los estados civiles,Menos de 15 años,179,106,73,13
Suchitepéquez,Todos los estados civiles,15 - 24,125,90,35,13
Suchitepéquez,Todos los estados civiles,25 - 44,440,309,131,13
Suchitepéquez,Todos los estados civiles,45 - 64,648,372,276,13
Suchitepéquez,Todos los estados civiles,65 y más,1277,667,610,13
Suchitepéquez,Todos los estados civiles,Ignorado,25,9,16,13
Suchitepéquez,Soltero(a),Todas las edades,1628,914,714,13
Suchitepéquez,Soltero(a),Menos de 15 años,179,106,73,13
Suchitepéquez,Soltero(a),15 - 24,115,84,31,13
Suchitepéquez,Soltero(a),25 - 44,260,192,68,13
Suchitepéquez,Soltero(a),45 - 64,284,163,121,13
Suchitepéquez,Soltero(a),65 y más,768,360,408,13
Suchitepéquez,Soltero(a),Ignorado,22,9,13,13
Suchitepéquez,Casado(a),Todas las edades,1051,635,416,13
Suchitepéquez,Casado(a),Menos de 15 años,0,0,0,13
Suchitepéquez,Casado(a),15 - 24,10,6,4,13
Suchitepéquez,Casado(a),25 - 44,179,117,62,13
Suchitepéquez,Casado(a),45 - 64,361,208,153,13
Suchitepéquez,Casado(a),65 y más,501,304,197,13
Suchitepéquez,Casado(a),Ignorado,0,0,0,13
Suchitepéquez,Unido(a),Todas las edades,13,4,9,13
Suchitepéquez,Unido(a),Menos de 15 años,0,0,0,13
Suchitepéquez,Unido(a),15 - 24,0,0,0,13
Suchitepéquez,Unido(a),25 - 44,1,0,1,13
Suchitepéquez,Unido(a),45 - 64,3,1,2,13
Suchitepéquez,Unido(a),65 y más,8,3,5,13
Suchitepéquez,Unido(a),Ignorado,1,0,1,13
Suchitepéquez,Ignorado(a),Todas las edades,2,0,2,13
Suchitepéquez,Ignorado(a),Menos de 15 años,0,0,0,13
Suchitepéquez,Ignorado(a),15 - 24,0,0,0,13
Suchitepéquez,Ignorado(a),25 - 44,0,0,0,13
Suchitepéquez,Ignorado(a),45 - 64,0,0,0,13
Suchitepéquez,Ignorado(a),65 y más,0,0,0,13
Suchitepéquez,Ignorado(a),Ignorado,2,0,2,13
Retalhuleu,Todos los estados civiles,Todas las edades,1729,1005,724,13
Retalhuleu,Todos los estados civiles,Menos de 15 años,157,77,80,13
Retalhuleu,Todos los estados civiles,15 - 24,87,69,18,13
Retalhuleu,Todos los estados civiles,25 - 44,259,200,59,13
Retalhuleu,Todos los estados civiles,45 - 64,422,257,165,13
Retalhuleu,Todos los estados civiles,65 y más,769,379,390,13
Retalhuleu,Todos los estados civiles,Ignorado,35,23,12,13
Retalhuleu,Soltero(a),Todas las edades,1075,617,458,13
Retalhuleu,Soltero(a),Menos de 15 años,157,77,80,13
Retalhuleu,Soltero(a),15 - 24,75,60,15,13
Retalhuleu,Soltero(a),25 - 44,160,133,27,13
Retalhuleu,Soltero(a),45 - 64,194,118,76,13
Retalhuleu,Soltero(a),65 y más,459,208,251,13
Retalhuleu,Soltero(a),Ignorado,30,21,9,13
Retalhuleu,Casado(a),Todas las edades,601,358,243,13
Retalhuleu,Casado(a),Menos de 15 años,0,0,0,13
Retalhuleu,Casado(a),15 - 24,12,9,3,13
Retalhuleu,Casado(a),25 - 44,96,65,31,13
Retalhuleu,Casado(a),45 - 64,212,128,84,13
Retalhuleu,Casado(a),65 y más,280,156,124,13
Retalhuleu,Casado(a),Ignorado,1,0,1,13
Retalhuleu,Unido(a),Todas las edades,48,27,21,13
Retalhuleu,Unido(a),Menos de 15 años,0,0,0,13
Retalhuleu,Unido(a),15 - 24,0,0,0,13
Retalhuleu,Unido(a),25 - 44,3,2,1,13
Retalhuleu,Unido(a),45 - 64,15,10,5,13
Retalhuleu,Unido(a),65 y más,29,15,14,13
Retalhuleu,Unido(a),Ignorado,1,0,1,13
Retalhuleu,Ignorado(a),Todas las edades,5,3,2,13
Retalhuleu,Ignorado(a),Menos de 15 años,0,0,0,13
Retalhuleu,Ignorado(a),15 - 24,0,0,0,13
Retalhuleu,Ignorado(a),25 - 44,0,0,0,13
Retalhuleu,Ignorado(a),45 - 64,1,1,0,13
Retalhuleu,Ignorado(a),65 y más,1,0,1,13
Retalhuleu,Ignorado(a),Ignorado,3,2,1,13
San Marcos,Todos los estados civiles,Todas las edades,4168,2397,1771,13
San Marcos,Todos los estados civiles,Menos de 15 años,256,148,108,13
San Marcos,Todos los estados civiles,15 - 24,233,151,82,13
San Marcos,Todos los estados civiles,25 - 44,692,483,209,13
San Marcos,Todos los estados civiles,45 - 64,892,515,377,13
San Marcos,Todos los estados civiles,65 y más,2052,1073,979,13
San Marcos,Todos los estados civiles,Ignorado,43,27,16,13
San Marcos,Soltero(a),Todas las edades,2606,1484,1122,13
San Marcos,Soltero(a),Menos de 15 años,255,147,108,13
San Marcos,Soltero(a),15 - 24,214,139,75,13
San Marcos,Soltero(a),25 - 44,468,329,139,13
San Marcos,Soltero(a),45 - 64,442,267,175,13
San Marcos,Soltero(a),65 y más,1196,583,613,13
San Marcos,Soltero(a),Ignorado,31,19,12,13
San Marcos,Casado(a),Todas las edades,1484,876,608,13
San Marcos,Casado(a),Menos de 15 años,0,0,0,13
San Marcos,Casado(a),15 - 24,19,12,7,13
San Marcos,Casado(a),25 - 44,215,151,64,13
San Marcos,Casado(a),45 - 64,426,238,188,13
San Marcos,Casado(a),65 y más,816,469,347,13
San Marcos,Casado(a),Ignorado,8,6,2,13
San Marcos,Unido(a),Todas las edades,71,33,38,13
San Marcos,Unido(a),Menos de 15 años,0,0,0,13
San Marcos,Unido(a),15 - 24,0,0,0,13
San Marcos,Unido(a),25 - 44,9,3,6,13
San Marcos,Unido(a),45 - 64,24,10,14,13
San Marcos,Unido(a),65 y más,37,20,17,13
San Marcos,Unido(a),Ignorado,1,0,1,13
San Marcos,Ignorado(a),Todas las edades,7,4,3,13
San Marcos,Ignorado(a),Menos de 15 años,1,1,0,13
San Marcos,Ignorado(a),15 - 24,0,0,0,13
San Marcos,Ignorado(a),25 - 44,0,0,0,13
San Marcos,Ignorado(a),45 - 64,0,0,0,13
San Marcos,Ignorado(a),65 y más,3,1,2,13
San Marcos,Ignorado(a),Ignorado,3,2,1,13
Huehuetenango,Todos los estados civiles,Todas las edades,4037,2232,1805,13
Huehuetenango,Todos los estados civiles,Menos de 15 años,453,235,218,13
Huehuetenango,Todos los estados civiles,15 - 24,278,160,118,13
Huehuetenango,Todos los estados civiles,25 - 44,610,366,244,13
Huehuetenango,Todos los estados civiles,45 - 64,822,426,396,13
Huehuetenango,Todos los estados civiles,65 y más,1835,1021,814,13
Huehuetenango,Todos los estados civiles,Ignorado,39,24,15,13
Huehuetenango,Soltero(a),Todas las edades,2832,1557,1275,13
Huehuetenango,Soltero(a),Menos de 15 años,453,235,218,13
Huehuetenango,Soltero(a),15 - 24,245,149,96,13
Huehuetenango,Soltero(a),25 - 44,386,236,150,13
Huehuetenango,Soltero(a),45 - 64,451,238,213,13
Huehuetenango,Soltero(a),65 y más,1264,680,584,13
Huehuetenango,Soltero(a),Ignorado,33,19,14,13
Huehuetenango,Casado(a),Todas las edades,1179,660,519,13
Huehuetenango,Casado(a),Menos de 15 años,0,0,0,13
Huehuetenango,Casado(a),15 - 24,33,11,22,13
Huehuetenango,Casado(a),25 - 44,224,130,94,13
Huehuetenango,Casado(a),45 - 64,370,187,183,13
Huehuetenango,Casado(a),65 y más,548,328,220,13
Huehuetenango,Casado(a),Ignorado,4,4,0,13
Huehuetenango,Unido(a),Todas las edades,22,12,10,13
Huehuetenango,Unido(a),Menos de 15 años,0,0,0,13
Huehuetenango,Unido(a),15 - 24,0,0,0,13
Huehuetenango,Unido(a),25 - 44,0,0,0,13
Huehuetenango,Unido(a),45 - 64,0,0,0,13
Huehuetenango,Unido(a),65 y más,22,12,10,13
Huehuetenango,Unido(a),Ignorado,0,0,0,13
Huehuetenango,Ignorado(a),Todas las edades,4,3,1,13
Huehuetenango,Ignorado(a),Menos de 15 años,0,0,0,13
Huehuetenango,Ignorado(a),15 - 24,0,0,0,13
Huehuetenango,Ignorado(a),25 - 44,0,0,0,13
Huehuetenango,Ignorado(a),45 - 64,1,1,0,13
Huehuetenango,Ignorado(a),65 y más,1,1,0,13
Huehuetenango,Ignorado(a),Ignorado,2,1,1,13
Quiché,Todos los estados civiles,Todas las edades,3555,1911,1644,13
Quiché,Todos los estados civiles,Menos de 15 años,465,243,222,13
Quiché,Todos los estados civiles,15 - 24,217,139,78,13
Quiché,Todos los estados civiles,25 - 44,558,354,204,13
Quiché,Todos los estados civiles,45 - 64,719,410,309,13
Quiché,Todos los estados civiles,65 y más,1539,738,801,13
Quiché,Todos los estados civiles,Ignorado,57,27,30,13
Quiché,Soltero(a),Todas las edades,2437,1240,1197,13
Quiché,Soltero(a),Menos de 15 años,465,243,222,13
Quiché,Soltero(a),15 - 24,194,128,66,13
Quiché,Soltero(a),25 - 44,333,215,118,13
Quiché,Soltero(a),45 - 64,341,177,164,13
Quiché,Soltero(a),65 y más,1052,452,600,13
Quiché,Soltero(a),Ignorado,52,25,27,13
Quiché,Casado(a),Todas las edades,1080,648,432,13
Quiché,Casado(a),Menos de 15 años,0,0,0,13
Quiché,Casado(a),15 - 24,22,10,12,13
Quiché,Casado(a),25 - 44,223,137,86,13
Quiché,Casado(a),45 - 64,376,231,145,13
Quiché,Casado(a),65 y más,456,268,188,13
Quiché,Casado(a),Ignorado,3,2,1,13
Quiché,Unido(a),Todas las edades,29,18,11,13
Quiché,Unido(a),Menos de 15 años,0,0,0,13
Quiché,Unido(a),15 - 24,0,0,0,13
Quiché,Unido(a),25 - 44,0,0,0,13
Quiché,Unido(a),45 - 64,1,1,0,13
Quiché,Unido(a),65 y más,28,17,11,13
Quiché,Unido(a),Ignorado,0,0,0,13
Quiché,Ignorado(a),Todas las edades,9,5,4,13
Quiché,Ignorado(a),Menos de 15 años,0,0,0,13
Quiché,Ignorado(a),15 - 24,1,1,0,13
Quiché,Ignorado(a),25 - 44,2,2,0,13
Quiché,Ignorado(a),45 - 64,1,1,0,13
Quiché,Ignorado(a),65 y más,3,1,2,13
Quiché,Ignorado(a),Ignorado,2,0,2,13
Baja Verapaz,Todos los estados civiles,Todas las edades,1206,636,570,13
Baja Verapaz,Todos los estados civiles,Menos de 15 años,164,85,79,13
Baja Verapaz,Todos los estados civiles,15 - 24,74,50,24,13
Baja Verapaz,Todos los estados civiles,25 - 44,141,83,58,13
Baja Verapaz,Todos los estados civiles,45 - 64,210,106,104,13
Baja Verapaz,Todos los estados civiles,65 y más,595,299,296,13
Baja Verapaz,Todos los estados civiles,Ignorado,22,13,9,13
Baja Verapaz,Soltero(a),Todas las edades,785,370,415,13
Baja Verapaz,Soltero(a),Menos de 15 años,164,85,79,13
Baja Verapaz,Soltero(a),15 - 24,72,48,24,13
Baja Verapaz,Soltero(a),25 - 44,78,45,33,13
Baja Verapaz,Soltero(a),45 - 64,101,39,62,13
Baja Verapaz,Soltero(a),65 y más,352,143,209,13
Baja Verapaz,Soltero(a),Ignorado,18,10,8,13
Baja Verapaz,Casado(a),Todas las edades,406,258,148,13
Baja Verapaz,Casado(a),Menos de 15 años,0,0,0,13
Baja Verapaz,Casado(a),15 - 24,2,2,0,13
Baja Verapaz,Casado(a),25 - 44,63,38,25,13
Baja Verapaz,Casado(a),45 - 64,109,67,42,13
Baja Verapaz,Casado(a),65 y más,230,149,81,13
Baja Verapaz,Casado(a),Ignorado,2,2,0,13
Baja Verapaz,Unido(a),Todas las edades,13,7,6,13
Baja Verapaz,Unido(a),Menos de 15 años,0,0,0,13
Baja Verapaz,Unido(a),15 - 24,0,0,0,13
Baja Verapaz,Unido(a),25 - 44,0,0,0,13
Baja Verapaz,Unido(a),45 - 64,0,0,0,13
Baja Verapaz,Unido(a),65 y más,13,7,6,13
Baja Verapaz,Unido(a),Ignorado,0,0,0,13
Baja Verapaz,Ignorado(a),Todas las edades,2,1,1,13
Baja Verapaz,Ignorado(a),Menos de 15 años,0,0,0,13
Baja Verapaz,Ignorado(a),15 - 24,0,0,0,13
Baja Verapaz,Ignorado(a),25 - 44,0,0,0,13
Baja Verapaz,Ignorado(a),45 - 64,0,0,0,13
Baja Verapaz,Ignorado(a),65 y más,0,0,0,13
Baja Verapaz,Ignorado(a),Ignorado,2,1,1,13
Alta Verapaz,Todos los estados civiles,Todas las edades,4189,2198,1991,13
Alta Verapaz,Todos los estados civiles,Menos de 15 años,809,441,368,13
Alta Verapaz,Todos los estados civiles,15 - 24,256,155,101,13
Alta Verapaz,Todos los estados civiles,25 - 44,566,358,208,13
Alta Verapaz,Todos los estados civiles,45 - 64,793,353,440,13
Alta Verapaz,Todos los estados civiles,65 y más,1672,828,844,13
Alta Verapaz,Todos los estados civiles,Ignorado,93,63,30,13
Alta Verapaz,Soltero(a),Todas las edades,2467,1259,1208,13
Alta Verapaz,Soltero(a),Menos de 15 años,809,441,368,13
Alta Verapaz,Soltero(a),15 - 24,223,143,80,13
Alta Verapaz,Soltero(a),25 - 44,272,173,99,13
Alta Verapaz,Soltero(a),45 - 64,275,127,148,13
Alta Verapaz,Soltero(a),65 y más,801,315,486,13
Alta Verapaz,Soltero(a),Ignorado,87,60,27,13
Alta Verapaz,Casado(a),Todas las edades,1673,910,763,13
Alta Verapaz,Casado(a),Menos de 15 años,0,0,0,13
Alta Verapaz,Casado(a),15 - 24,32,11,21,13
Alta Verapaz,Casado(a),25 - 44,288,180,108,13
Alta Verapaz,Casado(a),45 - 64,502,220,282,13
Alta Verapaz,Casado(a),65 y más,846,497,349,13
Alta Verapaz,Casado(a),Ignorado,5,2,3,13
Alta Verapaz,Unido(a),Todas las edades,43,24,19,13
Alta Verapaz,Unido(a),Menos de 15 años,0,0,0,13
Alta Verapaz,Unido(a),15 - 24,0,0,0,13
Alta Verapaz,Unido(a),25 - 44,4,3,1,13
Alta Verapaz,Unido(a),45 - 64,16,6,10,13
Alta Verapaz,Unido(a),65 y más,23,15,8,13
Alta Verapaz,Unido(a),Ignorado,0,0,0,13
Alta Verapaz,Ignorado(a),Todas las edades,6,5,1,13
Alta Verapaz,Ignorado(a),Menos de 15 años,0,0,0,13
Alta Verapaz,Ignorado(a),15 - 24,1,1,0,13
Alta Verapaz,Ignorado(a),25 - 44,2,2,0,13
Alta Verapaz,Ignorado(a),45 - 64,0,0,0,13
Alta Verapaz,Ignorado(a),65 y más,2,1,1,13
Alta Verapaz,Ignorado(a),Ignorado,1,1,0,13
Petén,Todos los estados civiles,Todas las edades,1903,1155,748,13
Petén,Todos los estados civiles,Menos de 15 años,191,98,93,13
Petén,Todos los estados civiles,15 - 24,188,144,44,13
Petén,Todos los estados civiles,25 - 44,386,260,126,13
Petén,Todos los estados civiles,45 - 64,404,211,193,13
Petén,Todos los estados civiles,65 y más,690,408,282,13
Petén,Todos los estados civiles,Ignorado,44,34,10,13
Petén,Soltero(a),Todas las edades,1270,777,493,13
Petén,Soltero(a),Menos de 15 años,191,98,93,13
Petén,Soltero(a),15 - 24,170,133,37,13
Petén,Soltero(a),25 - 44,272,191,81,13
Petén,Soltero(a),45 - 64,192,101,91,13
Petén,Soltero(a),65 y más,416,232,184,13
Petén,Soltero(a),Ignorado,29,22,7,13
Petén,Casado(a),Todas las edades,518,300,218,13
Petén,Casado(a),Menos de 15 años,0,0,0,13
Petén,Casado(a),15 - 24,17,11,6,13
Petén,Casado(a),25 - 44,99,61,38,13
Petén,Casado(a),45 - 64,175,90,85,13
Petén,Casado(a),65 y más,223,136,87,13
Petén,Casado(a),Ignorado,4,2,2,13
Petén,Unido(a),Todas las edades,102,67,35,13
Petén,Unido(a),Menos de 15 años,0,0,0,13
Petén,Unido(a),15 - 24,1,0,1,13
Petén,Unido(a),25 - 44,13,7,6,13
Petén,Unido(a),45 - 64,37,20,17,13
Petén,Unido(a),65 y más,48,38,10,13
Petén,Unido(a),Ignorado,3,2,1,13
Petén,Ignorado(a),Todas las edades,13,11,2,13
Petén,Ignorado(a),Menos de 15 años,0,0,0,13
Petén,Ignorado(a),15 - 24,0,0,0,13
Petén,Ignorado(a),25 - 44,2,1,1,13
Petén,Ignorado(a),45 - 64,0,0,0,13
Petén,Ignorado(a),65 y más,3,2,1,13
Petén,Ignorado(a),Ignorado,8,8,0,13
Izabal,Todos los estados civiles,Todas las edades,1948,1164,784,13
Izabal,Todos los estados civiles,Menos de 15 años,187,111,76,13
Izabal,Todos los estados civiles,15 - 24,191,142,49,13
Izabal,Todos los estados civiles,25 - 44,350,253,97,13
Izabal,Todos los estados civiles,45 - 64,394,217,177,13
Izabal,Todos los estados civiles,65 y más,807,428,379,13
Izabal,Todos los estados civiles,Ignorado,19,13,6,13
Izabal,Soltero(a),Todas las edades,1341,798,543,13
Izabal,Soltero(a),Menos de 15 años,187,111,76,13
Izabal,Soltero(a),15 - 24,187,139,48,13
Izabal,Soltero(a),25 - 44,248,189,59,13
Izabal,Soltero(a),45 - 64,204,107,97,13
Izabal,Soltero(a),65 y más,498,240,258,13
Izabal,Soltero(a),Ignorado,17,12,5,13
Izabal,Casado(a),Todas las edades,565,342,223,13
Izabal,Casado(a),Menos de 15 años,0,0,0,13
Izabal,Casado(a),15 - 24,4,3,1,13
Izabal,Casado(a),25 - 44,101,63,38,13
Izabal,Casado(a),45 - 64,183,108,75,13
Izabal,Casado(a),65 y más,277,168,109,13
Izabal,Casado(a),Ignorado,0,0,0,13
Izabal,Unido(a),Todas las edades,38,22,16,13
Izabal,Unido(a),Menos de 15 años,0,0,0,13
Izabal,Unido(a),15 - 24,0,0,0,13
Izabal,Unido(a),25 - 44,0,0,0,13
Izabal,Unido(a),45 - 64,7,2,5,13
Izabal,Unido(a),65 y más,31,20,11,13
Izabal,Unido(a),Ignorado,0,0,0,13
Izabal,Ignorado(a),Todas las edades,4,2,2,13
Izabal,Ignorado(a),Menos de 15 años,0,0,0,13
Izabal,Ignorado(a),15 - 24,0,0,0,13
Izabal,Ignorado(a),25 - 44,1,1,0,13
Izabal,Ignorado(a),45 - 64,0,0,0,13
Izabal,Ignorado(a),65 y más,1,0,1,13
Izabal,Ignorado(a),Ignorado,2,1,1,13
Zacapa,Todos los estados civiles,Todas las edades,1391,773,618,13
Zacapa,Todos los estados civiles,Menos de 15 años,83,39,44,13
Zacapa,Todos los estados civiles,15 - 24,74,54,20,13
Zacapa,Todos los estados civiles,25 - 44,242,175,67,13
Zacapa,Todos los estados civiles,45 - 64,306,169,137,13
Zacapa,Todos los estados civiles,65 y más,677,330,347,13
Zacapa,Todos los estados civiles,Ignorado,9,6,3,13
Zacapa,Soltero(a),Todas las edades,874,469,405,13
Zacapa,Soltero(a),Menos de 15 años,83,39,44,13
Zacapa,Soltero(a),15 - 24,68,50,18,13
Zacapa,Soltero(a),25 - 44,163,122,41,13
Zacapa,Soltero(a),45 - 64,150,82,68,13
Zacapa,Soltero(a),65 y más,402,170,232,13
Zacapa,Soltero(a),Ignorado,8,6,2,13
Zacapa,Casado(a),Todas las edades,512,301,211,13
Zacapa,Casado(a),Menos de 15 años,0,0,0,13
Zacapa,Casado(a),15 - 24,6,4,2,13
Zacapa,Casado(a),25 - 44,78,53,25,13
Zacapa,Casado(a),45 - 64,153,84,69,13
Zacapa,Casado(a),65 y más,275,160,115,13
Zacapa,Casado(a),Ignorado,0,0,0,13
Zacapa,Unido(a),Todas las edades,4,3,1,13
Zacapa,Unido(a),Menos de 15 años,0,0,0,13
Zacapa,Unido(a),15 - 24,0,0,0,13
Zacapa,Unido(a),25 - 44,1,0,1,13
Zacapa,Unido(a),45 - 64,3,3,0,13
Zacapa,Unido(a),65 y más,0,0,0,13
Zacapa,Unido(a),Ignorado,0,0,0,13
Zacapa,Ignorado(a),Todas las edades,1,0,1,13
Zacapa,Ignorado(a),Menos de 15 años,0,0,0,13
Zacapa,Ignorado(a),15 - 24,0,0,0,13
Zacapa,Ignorado(a),25 - 44,0,0,0,13
Zacapa,Ignorado(a),45 - 64,0,0,0,13
Zacapa,Ignorado(a),65 y más,0,0,0,13
Zacapa,Ignorado(a),Ignorado,1,0,1,13
Chiquimula,Todos los estados civiles,Todas las edades,2095,1178,917,13
Chiquimula,Todos los estados civiles,Menos de 15 años,279,139,140,13
Chiquimula,Todos los estados civiles,15 - 24,150,109,41,13
Chiquimula,Todos los estados civiles,25 - 44,356,258,98,13
Chiquimula,Todos los estados civiles,45 - 64,380,206,174,13
Chiquimula,Todos los estados civiles,65 y más,900,452,448,13
Chiquimula,Todos los estados civiles,Ignorado,30,14,16,13
Chiquimula,Soltero(a),Todas las edades,1427,783,644,13
Chiquimula,Soltero(a),Menos de 15 años,277,139,138,13
Chiquimula,Soltero(a),15 - 24,139,101,38,13
Chiquimula,Soltero(a),25 - 44,245,186,59,13
Chiquimula,Soltero(a),45 - 64,187,104,83,13
Chiquimula,Soltero(a),65 y más,551,239,312,13
Chiquimula,Soltero(a),Ignorado,28,14,14,13
Chiquimula,Casado(a),Todas las edades,648,385,263,13
Chiquimula,Casado(a),Menos de 15 años,0,0,0,13
Chiquimula,Casado(a),15 - 24,9,7,2,13
Chiquimula,Casado(a),25 - 44,107,68,39,13
Chiquimula,Casado(a),45 - 64,191,101,90,13
Chiquimula,Casado(a),65 y más,341,209,132,13
Chiquimula,Casado(a),Ignorado,0,0,0,13
Chiquimula,Unido(a),Todas las edades,13,9,4,13
Chiquimula,Unido(a),Menos de 15 años,0,0,0,13
Chiquimula,Unido(a),15 - 24,0,0,0,13
Chiquimula,Unido(a),25 - 44,4,4,0,13
Chiquimula,Unido(a),45 - 64,2,1,1,13
Chiquimula,Unido(a),65 y más,7,4,3,13
Chiquimula,Unido(a),Ignorado,0,0,0,13
Chiquimula,Ignorado(a),Todas las edades,7,1,6,13
Chiquimula,Ignorado(a),Menos de 15 años,2,0,2,13
Chiquimula,Ignorado(a),15 - 24,2,1,1,13
Chiquimula,Ignorado(a),25 - 44,0,0,0,13
Chiquimula,Ignorado(a),45 - 64,0,0,0,13
Chiquimula,Ignorado(a),65 y más,1,0,1,13
Chiquimula,Ignorado(a),Ignorado,2,0,2,13
Jalapa,Todos los estados civiles,Todas las edades,1714,961,753,13
Jalapa,Todos los estados civiles,Menos de 15 años,183,114,69,13
Jalapa,Todos los estados civiles,15 - 24,139,93,46,13
Jalapa,Todos los estados civiles,25 - 44,260,186,74,13
Jalapa,Todos los estados civiles,45 - 64,350,187,163,13
Jalapa,Todos los estados civiles,65 y más,767,371,396,13
Jalapa,Todos los estados civiles,Ignorado,15,10,5,13
Jalapa,Soltero(a),Todas las edades,1000,532,468,13
Jalapa,Soltero(a),Menos de 15 años,183,114,69,13
Jalapa,Soltero(a),15 - 24,131,87,44,13
Jalapa,Soltero(a),25 - 44,154,111,43,13
Jalapa,Soltero(a),45 - 64,131,62,69,13
Jalapa,Soltero(a),65 y más,391,152,239,13
Jalapa,Soltero(a),Ignorado,10,6,4,13
Jalapa,Casado(a),Todas las edades,704,421,283,13
Jalapa,Casado(a),Menos de 15 años,0,0,0,13
Jalapa,Casado(a),15 - 24,8,6,2,13
Jalapa,Casado(a),25 - 44,106,75,31,13
Jalapa,Casado(a),45 - 64,218,124,94,13
Jalapa,Casado(a),65 y más,371,215,156,13
Jalapa,Casado(a),Ignorado,1,1,0,13
Jalapa,Unido(a),Todas las edades,5,4,1,13
Jalapa,Unido(a),Menos de 15 años,0,0,0,13
Jalapa,Unido(a),15 - 24,0,0,0,13
Jalapa,Unido(a),25 - 44,0,0,0,13
Jalapa,Unido(a),45 - 64,0,0,0,13
Jalapa,Unido(a),65 y más,5,4,1,13
Jalapa,Unido(a),Ignorado,0,0,0,13
Jalapa,Ignorado(a),Todas las edades,5,4,1,13
Jalapa,Ignorado(a),Menos de 15 años,0,0,0,13
Jalapa,Ignorado(a),15 - 24,0,0,0,13
Jalapa,Ignorado(a),25 - 44,0,0,0,13
Jalapa,Ignorado(a),45 - 64,1,1,0,13
Jalapa,Ignorado(a),65 y más,0,0,0,13
Jalapa,Ignorado(a),Ignorado,4,3,1,13
Jutiapa,Todos los estados civiles,Todas las edades,2608,1520,1088,13
Jutiapa,Todos los estados civiles,Menos de 15 años,130,69,61,13
Jutiapa,Todos los estados civiles,15 - 24,188,138,50,13
Jutiapa,Todos los estados civiles,25 - 44,421,313,108,13
Jutiapa,Todos los estados civiles,45 - 64,562,322,240,13
Jutiapa,Todos los estados civiles,65 y más,1301,675,626,13
Jutiapa,Todos los estados civiles,Ignorado,6,3,3,13
Jutiapa,Soltero(a),Todas las edades,1703,957,746,13
Jutiapa,Soltero(a),Menos de 15 años,130,69,61,13
Jutiapa,Soltero(a),15 - 24,175,129,46,13
Jutiapa,Soltero(a),25 - 44,286,218,68,13
Jutiapa,Soltero(a),45 - 64,285,159,126,13
Jutiapa,Soltero(a),65 y más,822,379,443,13
Jutiapa,Soltero(a),Ignorado,5,3,2,13
Jutiapa,Casado(a),Todas las edades,877,545,332,13
Jutiapa,Casado(a),Menos de 15 años,0,0,0,13
Jutiapa,Casado(a),15 - 24,13,9,4,13
Jutiapa,Casado(a),25 - 44,135,95,40,13
Jutiapa,Casado(a),45 - 64,271,159,112,13
Jutiapa,Casado(a),65 y más,457,282,175,13
Jutiapa,Casado(a),Ignorado,1,0,1,13
Jutiapa,Unido(a),Todas las edades,22,14,8,13
Jutiapa,Unido(a),Menos de 15 años,0,0,0,13
Jutiapa,Unido(a),15 - 24,0,0,0,13
Jutiapa,Unido(a),25 - 44,0,0,0,13
Jutiapa,Unido(a),45 - 64,3,1,2,13
Jutiapa,Unido(a),65 y más,19,13,6,13
Jutiapa,Unido(a),Ignorado,0,0,0,13
Jutiapa,Ignorado(a),Todas las edades,6,4,2,13
Jutiapa,Ignorado(a),Menos de 15 años,0,0,0,13
Jutiapa,Ignorado(a),15 - 24,0,0,0,13
Jutiapa,Ignorado(a),25 - 44,0,0,0,13
Jutiapa,Ignorado(a),45 - 64,3,3,0,13
Jutiapa,Ignorado(a),65 y más,3,1,2,13
Jutiapa,Ignorado(a),Ignorado,0,0,0,13
Extranjero,Todos los estados civiles,Todas las edades,129,87,42,13
Extranjero,Todos los estados civiles,Menos de 15 años,9,4,5,13
Extranjero,Todos los estados civiles,15 - 24,20,18,2,13
Extranjero,Todos los estados civiles,25 - 44,48,33,15,13
Extranjero,Todos los estados civiles,45 - 64,22,12,10,13
Extranjero,Todos los estados civiles,65 y más,20,12,8,13
Extranjero,Todos los estados civiles,Ignorado,10,8,2,13
Extranjero,Soltero(a),Todas las edades,92,62,30,13
Extranjero,Soltero(a),Menos de 15 años,9,4,5,13
Extranjero,Soltero(a),15 - 24,19,17,2,13
Extranjero,Soltero(a),25 - 44,32,22,10,13
Extranjero,Soltero(a),45 - 64,14,7,7,13
Extranjero,Soltero(a),65 y más,13,7,6,13
Extranjero,Soltero(a),Ignorado,5,5,0,13
Extranjero,Casado(a),Todas las edades,30,20,10,13
Extranjero,Casado(a),Menos de 15 años,0,0,0,13
Extranjero,Casado(a),15 - 24,1,1,0,13
Extranjero,Casado(a),25 - 44,13,9,4,13
Extranjero,Casado(a),45 - 64,7,4,3,13
Extranjero,Casado(a),65 y más,4,3,1,13
Extranjero,Casado(a),Ignorado,5,3,2,13
Extranjero,Unido(a),Todas las edades,1,0,1,13
Extranjero,Unido(a),Menos de 15 años,0,0,0,13
Extranjero,Unido(a),15 - 24,0,0,0,13
Extranjero,Unido(a),25 - 44,1,0,1,13
Extranjero,Unido(a),45 - 64,0,0,0,13
Extranjero,Unido(a),65 y más,0,0,0,13
Extranjero,Unido(a),Ignorado,0,0,0,13
Extranjero,Ignorado(a),Todas las edades,6,5,1,13
Extranjero,Ignorado(a),Menos de 15 años,0,0,0,13
Extranjero,Ignorado(a),15 - 24,0,0,0,13
Extranjero,Ignorado(a),25 - 44,2,2,0,13
Extranjero,Ignorado(a),45 - 64,1,1,0,13
Extranjero,Ignorado(a),65 y más,3,2,1,13
Extranjero,Ignorado(a),Ignorado,0,0,0,13
Ignorado,Todos los estados civiles,Todas las edades,6663,3933,2730,13
Ignorado,Todos los estados civiles,Menos de 15 años,4683,2604,2079,13
Ignorado,Todos los estados civiles,15 - 24,552,421,131,13
Ignorado,Todos los estados civiles,25 - 44,248,201,47,13
Ignorado,Todos los estados civiles,45 - 64,157,125,32,13
Ignorado,Todos los estados civiles,65 y más,236,110,126,13
Ignorado,Todos los estados civiles,Ignorado,787,472,315,13
Ignorado,Todos los estados civiles,Todas las edades,6179,3561,2618,13
Ignorado,Soltero(a),Menos de 15 años,4683,2604,2079,13
Ignorado,Soltero(a),15 - 24,528,403,125,13
Ignorado,Soltero(a),25 - 44,154,125,29,13
Ignorado,Soltero(a),45 - 64,95,71,24,13
Ignorado,Soltero(a),65 y más,200,87,113,13
Ignorado,Soltero(a),Ignorado,519,271,248,13
Ignorado,Casado(a),Todas las edades,87,67,20,13
Ignorado,Casado(a),Menos de 15 años,0,0,0,13
Ignorado,Casado(a),15 - 24,2,2,0,13
Ignorado,Casado(a),25 - 44,28,23,5,13
Ignorado,Casado(a),45 - 64,33,27,6,13
Ignorado,Casado(a),65 y más,23,14,9,13
Ignorado,Casado(a),Ignorado,1,1,0,13
Ignorado,Unido(a),Todas las edades,3,2,1,13
Ignorado,Unido(a),Menos de 15 años,0,0,0,13
Ignorado,Unido(a),15 - 24,0,0,0,13
Ignorado,Unido(a),25 - 44,0,0,0,13
Ignorado,Unido(a),45 - 64,0,0,0,13
Ignorado,Unido(a),65 y más,3,2,1,13
Ignorado,Unido(a),Ignorado,0,0,0,13
Ignorado,Ignorado(a),Todas las edades,394,303,91,13
Ignorado,Ignorado(a),Menos de 15 años,0,0,0,13
Ignorado,Ignorado(a),15 - 24,22,16,6,13
Ignorado,Ignorado(a),25 - 44,66,53,13,13
Ignorado,Ignorado(a),45 - 64,29,27,2,13
Ignorado,Ignorado(a),65 y más,10,7,3,13
Ignorado,Ignorado(a),Ignorado,267,200,67,13
Todos los departamentos,Todos los estados civiles,Todas las edades,77807,43810,33997,14
Todos los departamentos,Todos los estados civiles,Menos de 15 años,11392,6246,5146,14
Todos los departamentos,Todos los estados civiles,15 - 24,5189,3772,1417,14
Todos los departamentos,Todos los estados civiles,25 - 44,10969,7747,3222,14
Todos los departamentos,Todos los estados civiles,45 - 64,15691,8582,7109,14
Todos los departamentos,Todos los estados civiles,65 y más,33972,17086,16886,14
Todos los departamentos,Todos los estados civiles,Ignorado,594,377,217,14
Todos los departamentos,Soltero(a),Todas las edades,51499,28158,23341,14
Todos los departamentos,Soltero(a),Menos de 15 años,11388,6244,5144,14
Todos los departamentos,Soltero(a),15 - 24,4760,3516,1244,14
Todos los departamentos,Soltero(a),25 - 44,6845,4984,1861,14
Todos los departamentos,Soltero(a),45 - 64,7468,3980,3488,14
Todos los departamentos,Soltero(a),65 y más,20667,9216,11451,14
Todos los departamentos,Soltero(a),Ignorado,371,218,153,14
Todos los departamentos,Casado(a),Todas las edades,25034,14840,10194,14
Todos los departamentos,Casado(a),Menos de 15 años,2,0,2,14
Todos los departamentos,Casado(a),15 - 24,387,232,155,14
Todos los departamentos,Casado(a),25 - 44,3957,2632,1325,14
Todos los departamentos,Casado(a),45 - 64,7929,4423,3506,14
Todos los departamentos,Casado(a),65 y más,12735,7541,5194,14
Todos los departamentos,Casado(a),Ignorado,24,12,12,14
Todos los departamentos,Unido(a),Todas las edades,725,402,323,14
Todos los departamentos,Unido(a),Menos de 15 años,0,0,0,14
Todos los departamentos,Unido(a),15 - 24,1,0,1,14
Todos los departamentos,Unido(a),25 - 44,41,29,12,14
Todos los departamentos,Unido(a),45 - 64,193,91,102,14
Todos los departamentos,Unido(a),65 y más,490,282,208,14
Todos los departamentos,Unido(a),Ignorado,0,0,0,14
Todos los departamentos,Ignorado(a),Todas las edades,549,410,139,14
Todos los departamentos,Ignorado(a),Menos de 15 años,2,2,0,14
Todos los departamentos,Ignorado(a),15 - 24,41,24,17,14
Todos los departamentos,Ignorado(a),25 - 44,126,102,24,14
Todos los departamentos,Ignorado(a),45 - 64,101,88,13,14
Todos los departamentos,Ignorado(a),65 y más,80,47,33,14
Todos los departamentos,Ignorado(a),Ignorado,199,147,52,14
Guatemala,Todos los estados civiles,Todas las edades,18123,9920,8203,14
Guatemala,Todos los estados civiles,Menos de 15 años,1650,914,736,14
Guatemala,Todos los estados civiles,15 - 24,1115,872,243,14
Guatemala,Todos los estados civiles,25 - 44,2684,1977,707,14
Guatemala,Todos los estados civiles,45 - 64,4054,2186,1868,14
Guatemala,Todos los estados civiles,65 y más,8561,3938,4623,14
Guatemala,Todos los estados civiles,Ignorado,59,33,26,14
Guatemala,Soltero(a),Todas las edades,11435,6060,5375,14
Guatemala,Soltero(a),Menos de 15 años,1649,913,736,14
Guatemala,Soltero(a),15 - 24,1023,807,216,14
Guatemala,Soltero(a),25 - 44,1753,1327,426,14
Guatemala,Soltero(a),45 - 64,2026,1037,989,14
Guatemala,Soltero(a),65 y más,4947,1954,2993,14
Guatemala,Soltero(a),Ignorado,37,22,15,14
Guatemala,Casado(a),Todas las edades,6522,3756,2766,14
Guatemala,Casado(a),Menos de 15 años,0,0,0,14
Guatemala,Casado(a),15 - 24,75,55,20,14
Guatemala,Casado(a),25 - 44,887,615,272,14
Guatemala,Casado(a),45 - 64,1992,1125,867,14
Guatemala,Casado(a),65 y más,3564,1961,1603,14
Guatemala,Casado(a),Ignorado,4,0,4,14
Guatemala,Unido(a),Todas las edades,43,18,25,14
Guatemala,Unido(a),Menos de 15 años,0,0,0,14
Guatemala,Unido(a),15 - 24,1,0,1,14
Guatemala,Unido(a),25 - 44,0,0,0,14
Guatemala,Unido(a),45 - 64,12,5,7,14
Guatemala,Unido(a),65 y más,30,13,17,14
Guatemala,Unido(a),Ignorado,0,0,0,14
Guatemala,Ignorado(a),Todas las edades,123,86,37,14
Guatemala,Ignorado(a),Menos de 15 años,1,1,0,14
Guatemala,Ignorado(a),15 - 24,16,10,6,14
Guatemala,Ignorado(a),25 - 44,44,35,9,14
Guatemala,Ignorado(a),45 - 64,24,19,5,14
Guatemala,Ignorado(a),65 y más,20,10,10,14
Guatemala,Ignorado(a),Ignorado,18,11,7,14
El Progreso,Todos los estados civiles,Todas las edades,1004,565,439,14
El Progreso,Todos los estados civiles,Menos de 15 años,48,19,29,14
El Progreso,Todos los estados civiles,15 - 24,61,40,21,14
El Progreso,Todos los estados civiles,25 - 44,120,83,37,14
El Progreso,Todos los estados civiles,45 - 64,211,114,97,14
El Progreso,Todos los estados civiles,65 y más,561,307,254,14
El Progreso,Todos los estados civiles,Ignorado,3,2,1,14
El Progreso,Soltero(a),Todas las edades,642,328,314,14
El Progreso,Soltero(a),Menos de 15 años,48,19,29,14
El Progreso,Soltero(a),15 - 24,58,38,20,14
El Progreso,Soltero(a),25 - 44,82,55,27,14
El Progreso,Soltero(a),45 - 64,110,57,53,14
El Progreso,Soltero(a),65 y más,341,157,184,14
El Progreso,Soltero(a),Ignorado,3,2,1,14
El Progreso,Casado(a),Todas las edades,354,235,119,14
El Progreso,Casado(a),Menos de 15 años,0,0,0,14
El Progreso,Casado(a),15 - 24,3,2,1,14
El Progreso,Casado(a),25 - 44,38,28,10,14
El Progreso,Casado(a),45 - 64,101,57,44,14
El Progreso,Casado(a),65 y más,212,148,64,14
El Progreso,Casado(a),Ignorado,0,0,0,14
El Progreso,Unido(a),Todas las edades,8,2,6,14
El Progreso,Unido(a),Menos de 15 años,0,0,0,14
El Progreso,Unido(a),15 - 24,0,0,0,14
El Progreso,Unido(a),25 - 44,0,0,0,14
El Progreso,Unido(a),45 - 64,0,0,0,14
El Progreso,Unido(a),65 y más,8,2,6,14
El Progreso,Unido(a),Ignorado,0,0,0,14
El Progreso,Ignorado(a),Todas las edades,0,0,0,14
El Progreso,Ignorado(a),Menos de 15 años,0,0,0,14
El Progreso,Ignorado(a),15 - 24,0,0,0,14
El Progreso,Ignorado(a),25 - 44,0,0,0,14
El Progreso,Ignorado(a),45 - 64,0,0,0,14
El Progreso,Ignorado(a),65 y más,0,0,0,14
El Progreso,Ignorado(a),Ignorado,0,0,0,14
Sacatepéquez,Todos los estados civiles,Todas las edades,1546,875,671,14
Sacatepéquez,Todos los estados civiles,Menos de 15 años,64,41,23,14
Sacatepéquez,Todos los estados civiles,15 - 24,64,53,11,14
Sacatepéquez,Todos los estados civiles,25 - 44,226,166,60,14
Sacatepéquez,Todos los estados civiles,45 - 64,339,177,162,14
Sacatepéquez,Todos los estados civiles,65 y más,839,429,410,14
Sacatepéquez,Todos los estados civiles,Ignorado,14,9,5,14
Sacatepéquez,Soltero(a),Todas las edades,815,437,378,14
Sacatepéquez,Soltero(a),Menos de 15 años,64,41,23,14
Sacatepéquez,Soltero(a),15 - 24,59,49,10,14
Sacatepéquez,Soltero(a),25 - 44,130,94,36,14
Sacatepéquez,Soltero(a),45 - 64,123,64,59,14
Sacatepéquez,Soltero(a),65 y más,433,186,247,14
Sacatepéquez,Soltero(a),Ignorado,6,3,3,14
Sacatepéquez,Casado(a),Todas las edades,717,427,290,14
Sacatepéquez,Casado(a),Menos de 15 años,0,0,0,14
Sacatepéquez,Casado(a),15 - 24,5,4,1,14
Sacatepéquez,Casado(a),25 - 44,95,71,24,14
Sacatepéquez,Casado(a),45 - 64,215,112,103,14
Sacatepéquez,Casado(a),65 y más,402,240,162,14
Sacatepéquez,Casado(a),Ignorado,0,0,0,14
Sacatepéquez,Unido(a),Todas las edades,3,2,1,14
Sacatepéquez,Unido(a),Menos de 15 años,0,0,0,14
Sacatepéquez,Unido(a),15 - 24,0,0,0,14
Sacatepéquez,Unido(a),25 - 44,0,0,0,14
Sacatepéquez,Unido(a),45 - 64,0,0,0,14
Sacatepéquez,Unido(a),65 y más,3,2,1,14
Sacatepéquez,Unido(a),Ignorado,0,0,0,14
Sacatepéquez,Ignorado(a),Todas las edades,11,9,2,14
Sacatepéquez,Ignorado(a),Menos de 15 años,0,0,0,14
Sacatepéquez,Ignorado(a),15 - 24,0,0,0,14
Sacatepéquez,Ignorado(a),25 - 44,1,1,0,14
Sacatepéquez,Ignorado(a),45 - 64,1,1,0,14
Sacatepéquez,Ignorado(a),65 y más,1,1,0,14
Sacatepéquez,Ignorado(a),Ignorado,8,6,2,14
Chimaltenango,Todos los estados civiles,Todas las edades,2642,1483,1159,14
Chimaltenango,Todos los estados civiles,Menos de 15 años,277,163,114,14
Chimaltenango,Todos los estados civiles,15 - 24,156,119,37,14
Chimaltenango,Todos los estados civiles,25 - 44,395,279,116,14
Chimaltenango,Todos los estados civiles,45 - 64,563,305,258,14
Chimaltenango,Todos los estados civiles,65 y más,1246,613,633,14
Chimaltenango,Todos los estados civiles,Ignorado,5,4,1,14
Chimaltenango,Soltero(a),Todas las edades,1388,737,651,14
Chimaltenango,Soltero(a),Menos de 15 años,277,163,114,14
Chimaltenango,Soltero(a),15 - 24,133,104,29,14
Chimaltenango,Soltero(a),25 - 44,179,138,41,14
Chimaltenango,Soltero(a),45 - 64,177,82,95,14
Chimaltenango,Soltero(a),65 y más,619,248,371,14
Chimaltenango,Soltero(a),Ignorado,3,2,1,14
Chimaltenango,Casado(a),Todas las edades,1244,742,502,14
Chimaltenango,Casado(a),Menos de 15 años,0,0,0,14
Chimaltenango,Casado(a),15 - 24,23,15,8,14
Chimaltenango,Casado(a),25 - 44,216,141,75,14
Chimaltenango,Casado(a),45 - 64,385,223,162,14
Chimaltenango,Casado(a),65 y más,619,362,257,14
Chimaltenango,Casado(a),Ignorado,1,1,0,14
Chimaltenango,Unido(a),Todas las edades,8,2,6,14
Chimaltenango,Unido(a),Menos de 15 años,0,0,0,14
Chimaltenango,Unido(a),15 - 24,0,0,0,14
Chimaltenango,Unido(a),25 - 44,0,0,0,14
Chimaltenango,Unido(a),45 - 64,1,0,1,14
Chimaltenango,Unido(a),65 y más,7,2,5,14
Chimaltenango,Unido(a),Ignorado,0,0,0,14
Chimaltenango,Ignorado(a),Todas las edades,2,2,0,14
Chimaltenango,Ignorado(a),Menos de 15 años,0,0,0,14
Chimaltenango,Ignorado(a),15 - 24,0,0,0,14
Chimaltenango,Ignorado(a),25 - 44,0,0,0,14
Chimaltenango,Ignorado(a),45 - 64,0,0,0,14
Chimaltenango,Ignorado(a),65 y más,1,1,0,14
Chimaltenango,Ignorado(a),Ignorado,1,1,0,14
Escuintla,Todos los estados civiles,Todas las edades,4245,2545,1700,14
Escuintla,Todos los estados civiles,Menos de 15 años,225,129,96,14
Escuintla,Todos los estados civiles,15 - 24,279,240,39,14
Escuintla,Todos los estados civiles,25 - 44,740,537,203,14
Escuintla,Todos los estados civiles,45 - 64,1083,593,490,14
Escuintla,Todos los estados civiles,65 y más,1909,1040,869,14
Escuintla,Todos los estados civiles,Ignorado,9,6,3,14
Escuintla,Soltero(a),Todas las edades,2882,1722,1160,14
Escuintla,Soltero(a),Menos de 15 años,225,129,96,14
Escuintla,Soltero(a),15 - 24,257,224,33,14
Escuintla,Soltero(a),25 - 44,527,398,129,14
Escuintla,Soltero(a),45 - 64,595,328,267,14
Escuintla,Soltero(a),65 y más,1272,639,633,14
Escuintla,Soltero(a),Ignorado,6,4,2,14
Escuintla,Casado(a),Todas las edades,1345,811,534,14
Escuintla,Casado(a),Menos de 15 años,0,0,0,14
Escuintla,Casado(a),15 - 24,22,16,6,14
Escuintla,Casado(a),25 - 44,211,137,74,14
Escuintla,Casado(a),45 - 64,487,264,223,14
Escuintla,Casado(a),65 y más,624,394,230,14
Escuintla,Casado(a),Ignorado,1,0,1,14
Escuintla,Unido(a),Todas las edades,13,8,5,14
Escuintla,Unido(a),Menos de 15 años,0,0,0,14
Escuintla,Unido(a),15 - 24,0,0,0,14
Escuintla,Unido(a),25 - 44,1,1,0,14
Escuintla,Unido(a),45 - 64,1,1,0,14
Escuintla,Unido(a),65 y más,11,6,5,14
Escuintla,Unido(a),Ignorado,0,0,0,14
Escuintla,Ignorado(a),Todas las edades,5,4,1,14
Escuintla,Ignorado(a),Menos de 15 años,0,0,0,14
Escuintla,Ignorado(a),15 - 24,0,0,0,14
Escuintla,Ignorado(a),25 - 44,1,1,0,14
Escuintla,Ignorado(a),45 - 64,0,0,0,14
Escuintla,Ignorado(a),65 y más,2,1,1,14
Escuintla,Ignorado(a),Ignorado,2,2,0,14
Santa Rosa,Todos los estados civiles,Todas las edades,2061,1253,808,14
Santa Rosa,Todos los estados civiles,Menos de 15 años,135,77,58,14
Santa Rosa,Todos los estados civiles,15 - 24,148,120,28,14
Santa Rosa,Todos los estados civiles,25 - 44,307,232,75,14
Santa Rosa,Todos los estados civiles,45 - 64,453,262,191,14
Santa Rosa,Todos los estados civiles,65 y más,1011,557,454,14
Santa Rosa,Todos los estados civiles,Ignorado,7,5,2,14
Santa Rosa,Soltero(a),Todas las edades,1390,840,550,14
Santa Rosa,Soltero(a),Menos de 15 años,135,77,58,14
Santa Rosa,Soltero(a),15 - 24,141,116,25,14
Santa Rosa,Soltero(a),25 - 44,224,173,51,14
Santa Rosa,Soltero(a),45 - 64,232,141,91,14
Santa Rosa,Soltero(a),65 y más,651,328,323,14
Santa Rosa,Soltero(a),Ignorado,7,5,2,14
Santa Rosa,Casado(a),Todas las edades,648,399,249,14
Santa Rosa,Casado(a),Menos de 15 años,0,0,0,14
Santa Rosa,Casado(a),15 - 24,7,4,3,14
Santa Rosa,Casado(a),25 - 44,81,57,24,14
Santa Rosa,Casado(a),45 - 64,216,119,97,14
Santa Rosa,Casado(a),65 y más,344,219,125,14
Santa Rosa,Casado(a),Ignorado,0,0,0,14
Santa Rosa,Unido(a),Todas las edades,22,14,8,14
Santa Rosa,Unido(a),Menos de 15 años,0,0,0,14
Santa Rosa,Unido(a),15 - 24,0,0,0,14
Santa Rosa,Unido(a),25 - 44,2,2,0,14
Santa Rosa,Unido(a),45 - 64,5,2,3,14
Santa Rosa,Unido(a),65 y más,15,10,5,14
Santa Rosa,Unido(a),Ignorado,0,0,0,14
Santa Rosa,Ignorado(a),Todas las edades,1,0,1,14
Santa Rosa,Ignorado(a),Menos de 15 años,0,0,0,14
Santa Rosa,Ignorado(a),15 - 24,0,0,0,14
Santa Rosa,Ignorado(a),25 - 44,0,0,0,14
Santa Rosa,Ignorado(a),45 - 64,0,0,0,14
Santa Rosa,Ignorado(a),65 y más,1,0,1,14
Santa Rosa,Ignorado(a),Ignorado,0,0,0,14
Sololá,Todos los estados civiles,Todas las edades,1683,925,758,14
Sololá,Todos los estados civiles,Menos de 15 años,134,72,62,14
Sololá,Todos los estados civiles,15 - 24,98,64,34,14
Sololá,Todos los estados civiles,25 - 44,241,163,78,14
Sololá,Todos los estados civiles,45 - 64,378,205,173,14
Sololá,Todos los estados civiles,65 y más,821,414,407,14
Sololá,Todos los estados civiles,Ignorado,11,7,4,14
Sololá,Soltero(a),Todas las edades,1083,573,510,14
Sololá,Soltero(a),Menos de 15 años,134,72,62,14
Sololá,Soltero(a),15 - 24,91,60,31,14
Sololá,Soltero(a),25 - 44,151,104,47,14
Sololá,Soltero(a),45 - 64,184,99,85,14
Sololá,Soltero(a),65 y más,516,235,281,14
Sololá,Soltero(a),Ignorado,7,3,4,14
Sololá,Casado(a),Todas las edades,512,297,215,14
Sololá,Casado(a),Menos de 15 años,0,0,0,14
Sololá,Casado(a),15 - 24,7,4,3,14
Sololá,Casado(a),25 - 44,87,57,30,14
Sololá,Casado(a),45 - 64,167,87,80,14
Sololá,Casado(a),65 y más,248,146,102,14
Sololá,Casado(a),Ignorado,3,3,0,14
Sololá,Unido(a),Todas las edades,86,54,32,14
Sololá,Unido(a),Menos de 15 años,0,0,0,14
Sololá,Unido(a),15 - 24,0,0,0,14
Sololá,Unido(a),25 - 44,3,2,1,14
Sololá,Unido(a),45 - 64,27,19,8,14
Sololá,Unido(a),65 y más,56,33,23,14
Sololá,Unido(a),Ignorado,0,0,0,14
Sololá,Ignorado(a),Todas las edades,2,1,1,14
Sololá,Ignorado(a),Menos de 15 años,0,0,0,14
Sololá,Ignorado(a),15 - 24,0,0,0,14
Sololá,Ignorado(a),25 - 44,0,0,0,14
Sololá,Ignorado(a),45 - 64,0,0,0,14
Sololá,Ignorado(a),65 y más,1,0,1,14
Sololá,Ignorado(a),Ignorado,1,1,0,14
Totonicapán,Todos los estados civiles,Todas las edades,2067,1124,943,14
Totonicapán,Todos los estados civiles,Menos de 15 años,146,86,60,14
Totonicapán,Todos los estados civiles,15 - 24,90,49,41,14
Totonicapán,Todos los estados civiles,25 - 44,337,224,113,14
Totonicapán,Todos los estados civiles,45 - 64,471,267,204,14
Totonicapán,Todos los estados civiles,65 y más,1015,493,522,14
Totonicapán,Todos los estados civiles,Ignorado,8,5,3,14
Totonicapán,Soltero(a),Todas las edades,1179,580,599,14
Totonicapán,Soltero(a),Menos de 15 años,146,86,60,14
Totonicapán,Soltero(a),15 - 24,77,42,35,14
Totonicapán,Soltero(a),25 - 44,174,114,60,14
Totonicapán,Soltero(a),45 - 64,173,93,80,14
Totonicapán,Soltero(a),65 y más,602,241,361,14
Totonicapán,Soltero(a),Ignorado,7,4,3,14
Totonicapán,Casado(a),Todas las edades,824,513,311,14
Totonicapán,Casado(a),Menos de 15 años,0,0,0,14
Totonicapán,Casado(a),15 - 24,13,7,6,14
Totonicapán,Casado(a),25 - 44,163,110,53,14
Totonicapán,Casado(a),45 - 64,283,168,115,14
Totonicapán,Casado(a),65 y más,364,227,137,14
Totonicapán,Casado(a),Ignorado,1,1,0,14
Totonicapán,Unido(a),Todas las edades,63,30,33,14
Totonicapán,Unido(a),Menos de 15 años,0,0,0,14
Totonicapán,Unido(a),15 - 24,0,0,0,14
Totonicapán,Unido(a),25 - 44,0,0,0,14
Totonicapán,Unido(a),45 - 64,14,5,9,14
Totonicapán,Unido(a),65 y más,49,25,24,14
Totonicapán,Unido(a),Ignorado,0,0,0,14
Totonicapán,Ignorado(a),Todas las edades,1,1,0,14
Totonicapán,Ignorado(a),Menos de 15 años,0,0,0,14
Totonicapán,Ignorado(a),15 - 24,0,0,0,14
Totonicapán,Ignorado(a),25 - 44,0,0,0,14
Totonicapán,Ignorado(a),45 - 64,1,1,0,14
Totonicapán,Ignorado(a),65 y más,0,0,0,14
Totonicapán,Ignorado(a),Ignorado,0,0,0,14
Quetzaltenango,Todos los estados civiles,Todas las edades,3940,2159,1781,14
Quetzaltenango,Todos los estados civiles,Menos de 15 años,258,134,124,14
Quetzaltenango,Todos los estados civiles,15 - 24,221,146,75,14
Quetzaltenango,Todos los estados civiles,25 - 44,553,381,172,14
Quetzaltenango,Todos los estados civiles,45 - 64,837,474,363,14
Quetzaltenango,Todos los estados civiles,65 y más,2049,1014,1035,14
Quetzaltenango,Todos los estados civiles,Ignorado,22,10,12,14
Quetzaltenango,Soltero(a),Todas las edades,2384,1240,1144,14
Quetzaltenango,Soltero(a),Menos de 15 años,258,134,124,14
Quetzaltenango,Soltero(a),15 - 24,197,135,62,14
Quetzaltenango,Soltero(a),25 - 44,323,222,101,14
Quetzaltenango,Soltero(a),45 - 64,376,212,164,14
Quetzaltenango,Soltero(a),65 y más,1214,528,686,14
Quetzaltenango,Soltero(a),Ignorado,16,9,7,14
Quetzaltenango,Casado(a),Todas las edades,1484,882,602,14
Quetzaltenango,Casado(a),Menos de 15 años,0,0,0,14
Quetzaltenango,Casado(a),15 - 24,24,11,13,14
Quetzaltenango,Casado(a),25 - 44,223,154,69,14
Quetzaltenango,Casado(a),45 - 64,442,256,186,14
Quetzaltenango,Casado(a),65 y más,793,461,332,14
Quetzaltenango,Casado(a),Ignorado,2,0,2,14
Quetzaltenango,Unido(a),Todas las edades,63,34,29,14
Quetzaltenango,Unido(a),Menos de 15 años,0,0,0,14
Quetzaltenango,Unido(a),15 - 24,0,0,0,14
Quetzaltenango,Unido(a),25 - 44,5,3,2,14
Quetzaltenango,Unido(a),45 - 64,19,6,13,14
Quetzaltenango,Unido(a),65 y más,39,25,14,14
Quetzaltenango,Unido(a),Ignorado,0,0,0,14
Quetzaltenango,Ignorado(a),Todas las edades,9,3,6,14
Quetzaltenango,Ignorado(a),Menos de 15 años,0,0,0,14
Quetzaltenango,Ignorado(a),15 - 24,0,0,0,14
Quetzaltenango,Ignorado(a),25 - 44,2,2,0,14
Quetzaltenango,Ignorado(a),45 - 64,0,0,0,14
Quetzaltenango,Ignorado(a),65 y más,3,0,3,14
Quetzaltenango,Ignorado(a),Ignorado,4,1,3,14
Suchitepéquez,Todos los estados civiles,Todas las edades,2792,1644,1148,14
Suchitepéquez,Todos los estados civiles,Menos de 15 años,150,78,72,14
Suchitepéquez,Todos los estados civiles,15 - 24,143,121,22,14
Suchitepéquez,Todos los estados civiles,25 - 44,423,318,105,14
Suchitepéquez,Todos los estados civiles,45 - 64,662,374,288,14
Suchitepéquez,Todos los estados civiles,65 y más,1405,747,658,14
Suchitepéquez,Todos los estados civiles,Ignorado,9,6,3,14
Suchitepéquez,Soltero(a),Todas las edades,1699,967,732,14
Suchitepéquez,Soltero(a),Menos de 15 años,150,78,72,14
Suchitepéquez,Soltero(a),15 - 24,124,106,18,14
Suchitepéquez,Soltero(a),25 - 44,246,194,52,14
Suchitepéquez,Soltero(a),45 - 64,289,166,123,14
Suchitepéquez,Soltero(a),65 y más,883,419,464,14
Suchitepéquez,Soltero(a),Ignorado,7,4,3,14
Suchitepéquez,Casado(a),Todas las edades,1064,659,405,14
Suchitepéquez,Casado(a),Menos de 15 años,0,0,0,14
Suchitepéquez,Casado(a),15 - 24,19,15,4,14
Suchitepéquez,Casado(a),25 - 44,175,122,53,14
Suchitepéquez,Casado(a),45 - 64,368,204,164,14
Suchitepéquez,Casado(a),65 y más,500,316,184,14
Suchitepéquez,Casado(a),Ignorado,2,2,0,14
Suchitepéquez,Unido(a),Todas las edades,19,10,9,14
Suchitepéquez,Unido(a),Menos de 15 años,0,0,0,14
Suchitepéquez,Unido(a),15 - 24,0,0,0,14
Suchitepéquez,Unido(a),25 - 44,1,1,0,14
Suchitepéquez,Unido(a),45 - 64,2,1,1,14
Suchitepéquez,Unido(a),65 y más,16,8,8,14
Suchitepéquez,Unido(a),Ignorado,0,0,0,14
Suchitepéquez,Ignorado(a),Todas las edades,10,8,2,14
Suchitepéquez,Ignorado(a),Menos de 15 años,0,0,0,14
Suchitepéquez,Ignorado(a),15 - 24,0,0,0,14
Suchitepéquez,Ignorado(a),25 - 44,1,1,0,14
Suchitepéquez,Ignorado(a),45 - 64,3,3,0,14
Suchitepéquez,Ignorado(a),65 y más,6,4,2,14
Suchitepéquez,Ignorado(a),Ignorado,0,0,0,14
Retalhuleu,Todos los estados civiles,Todas las edades,1729,974,755,14
Retalhuleu,Todos los estados civiles,Menos de 15 años,134,81,53,14
Retalhuleu,Todos los estados civiles,15 - 24,105,74,31,14
Retalhuleu,Todos los estados civiles,25 - 44,261,193,68,14
Retalhuleu,Todos los estados civiles,45 - 64,376,205,171,14
Retalhuleu,Todos los estados civiles,65 y más,841,413,428,14
Retalhuleu,Todos los estados civiles,Ignorado,12,8,4,14
Retalhuleu,Soltero(a),Todas las edades,1065,595,470,14
Retalhuleu,Soltero(a),Menos de 15 años,134,81,53,14
Retalhuleu,Soltero(a),15 - 24,92,65,27,14
Retalhuleu,Soltero(a),25 - 44,162,120,42,14
Retalhuleu,Soltero(a),45 - 64,172,96,76,14
Retalhuleu,Soltero(a),65 y más,497,228,269,14
Retalhuleu,Soltero(a),Ignorado,8,5,3,14
Retalhuleu,Casado(a),Todas las edades,616,356,260,14
Retalhuleu,Casado(a),Menos de 15 años,0,0,0,14
Retalhuleu,Casado(a),15 - 24,13,9,4,14
Retalhuleu,Casado(a),25 - 44,97,71,26,14
Retalhuleu,Casado(a),45 - 64,193,105,88,14
Retalhuleu,Casado(a),65 y más,311,170,141,14
Retalhuleu,Casado(a),Ignorado,2,1,1,14
Retalhuleu,Unido(a),Todas las edades,46,21,25,14
Retalhuleu,Unido(a),Menos de 15 años,0,0,0,14
Retalhuleu,Unido(a),15 - 24,0,0,0,14
Retalhuleu,Unido(a),25 - 44,2,2,0,14
Retalhuleu,Unido(a),45 - 64,11,4,7,14
Retalhuleu,Unido(a),65 y más,33,15,18,14
Retalhuleu,Unido(a),Ignorado,0,0,0,14
Retalhuleu,Ignorado(a),Todas las edades,2,2,0,14
Retalhuleu,Ignorado(a),Menos de 15 años,0,0,0,14
Retalhuleu,Ignorado(a),15 - 24,0,0,0,14
Retalhuleu,Ignorado(a),25 - 44,0,0,0,14
Retalhuleu,Ignorado(a),45 - 64,0,0,0,14
Retalhuleu,Ignorado(a),65 y más,0,0,0,14
Retalhuleu,Ignorado(a),Ignorado,2,2,0,14
San Marcos,Todos los estados civiles,Todas las edades,4362,2477,1885,14
San Marcos,Todos los estados civiles,Menos de 15 años,256,131,125,14
San Marcos,Todos los estados civiles,15 - 24,284,180,104,14
San Marcos,Todos los estados civiles,25 - 44,677,473,204,14
San Marcos,Todos los estados civiles,45 - 64,958,550,408,14
San Marcos,Todos los estados civiles,65 y más,2174,1139,1035,14
San Marcos,Todos los estados civiles,Ignorado,13,4,9,14
San Marcos,Soltero(a),Todas las edades,2828,1590,1238,14
San Marcos,Soltero(a),Menos de 15 años,256,131,125,14
San Marcos,Soltero(a),15 - 24,262,172,90,14
San Marcos,Soltero(a),25 - 44,458,327,131,14
San Marcos,Soltero(a),45 - 64,474,278,196,14
San Marcos,Soltero(a),65 y más,1367,679,688,14
San Marcos,Soltero(a),Ignorado,11,3,8,14
San Marcos,Casado(a),Todas las edades,1469,852,617,14
San Marcos,Casado(a),Menos de 15 años,0,0,0,14
San Marcos,Casado(a),15 - 24,22,8,14,14
San Marcos,Casado(a),25 - 44,214,144,70,14
San Marcos,Casado(a),45 - 64,465,264,201,14
San Marcos,Casado(a),65 y más,767,435,332,14
San Marcos,Casado(a),Ignorado,1,1,0,14
San Marcos,Unido(a),Todas las edades,63,35,28,14
San Marcos,Unido(a),Menos de 15 años,0,0,0,14
San Marcos,Unido(a),15 - 24,0,0,0,14
San Marcos,Unido(a),25 - 44,5,2,3,14
San Marcos,Unido(a),45 - 64,19,8,11,14
San Marcos,Unido(a),65 y más,39,25,14,14
San Marcos,Unido(a),Ignorado,0,0,0,14
San Marcos,Ignorado(a),Todas las edades,2,0,2,14
San Marcos,Ignorado(a),Menos de 15 años,0,0,0,14
San Marcos,Ignorado(a),15 - 24,0,0,0,14
San Marcos,Ignorado(a),25 - 44,0,0,0,14
San Marcos,Ignorado(a),45 - 64,0,0,0,14
San Marcos,Ignorado(a),65 y más,1,0,1,14
San Marcos,Ignorado(a),Ignorado,1,0,1,14
Huehuetenango,Todos los estados civiles,Todas las edades,3949,2163,1786,14
Huehuetenango,Todos los estados civiles,Menos de 15 años,425,210,215,14
Huehuetenango,Todos los estados civiles,15 - 24,238,142,96,14
Huehuetenango,Todos los estados civiles,25 - 44,592,352,240,14
Huehuetenango,Todos los estados civiles,45 - 64,806,421,385,14
Huehuetenango,Todos los estados civiles,65 y más,1871,1030,841,14
Huehuetenango,Todos los estados civiles,Ignorado,17,8,9,14
Huehuetenango,Soltero(a),Todas las edades,2800,1499,1301,14
Huehuetenango,Soltero(a),Menos de 15 años,425,210,215,14
Huehuetenango,Soltero(a),15 - 24,213,132,81,14
Huehuetenango,Soltero(a),25 - 44,378,234,144,14
Huehuetenango,Soltero(a),45 - 64,435,218,217,14
Huehuetenango,Soltero(a),65 y más,1332,697,635,14
Huehuetenango,Soltero(a),Ignorado,17,8,9,14
Huehuetenango,Casado(a),Todas las edades,1140,661,479,14
Huehuetenango,Casado(a),Menos de 15 años,0,0,0,14
Huehuetenango,Casado(a),15 - 24,25,10,15,14
Huehuetenango,Casado(a),25 - 44,213,117,96,14
Huehuetenango,Casado(a),45 - 64,371,203,168,14
Huehuetenango,Casado(a),65 y más,531,331,200,14
Huehuetenango,Casado(a),Ignorado,0,0,0,14
Huehuetenango,Unido(a),Todas las edades,8,3,5,14
Huehuetenango,Unido(a),Menos de 15 años,0,0,0,14
Huehuetenango,Unido(a),15 - 24,0,0,0,14
Huehuetenango,Unido(a),25 - 44,1,1,0,14
Huehuetenango,Unido(a),45 - 64,0,0,0,14
Huehuetenango,Unido(a),65 y más,7,2,5,14
Huehuetenango,Unido(a),Ignorado,0,0,0,14
Huehuetenango,Ignorado(a),Todas las edades,1,0,1,14
Huehuetenango,Ignorado(a),Menos de 15 años,0,0,0,14
Huehuetenango,Ignorado(a),15 - 24,0,0,0,14
Huehuetenango,Ignorado(a),25 - 44,0,0,0,14
Huehuetenango,Ignorado(a),45 - 64,0,0,0,14
Huehuetenango,Ignorado(a),65 y más,1,0,1,14
Huehuetenango,Ignorado(a),Ignorado,0,0,0,14
Quiché,Todos los estados civiles,Todas las edades,3551,1928,1623,14
Quiché,Todos los estados civiles,Menos de 15 años,434,232,202,14
Quiché,Todos los estados civiles,15 - 24,235,151,84,14
Quiché,Todos los estados civiles,25 - 44,562,368,194,14
Quiché,Todos los estados civiles,45 - 64,744,382,362,14
Quiché,Todos los estados civiles,65 y más,1553,783,770,14
Quiché,Todos los estados civiles,Ignorado,23,12,11,14
Quiché,Soltero(a),Todas las edades,2387,1250,1137,14
Quiché,Soltero(a),Menos de 15 años,434,232,202,14
Quiché,Soltero(a),15 - 24,205,135,70,14
Quiché,Soltero(a),25 - 44,321,216,105,14
Quiché,Soltero(a),45 - 64,347,176,171,14
Quiché,Soltero(a),65 y más,1060,480,580,14
Quiché,Soltero(a),Ignorado,20,11,9,14
Quiché,Casado(a),Todas las edades,1139,661,478,14
Quiché,Casado(a),Menos de 15 años,0,0,0,14
Quiché,Casado(a),15 - 24,30,16,14,14
Quiché,Casado(a),25 - 44,241,152,89,14
Quiché,Casado(a),45 - 64,393,205,188,14
Quiché,Casado(a),65 y más,475,288,187,14
Quiché,Casado(a),Ignorado,0,0,0,14
Quiché,Unido(a),Todas las edades,20,14,6,14
Quiché,Unido(a),Menos de 15 años,0,0,0,14
Quiché,Unido(a),15 - 24,0,0,0,14
Quiché,Unido(a),25 - 44,0,0,0,14
Quiché,Unido(a),45 - 64,3,0,3,14
Quiché,Unido(a),65 y más,17,14,3,14
Quiché,Unido(a),Ignorado,0,0,0,14
Quiché,Ignorado(a),Todas las edades,5,3,2,14
Quiché,Ignorado(a),Menos de 15 años,0,0,0,14
Quiché,Ignorado(a),15 - 24,0,0,0,14
Quiché,Ignorado(a),25 - 44,0,0,0,14
Quiché,Ignorado(a),45 - 64,1,1,0,14
Quiché,Ignorado(a),65 y más,1,1,0,14
Quiché,Ignorado(a),Ignorado,3,1,2,14
Baja Verapaz,Todos los estados civiles,Todas las edades,1174,612,562,14
Baja Verapaz,Todos los estados civiles,Menos de 15 años,122,68,54,14
Baja Verapaz,Todos los estados civiles,15 - 24,81,55,26,14
Baja Verapaz,Todos los estados civiles,25 - 44,163,97,66,14
Baja Verapaz,Todos los estados civiles,45 - 64,214,96,118,14
Baja Verapaz,Todos los estados civiles,65 y más,588,293,295,14
Baja Verapaz,Todos los estados civiles,Ignorado,6,3,3,14
Baja Verapaz,Soltero(a),Todas las edades,723,358,365,14
Baja Verapaz,Soltero(a),Menos de 15 años,122,68,54,14
Baja Verapaz,Soltero(a),15 - 24,69,48,21,14
Baja Verapaz,Soltero(a),25 - 44,69,42,27,14
Baja Verapaz,Soltero(a),45 - 64,107,50,57,14
Baja Verapaz,Soltero(a),65 y más,351,147,204,14
Baja Verapaz,Soltero(a),Ignorado,5,3,2,14
Baja Verapaz,Casado(a),Todas las edades,429,242,187,14
Baja Verapaz,Casado(a),Menos de 15 años,0,0,0,14
Baja Verapaz,Casado(a),15 - 24,12,7,5,14
Baja Verapaz,Casado(a),25 - 44,94,55,39,14
Baja Verapaz,Casado(a),45 - 64,105,46,59,14
Baja Verapaz,Casado(a),65 y más,217,134,83,14
Baja Verapaz,Casado(a),Ignorado,1,0,1,14
Baja Verapaz,Unido(a),Todas las edades,22,12,10,14
Baja Verapaz,Unido(a),Menos de 15 años,0,0,0,14
Baja Verapaz,Unido(a),15 - 24,0,0,0,14
Baja Verapaz,Unido(a),25 - 44,0,0,0,14
Baja Verapaz,Unido(a),45 - 64,2,0,2,14
Baja Verapaz,Unido(a),65 y más,20,12,8,14
Baja Verapaz,Unido(a),Ignorado,0,0,0,14
Baja Verapaz,Ignorado(a),Todas las edades,0,0,0,14
Baja Verapaz,Ignorado(a),Menos de 15 años,0,0,0,14
Baja Verapaz,Ignorado(a),15 - 24,0,0,0,14
Baja Verapaz,Ignorado(a),25 - 44,0,0,0,14
Baja Verapaz,Ignorado(a),45 - 64,0,0,0,14
Baja Verapaz,Ignorado(a),65 y más,0,0,0,14
Baja Verapaz,Ignorado(a),Ignorado,0,0,0,14
Alta Verapaz,Todos los estados civiles,Todas las edades,4406,2265,2141,14
Alta Verapaz,Todos los estados civiles,Menos de 15 años,850,484,366,14
Alta Verapaz,Todos los estados civiles,15 - 24,279,185,94,14
Alta Verapaz,Todos los estados civiles,25 - 44,563,318,245,14
Alta Verapaz,Todos los estados civiles,45 - 64,820,414,406,14
Alta Verapaz,Todos los estados civiles,65 y más,1867,851,1016,14
Alta Verapaz,Todos los estados civiles,Ignorado,27,13,14,14
Alta Verapaz,Soltero(a),Todas las edades,2637,1310,1327,14
Alta Verapaz,Soltero(a),Menos de 15 años,850,484,366,14
Alta Verapaz,Soltero(a),15 - 24,249,170,79,14
Alta Verapaz,Soltero(a),25 - 44,277,165,112,14
Alta Verapaz,Soltero(a),45 - 64,273,126,147,14
Alta Verapaz,Soltero(a),65 y más,962,353,609,14
Alta Verapaz,Soltero(a),Ignorado,26,12,14,14
Alta Verapaz,Casado(a),Todas las edades,1705,917,788,14
Alta Verapaz,Casado(a),Menos de 15 años,0,0,0,14
Alta Verapaz,Casado(a),15 - 24,30,15,15,14
Alta Verapaz,Casado(a),25 - 44,281,150,131,14
Alta Verapaz,Casado(a),45 - 64,526,276,250,14
Alta Verapaz,Casado(a),65 y más,867,475,392,14
Alta Verapaz,Casado(a),Ignorado,1,1,0,14
Alta Verapaz,Unido(a),Todas las edades,62,37,25,14
Alta Verapaz,Unido(a),Menos de 15 años,0,0,0,14
Alta Verapaz,Unido(a),15 - 24,0,0,0,14
Alta Verapaz,Unido(a),25 - 44,4,3,1,14
Alta Verapaz,Unido(a),45 - 64,21,12,9,14
Alta Verapaz,Unido(a),65 y más,37,22,15,14
Alta Verapaz,Unido(a),Ignorado,0,0,0,14
Alta Verapaz,Ignorado(a),Todas las edades,2,1,1,14
Alta Verapaz,Ignorado(a),Menos de 15 años,0,0,0,14
Alta Verapaz,Ignorado(a),15 - 24,0,0,0,14
Alta Verapaz,Ignorado(a),25 - 44,1,0,1,14
Alta Verapaz,Ignorado(a),45 - 64,0,0,0,14
Alta Verapaz,Ignorado(a),65 y más,1,1,0,14
Alta Verapaz,Ignorado(a),Ignorado,0,0,0,14
Petén,Todos los estados civiles,Todas las edades,1833,1111,722,14
Petén,Todos los estados civiles,Menos de 15 años,190,89,101,14
Petén,Todos los estados civiles,15 - 24,190,143,47,14
Petén,Todos los estados civiles,25 - 44,350,249,101,14
Petén,Todos los estados civiles,45 - 64,410,220,190,14
Petén,Todos los estados civiles,65 y más,674,396,278,14
Petén,Todos los estados civiles,Ignorado,19,14,5,14
Petén,Soltero(a),Todas las edades,1264,767,497,14
Petén,Soltero(a),Menos de 15 años,190,89,101,14
Petén,Soltero(a),15 - 24,178,135,43,14
Petén,Soltero(a),25 - 44,236,176,60,14
Petén,Soltero(a),45 - 64,193,103,90,14
Petén,Soltero(a),65 y más,451,253,198,14
Petén,Soltero(a),Ignorado,16,11,5,14
Petén,Casado(a),Todas las edades,471,281,190,14
Petén,Casado(a),Menos de 15 años,0,0,0,14
Petén,Casado(a),15 - 24,12,8,4,14
Petén,Casado(a),25 - 44,101,64,37,14
Petén,Casado(a),45 - 64,177,96,81,14
Petén,Casado(a),65 y más,181,113,68,14
Petén,Casado(a),Ignorado,0,0,0,14
Petén,Unido(a),Todas las edades,95,60,35,14
Petén,Unido(a),Menos de 15 años,0,0,0,14
Petén,Unido(a),15 - 24,0,0,0,14
Petén,Unido(a),25 - 44,13,9,4,14
Petén,Unido(a),45 - 64,40,21,19,14
Petén,Unido(a),65 y más,42,30,12,14
Petén,Unido(a),Ignorado,0,0,0,14
Petén,Ignorado(a),Todas las edades,3,3,0,14
Petén,Ignorado(a),Menos de 15 años,0,0,0,14
Petén,Ignorado(a),15 - 24,0,0,0,14
Petén,Ignorado(a),25 - 44,0,0,0,14
Petén,Ignorado(a),45 - 64,0,0,0,14
Petén,Ignorado(a),65 y más,0,0,0,14
Petén,Ignorado(a),Ignorado,3,3,0,14
Izabal,Todos los estados civiles,Todas las edades,1990,1171,819,14
Izabal,Todos los estados civiles,Menos de 15 años,194,113,81,14
Izabal,Todos los estados civiles,15 - 24,171,130,41,14
Izabal,Todos los estados civiles,25 - 44,336,243,93,14
Izabal,Todos los estados civiles,45 - 64,424,215,209,14
Izabal,Todos los estados civiles,65 y más,858,465,393,14
Izabal,Todos los estados civiles,Ignorado,7,5,2,14
Izabal,Soltero(a),Todas las edades,1396,812,584,14
Izabal,Soltero(a),Menos de 15 años,193,113,80,14
Izabal,Soltero(a),15 - 24,161,126,35,14
Izabal,Soltero(a),25 - 44,238,177,61,14
Izabal,Soltero(a),45 - 64,230,115,115,14
Izabal,Soltero(a),65 y más,568,276,292,14
Izabal,Soltero(a),Ignorado,6,5,1,14
Izabal,Casado(a),Todas las edades,560,345,215,14
Izabal,Casado(a),Menos de 15 años,1,0,1,14
Izabal,Casado(a),15 - 24,10,4,6,14
Izabal,Casado(a),25 - 44,98,66,32,14
Izabal,Casado(a),45 - 64,185,99,86,14
Izabal,Casado(a),65 y más,265,176,89,14
Izabal,Casado(a),Ignorado,1,0,1,14
Izabal,Unido(a),Todas las edades,34,14,20,14
Izabal,Unido(a),Menos de 15 años,0,0,0,14
Izabal,Unido(a),15 - 24,0,0,0,14
Izabal,Unido(a),25 - 44,0,0,0,14
Izabal,Unido(a),45 - 64,9,1,8,14
Izabal,Unido(a),65 y más,25,13,12,14
Izabal,Unido(a),Ignorado,0,0,0,14
Izabal,Ignorado(a),Todas las edades,0,0,0,14
Izabal,Ignorado(a),Menos de 15 años,0,0,0,14
Izabal,Ignorado(a),15 - 24,0,0,0,14
Izabal,Ignorado(a),25 - 44,0,0,0,14
Izabal,Ignorado(a),45 - 64,0,0,0,14
Izabal,Ignorado(a),65 y más,0,0,0,14
Izabal,Ignorado(a),Ignorado,0,0,0,14
Zacapa,Todos los estados civiles,Todas las edades,1400,814,586,14
Zacapa,Todos los estados civiles,Menos de 15 años,73,43,30,14
Zacapa,Todos los estados civiles,15 - 24,88,67,21,14
Zacapa,Todos los estados civiles,25 - 44,190,146,44,14
Zacapa,Todos los estados civiles,45 - 64,308,174,134,14
Zacapa,Todos los estados civiles,65 y más,738,382,356,14
Zacapa,Todos los estados civiles,Ignorado,3,2,1,14
Zacapa,Soltero(a),Todas las edades,921,500,421,14
Zacapa,Soltero(a),Menos de 15 años,73,43,30,14
Zacapa,Soltero(a),15 - 24,82,63,19,14
Zacapa,Soltero(a),25 - 44,131,104,27,14
Zacapa,Soltero(a),45 - 64,161,88,73,14
Zacapa,Soltero(a),65 y más,472,200,272,14
Zacapa,Soltero(a),Ignorado,2,2,0,14
Zacapa,Casado(a),Todas las edades,472,310,162,14
Zacapa,Casado(a),Menos de 15 años,0,0,0,14
Zacapa,Casado(a),15 - 24,6,4,2,14
Zacapa,Casado(a),25 - 44,59,42,17,14
Zacapa,Casado(a),45 - 64,146,85,61,14
Zacapa,Casado(a),65 y más,260,179,81,14
Zacapa,Casado(a),Ignorado,1,0,1,14
Zacapa,Unido(a),Todas las edades,7,4,3,14
Zacapa,Unido(a),Menos de 15 años,0,0,0,14
Zacapa,Unido(a),15 - 24,0,0,0,14
Zacapa,Unido(a),25 - 44,0,0,0,14
Zacapa,Unido(a),45 - 64,1,1,0,14
Zacapa,Unido(a),65 y más,6,3,3,14
Zacapa,Unido(a),Ignorado,0,0,0,14
Zacapa,Ignorado(a),Todas las edades,0,0,0,14
Zacapa,Ignorado(a),Menos de 15 años,0,0,0,14
Zacapa,Ignorado(a),15 - 24,0,0,0,14
Zacapa,Ignorado(a),25 - 44,0,0,0,14
Zacapa,Ignorado(a),45 - 64,0,0,0,14
Zacapa,Ignorado(a),65 y más,0,0,0,14
Zacapa,Ignorado(a),Ignorado,0,0,0,14
Chiquimula,Todos los estados civiles,Todas las edades,1920,1138,782,14
Chiquimula,Todos los estados civiles,Menos de 15 años,169,89,80,14
Chiquimula,Todos los estados civiles,15 - 24,116,82,34,14
Chiquimula,Todos los estados civiles,25 - 44,281,210,71,14
Chiquimula,Todos los estados civiles,45 - 64,410,233,177,14
Chiquimula,Todos los estados civiles,65 y más,936,519,417,14
Chiquimula,Todos los estados civiles,Ignorado,8,5,3,14
Chiquimula,Soltero(a),Todas las edades,1285,732,553,14
Chiquimula,Soltero(a),Menos de 15 años,169,89,80,14
Chiquimula,Soltero(a),15 - 24,105,74,31,14
Chiquimula,Soltero(a),25 - 44,187,143,44,14
Chiquimula,Soltero(a),45 - 64,233,131,102,14
Chiquimula,Soltero(a),65 y más,587,293,294,14
Chiquimula,Soltero(a),Ignorado,4,2,2,14
Chiquimula,Casado(a),Todas las edades,618,394,224,14
Chiquimula,Casado(a),Menos de 15 años,0,0,0,14
Chiquimula,Casado(a),15 - 24,10,8,2,14
Chiquimula,Casado(a),25 - 44,93,66,27,14
Chiquimula,Casado(a),45 - 64,174,100,74,14
Chiquimula,Casado(a),65 y más,340,219,121,14
Chiquimula,Casado(a),Ignorado,1,1,0,14
Chiquimula,Unido(a),Todas las edades,11,9,2,14
Chiquimula,Unido(a),Menos de 15 años,0,0,0,14
Chiquimula,Unido(a),15 - 24,0,0,0,14
Chiquimula,Unido(a),25 - 44,1,1,0,14
Chiquimula,Unido(a),45 - 64,2,2,0,14
Chiquimula,Unido(a),65 y más,8,6,2,14
Chiquimula,Unido(a),Ignorado,0,0,0,14
Chiquimula,Ignorado(a),Todas las edades,6,3,3,14
Chiquimula,Ignorado(a),Menos de 15 años,0,0,0,14
Chiquimula,Ignorado(a),15 - 24,1,0,1,14
Chiquimula,Ignorado(a),25 - 44,0,0,0,14
Chiquimula,Ignorado(a),45 - 64,1,0,1,14
Chiquimula,Ignorado(a),65 y más,1,1,0,14
Chiquimula,Ignorado(a),Ignorado,3,2,1,14
Jalapa,Todos los estados civiles,Todas las edades,1611,913,698,14
Jalapa,Todos los estados civiles,Menos de 15 años,181,103,78,14
Jalapa,Todos los estados civiles,15 - 24,136,91,45,14
Jalapa,Todos los estados civiles,25 - 44,272,206,66,14
Jalapa,Todos los estados civiles,45 - 64,317,174,143,14
Jalapa,Todos los estados civiles,65 y más,699,335,364,14
Jalapa,Todos los estados civiles,Ignorado,6,4,2,14
Jalapa,Soltero(a),Todas las edades,952,517,435,14
Jalapa,Soltero(a),Menos de 15 años,181,103,78,14
Jalapa,Soltero(a),15 - 24,128,86,42,14
Jalapa,Soltero(a),25 - 44,160,129,31,14
Jalapa,Soltero(a),45 - 64,108,58,50,14
Jalapa,Soltero(a),65 y más,371,138,233,14
Jalapa,Soltero(a),Ignorado,4,3,1,14
Jalapa,Casado(a),Todas las edades,656,394,262,14
Jalapa,Casado(a),Menos de 15 años,0,0,0,14
Jalapa,Casado(a),15 - 24,8,5,3,14
Jalapa,Casado(a),25 - 44,112,77,35,14
Jalapa,Casado(a),45 - 64,209,116,93,14
Jalapa,Casado(a),65 y más,325,195,130,14
Jalapa,Casado(a),Ignorado,2,1,1,14
Jalapa,Unido(a),Todas las edades,3,2,1,14
Jalapa,Unido(a),Menos de 15 años,0,0,0,14
Jalapa,Unido(a),15 - 24,0,0,0,14
Jalapa,Unido(a),25 - 44,0,0,0,14
Jalapa,Unido(a),45 - 64,0,0,0,14
Jalapa,Unido(a),65 y más,3,2,1,14
Jalapa,Unido(a),Ignorado,0,0,0,14
Jalapa,Ignorado(a),Todas las edades,0,0,0,14
Jalapa,Ignorado(a),Menos de 15 años,0,0,0,14
Jalapa,Ignorado(a),15 - 24,0,0,0,14
Jalapa,Ignorado(a),25 - 44,0,0,0,14
Jalapa,Ignorado(a),45 - 64,0,0,0,14
Jalapa,Ignorado(a),65 y más,0,0,0,14
Jalapa,Ignorado(a),Ignorado,0,0,0,14
Jutiapa,Todos los estados civiles,Todas las edades,2588,1522,1066,14
Jutiapa,Todos los estados civiles,Menos de 15 años,107,65,42,14
Jutiapa,Todos los estados civiles,15 - 24,152,105,47,14
Jutiapa,Todos los estados civiles,25 - 44,384,280,104,14
Jutiapa,Todos los estados civiles,45 - 64,585,341,244,14
Jutiapa,Todos los estados civiles,65 y más,1357,729,628,14
Jutiapa,Todos los estados civiles,Ignorado,3,2,1,14
Jutiapa,Soltero(a),Todas las edades,1655,898,757,14
Jutiapa,Soltero(a),Menos de 15 años,107,65,42,14
Jutiapa,Soltero(a),15 - 24,144,102,42,14
Jutiapa,Soltero(a),25 - 44,240,173,67,14
Jutiapa,Soltero(a),45 - 64,303,163,140,14
Jutiapa,Soltero(a),65 y más,859,393,466,14
Jutiapa,Soltero(a),Ignorado,2,2,0,14
Jutiapa,Casado(a),Todas las edades,904,606,298,14
Jutiapa,Casado(a),Menos de 15 años,0,0,0,14
Jutiapa,Casado(a),15 - 24,8,3,5,14
Jutiapa,Casado(a),25 - 44,141,105,36,14
Jutiapa,Casado(a),45 - 64,278,175,103,14
Jutiapa,Casado(a),65 y más,477,323,154,14
Jutiapa,Casado(a),Ignorado,0,0,0,14
Jutiapa,Unido(a),Todas las edades,26,17,9,14
Jutiapa,Unido(a),Menos de 15 años,0,0,0,14
Jutiapa,Unido(a),15 - 24,0,0,0,14
Jutiapa,Unido(a),25 - 44,3,2,1,14
Jutiapa,Unido(a),45 - 64,4,3,1,14
Jutiapa,Unido(a),65 y más,19,12,7,14
Jutiapa,Unido(a),Ignorado,0,0,0,14
Jutiapa,Ignorado(a),Todas las edades,3,1,2,14
Jutiapa,Ignorado(a),Menos de 15 años,0,0,0,14
Jutiapa,Ignorado(a),15 - 24,0,0,0,14
Jutiapa,Ignorado(a),25 - 44,0,0,0,14
Jutiapa,Ignorado(a),45 - 64,0,0,0,14
Jutiapa,Ignorado(a),65 y más,2,1,1,14
Jutiapa,Ignorado(a),Ignorado,1,0,1,14
Extranjero,Todos los estados civiles,Todas las edades,213,141,72,14
Extranjero,Todos los estados civiles,Menos de 15 años,15,6,9,14
Extranjero,Todos los estados civiles,15 - 24,42,36,6,14
Extranjero,Todos los estados civiles,25 - 44,50,35,15,14
Extranjero,Todos los estados civiles,45 - 64,55,36,19,14
Extranjero,Todos los estados civiles,65 y más,41,20,21,14
Extranjero,Todos los estados civiles,Ignorado,10,8,2,14
Extranjero,Soltero(a),Todas las edades,149,93,56,14
Extranjero,Soltero(a),Menos de 15 años,15,6,9,14
Extranjero,Soltero(a),15 - 24,38,33,5,14
Extranjero,Soltero(a),25 - 44,36,25,11,14
Extranjero,Soltero(a),45 - 64,34,18,16,14
Extranjero,Soltero(a),65 y más,25,10,15,14
Extranjero,Soltero(a),Ignorado,1,1,0,14
Extranjero,Casado(a),Todas las edades,31,22,9,14
Extranjero,Casado(a),Menos de 15 años,0,0,0,14
Extranjero,Casado(a),15 - 24,1,1,0,14
Extranjero,Casado(a),25 - 44,9,6,3,14
Extranjero,Casado(a),45 - 64,11,8,3,14
Extranjero,Casado(a),65 y más,10,7,3,14
Extranjero,Casado(a),Ignorado,0,0,0,14
Extranjero,Unido(a),Todas las edades,0,0,0,14
Extranjero,Unido(a),Menos de 15 años,0,0,0,14
Extranjero,Unido(a),15 - 24,0,0,0,14
Extranjero,Unido(a),25 - 44,0,0,0,14
Extranjero,Unido(a),45 - 64,0,0,0,14
Extranjero,Unido(a),65 y más,0,0,0,14
Extranjero,Unido(a),Ignorado,0,0,0,14
Extranjero,Ignorado(a),Todas las edades,33,26,7,14
Extranjero,Ignorado(a),Menos de 15 años,0,0,0,14
Extranjero,Ignorado(a),15 - 24,3,2,1,14
Extranjero,Ignorado(a),25 - 44,5,4,1,14
Extranjero,Ignorado(a),45 - 64,10,10,0,14
Extranjero,Ignorado(a),65 y más,6,3,3,14
Extranjero,Ignorado(a),Ignorado,9,7,2,14
Ignorado,Todos los estados civiles,Todas las edades,6978,4088,2890,14
Ignorado,Todos los estados civiles,Menos de 15 años,5155,2819,2336,14
Ignorado,Todos los estados civiles,15 - 24,697,507,190,14
Ignorado,Todos los estados civiles,25 - 44,262,217,45,14
Ignorado,Todos los estados civiles,45 - 64,213,164,49,14
Ignorado,Todos los estados civiles,65 y más,358,179,179,14
Ignorado,Todos los estados civiles,Ignorado,293,202,91,14
Ignorado,Todos los estados civiles,Todas las edades,6540,3753,2787,14
Ignorado,Soltero(a),Menos de 15 años,5153,2818,2335,14
Ignorado,Soltero(a),15 - 24,674,494,180,14
Ignorado,Soltero(a),25 - 44,163,134,29,14
Ignorado,Soltero(a),45 - 64,113,81,32,14
Ignorado,Soltero(a),65 y más,287,134,153,14
Ignorado,Soltero(a),Ignorado,150,92,58,14
Ignorado,Casado(a),Todas las edades,110,78,32,14
Ignorado,Casado(a),Menos de 15 años,1,0,1,14
Ignorado,Casado(a),15 - 24,2,1,1,14
Ignorado,Casado(a),25 - 44,28,25,3,14
Ignorado,Casado(a),45 - 64,40,30,10,14
Ignorado,Casado(a),65 y más,39,22,17,14
Ignorado,Casado(a),Ignorado,0,0,0,14
Ignorado,Unido(a),Todas las edades,0,0,0,14
Ignorado,Unido(a),Menos de 15 años,0,0,0,14
Ignorado,Unido(a),15 - 24,0,0,0,14
Ignorado,Unido(a),25 - 44,0,0,0,14
Ignorado,Unido(a),45 - 64,0,0,0,14
Ignorado,Unido(a),65 y más,0,0,0,14
Ignorado,Unido(a),Ignorado,0,0,0,14
Ignorado,Ignorado(a),Todas las edades,328,257,71,14
Ignorado,Ignorado(a),Menos de 15 años,1,1,0,14
Ignorado,Ignorado(a),15 - 24,21,12,9,14
Ignorado,Ignorado(a),25 - 44,71,58,13,14
Ignorado,Ignorado(a),45 - 64,60,53,7,14
Ignorado,Ignorado(a),65 y más,32,23,9,14
Ignorado,Ignorado(a),Ignorado,143,110,33,14
Todos los departamentos,Todos los estados civiles,Todas las edades,80876,45513,35363,15
Todos los departamentos,Todos los estados civiles,Menos de 15 años,12352,6883,5469,15
Todos los departamentos,Todos los estados civiles,15 - 24,5278,3828,1450,15
Todos los departamentos,Todos los estados civiles,25 - 44,11420,7984,3436,15
Todos los departamentos,Todos los estados civiles,45 - 64,16239,8918,7321,15
Todos los departamentos,Todos los estados civiles,65 y más,35104,17595,17509,15
Todos los departamentos,Todos los estados civiles,Ignorado,483,305,178,15
Todos los departamentos,Soltero(a),Todas las edades,53221,29154,24067,15
Todos los departamentos,Soltero(a),Menos de 15 años,12349,6881,5468,15
Todos los departamentos,Soltero(a),15 - 24,4874,3575,1299,15
Todos los departamentos,Soltero(a),25 - 44,7127,5145,1982,15
Todos los departamentos,Soltero(a),45 - 64,7657,4117,3540,15
Todos los departamentos,Soltero(a),65 y más,20972,9297,11675,15
Todos los departamentos,Soltero(a),Ignorado,242,139,103,15
Todos los departamentos,Casado(a),Todas las edades,26456,15628,10828,15
Todos los departamentos,Casado(a),Menos de 15 años,0,0,0,15
Todos los departamentos,Casado(a),15 - 24,377,238,139,15
Todos los departamentos,Casado(a),25 - 44,4172,2748,1424,15
Todos los departamentos,Casado(a),45 - 64,8361,4678,3683,15
Todos los departamentos,Casado(a),65 y más,13516,7948,5568,15
Todos los departamentos,Casado(a),Ignorado,30,16,14,15
Todos los departamentos,Unido(a),Todas las edades,766,413,353,15
Todos los departamentos,Unido(a),Menos de 15 años,0,0,0,15
Todos los departamentos,Unido(a),15 - 24,0,0,0,15
Todos los departamentos,Unido(a),25 - 44,47,28,19,15
Todos los departamentos,Unido(a),45 - 64,165,79,86,15
Todos los departamentos,Unido(a),65 y más,553,306,247,15
Todos los departamentos,Unido(a),Ignorado,1,0,1,15
Todos los departamentos,Ignorado(a),Todas las edades,433,318,115,15
Todos los departamentos,Ignorado(a),Menos de 15 años,3,2,1,15
Todos los departamentos,Ignorado(a),15 - 24,27,15,12,15
Todos los departamentos,Ignorado(a),25 - 44,74,63,11,15
Todos los departamentos,Ignorado(a),45 - 64,56,44,12,15
Todos los departamentos,Ignorado(a),65 y más,63,44,19,15
Todos los departamentos,Ignorado(a),Ignorado,210,150,60,15
Guatemala,Todos los estados civiles,Todas las edades,18734,10392,8342,15
Guatemala,Todos los estados civiles,Menos de 15 años,1617,912,705,15
Guatemala,Todos los estados civiles,15 - 24,1210,927,283,15
Guatemala,Todos los estados civiles,25 - 44,2720,1990,730,15
Guatemala,Todos los estados civiles,45 - 64,4162,2344,1818,15
Guatemala,Todos los estados civiles,65 y más,8968,4190,4778,15
Guatemala,Todos los estados civiles,Ignorado,57,29,28,15
Guatemala,Soltero(a),Todas las edades,11810,6278,5532,15
Guatemala,Soltero(a),Menos de 15 años,1615,911,704,15
Guatemala,Soltero(a),15 - 24,1139,880,259,15
Guatemala,Soltero(a),25 - 44,1808,1356,452,15
Guatemala,Soltero(a),45 - 64,2091,1118,973,15
Guatemala,Soltero(a),65 y más,5127,2000,3127,15
Guatemala,Soltero(a),Ignorado,30,13,17,15
Guatemala,Casado(a),Todas las edades,6857,4080,2777,15
Guatemala,Casado(a),Menos de 15 años,0,0,0,15
Guatemala,Casado(a),15 - 24,71,47,24,15
Guatemala,Casado(a),25 - 44,909,632,277,15
Guatemala,Casado(a),45 - 64,2065,1222,843,15
Guatemala,Casado(a),65 y más,3810,2177,1633,15
Guatemala,Casado(a),Ignorado,2,2,0,15
Guatemala,Unido(a),Todas las edades,26,14,12,15
Guatemala,Unido(a),Menos de 15 años,0,0,0,15
Guatemala,Unido(a),15 - 24,0,0,0,15
Guatemala,Unido(a),25 - 44,1,1,0,15
Guatemala,Unido(a),45 - 64,5,3,2,15
Guatemala,Unido(a),65 y más,20,10,10,15
Guatemala,Unido(a),Ignorado,0,0,0,15
Guatemala,Ignorado(a),Todas las edades,41,20,21,15
Guatemala,Ignorado(a),Menos de 15 años,2,1,1,15
Guatemala,Ignorado(a),15 - 24,0,0,0,15
Guatemala,Ignorado(a),25 - 44,2,1,1,15
Guatemala,Ignorado(a),45 - 64,1,1,0,15
Guatemala,Ignorado(a),65 y más,11,3,8,15
Guatemala,Ignorado(a),Ignorado,25,14,11,15
El Progreso,Todos los estados civiles,Todas las edades,1088,624,464,15
El Progreso,Todos los estados civiles,Menos de 15 años,77,45,32,15
El Progreso,Todos los estados civiles,15 - 24,46,35,11,15
El Progreso,Todos los estados civiles,25 - 44,151,113,38,15
El Progreso,Todos los estados civiles,45 - 64,218,123,95,15
El Progreso,Todos los estados civiles,65 y más,596,308,288,15
El Progreso,Todos los estados civiles,Ignorado,0,0,0,15
El Progreso,Soltero(a),Todas las edades,692,390,302,15
El Progreso,Soltero(a),Menos de 15 años,77,45,32,15
El Progreso,Soltero(a),15 - 24,43,33,10,15
El Progreso,Soltero(a),25 - 44,103,78,25,15
El Progreso,Soltero(a),45 - 64,116,64,52,15
El Progreso,Soltero(a),65 y más,353,170,183,15
El Progreso,Soltero(a),Ignorado,0,0,0,15
El Progreso,Casado(a),Todas las edades,389,228,161,15
El Progreso,Casado(a),Menos de 15 años,0,0,0,15
El Progreso,Casado(a),15 - 24,3,2,1,15
El Progreso,Casado(a),25 - 44,48,35,13,15
El Progreso,Casado(a),45 - 64,101,58,43,15
El Progreso,Casado(a),65 y más,237,133,104,15
El Progreso,Casado(a),Ignorado,0,0,0,15
El Progreso,Unido(a),Todas las edades,7,6,1,15
El Progreso,Unido(a),Menos de 15 años,0,0,0,15
El Progreso,Unido(a),15 - 24,0,0,0,15
El Progreso,Unido(a),25 - 44,0,0,0,15
El Progreso,Unido(a),45 - 64,1,1,0,15
El Progreso,Unido(a),65 y más,6,5,1,15
El Progreso,Unido(a),Ignorado,0,0,0,15
El Progreso,Ignorado(a),Todas las edades,0,0,0,15
El Progreso,Ignorado(a),Menos de 15 años,0,0,0,15
El Progreso,Ignorado(a),15 - 24,0,0,0,15
El Progreso,Ignorado(a),25 - 44,0,0,0,15
El Progreso,Ignorado(a),45 - 64,0,0,0,15
El Progreso,Ignorado(a),65 y más,0,0,0,15
El Progreso,Ignorado(a),Ignorado,0,0,0,15
Sacatepéquez,Todos los estados civiles,Todas las edades,1594,899,695,15
Sacatepéquez,Todos los estados civiles,Menos de 15 años,75,42,33,15
Sacatepéquez,Todos los estados civiles,15 - 24,83,51,32,15
Sacatepéquez,Todos los estados civiles,25 - 44,266,185,81,15
Sacatepéquez,Todos los estados civiles,45 - 64,362,200,162,15
Sacatepéquez,Todos los estados civiles,65 y más,796,413,383,15
Sacatepéquez,Todos los estados civiles,Ignorado,12,8,4,15
Sacatepéquez,Soltero(a),Todas las edades,808,443,365,15
Sacatepéquez,Soltero(a),Menos de 15 años,75,42,33,15
Sacatepéquez,Soltero(a),15 - 24,76,46,30,15
Sacatepéquez,Soltero(a),25 - 44,135,98,37,15
Sacatepéquez,Soltero(a),45 - 64,116,61,55,15
Sacatepéquez,Soltero(a),65 y más,403,193,210,15
Sacatepéquez,Soltero(a),Ignorado,3,3,0,15
Sacatepéquez,Casado(a),Todas las edades,773,449,324,15
Sacatepéquez,Casado(a),Menos de 15 años,0,0,0,15
Sacatepéquez,Casado(a),15 - 24,7,5,2,15
Sacatepéquez,Casado(a),25 - 44,131,87,44,15
Sacatepéquez,Casado(a),45 - 64,245,138,107,15
Sacatepéquez,Casado(a),65 y más,390,219,171,15
Sacatepéquez,Casado(a),Ignorado,0,0,0,15
Sacatepéquez,Unido(a),Todas las edades,2,1,1,15
Sacatepéquez,Unido(a),Menos de 15 años,0,0,0,15
Sacatepéquez,Unido(a),15 - 24,0,0,0,15
Sacatepéquez,Unido(a),25 - 44,0,0,0,15
Sacatepéquez,Unido(a),45 - 64,0,0,0,15
Sacatepéquez,Unido(a),65 y más,2,1,1,15
Sacatepéquez,Unido(a),Ignorado,0,0,0,15
Sacatepéquez,Ignorado(a),Todas las edades,11,6,5,15
Sacatepéquez,Ignorado(a),Menos de 15 años,0,0,0,15
Sacatepéquez,Ignorado(a),15 - 24,0,0,0,15
Sacatepéquez,Ignorado(a),25 - 44,0,0,0,15
Sacatepéquez,Ignorado(a),45 - 64,1,1,0,15
Sacatepéquez,Ignorado(a),65 y más,1,0,1,15
Sacatepéquez,Ignorado(a),Ignorado,9,5,4,15
Chimaltenango,Todos los estados civiles,Todas las edades,2703,1460,1243,15
Chimaltenango,Todos los estados civiles,Menos de 15 años,293,156,137,15
Chimaltenango,Todos los estados civiles,15 - 24,175,127,48,15
Chimaltenango,Todos los estados civiles,25 - 44,394,269,125,15
Chimaltenango,Todos los estados civiles,45 - 64,634,328,306,15
Chimaltenango,Todos los estados civiles,65 y más,1200,575,625,15
Chimaltenango,Todos los estados civiles,Ignorado,7,5,2,15
Chimaltenango,Soltero(a),Todas las edades,1440,756,684,15
Chimaltenango,Soltero(a),Menos de 15 años,293,156,137,15
Chimaltenango,Soltero(a),15 - 24,159,116,43,15
Chimaltenango,Soltero(a),25 - 44,172,126,46,15
Chimaltenango,Soltero(a),45 - 64,210,107,103,15
Chimaltenango,Soltero(a),65 y más,602,249,353,15
Chimaltenango,Soltero(a),Ignorado,4,2,2,15
Chimaltenango,Casado(a),Todas las edades,1255,702,553,15
Chimaltenango,Casado(a),Menos de 15 años,0,0,0,15
Chimaltenango,Casado(a),15 - 24,16,11,5,15
Chimaltenango,Casado(a),25 - 44,222,143,79,15
Chimaltenango,Casado(a),45 - 64,423,221,202,15
Chimaltenango,Casado(a),65 y más,593,326,267,15
Chimaltenango,Casado(a),Ignorado,1,1,0,15
Chimaltenango,Unido(a),Todas las edades,6,0,6,15
Chimaltenango,Unido(a),Menos de 15 años,0,0,0,15
Chimaltenango,Unido(a),15 - 24,0,0,0,15
Chimaltenango,Unido(a),25 - 44,0,0,0,15
Chimaltenango,Unido(a),45 - 64,1,0,1,15
Chimaltenango,Unido(a),65 y más,5,0,5,15
Chimaltenango,Unido(a),Ignorado,0,0,0,15
Chimaltenango,Ignorado(a),Todas las edades,2,2,0,15
Chimaltenango,Ignorado(a),Menos de 15 años,0,0,0,15
Chimaltenango,Ignorado(a),15 - 24,0,0,0,15
Chimaltenango,Ignorado(a),25 - 44,0,0,0,15
Chimaltenango,Ignorado(a),45 - 64,0,0,0,15
Chimaltenango,Ignorado(a),65 y más,0,0,0,15
Chimaltenango,Ignorado(a),Ignorado,2,2,0,15
Escuintla,Todos los estados civiles,Todas las edades,4558,2771,1787,15
Escuintla,Todos los estados civiles,Menos de 15 años,286,164,122,15
Escuintla,Todos los estados civiles,15 - 24,361,295,66,15
Escuintla,Todos los estados civiles,25 - 44,859,630,229,15
Escuintla,Todos los estados civiles,45 - 64,1063,583,480,15
Escuintla,Todos los estados civiles,65 y más,1982,1096,886,15
Escuintla,Todos los estados civiles,Ignorado,7,3,4,15
Escuintla,Soltero(a),Todas las edades,3090,1903,1187,15
Escuintla,Soltero(a),Menos de 15 años,286,164,122,15
Escuintla,Soltero(a),15 - 24,334,274,60,15
Escuintla,Soltero(a),25 - 44,591,447,144,15
Escuintla,Soltero(a),45 - 64,585,331,254,15
Escuintla,Soltero(a),65 y más,1288,684,604,15
Escuintla,Soltero(a),Ignorado,6,3,3,15
Escuintla,Casado(a),Todas las edades,1445,859,586,15
Escuintla,Casado(a),Menos de 15 años,0,0,0,15
Escuintla,Casado(a),15 - 24,27,21,6,15
Escuintla,Casado(a),25 - 44,266,181,85,15
Escuintla,Casado(a),45 - 64,475,250,225,15
Escuintla,Casado(a),65 y más,677,407,270,15
Escuintla,Casado(a),Ignorado,0,0,0,15
Escuintla,Unido(a),Todas las edades,18,5,13,15
Escuintla,Unido(a),Menos de 15 años,0,0,0,15
Escuintla,Unido(a),15 - 24,0,0,0,15
Escuintla,Unido(a),25 - 44,0,0,0,15
Escuintla,Unido(a),45 - 64,3,2,1,15
Escuintla,Unido(a),65 y más,15,3,12,15
Escuintla,Unido(a),Ignorado,0,0,0,15
Escuintla,Ignorado(a),Todas las edades,5,4,1,15
Escuintla,Ignorado(a),Menos de 15 años,0,0,0,15
Escuintla,Ignorado(a),15 - 24,0,0,0,15
Escuintla,Ignorado(a),25 - 44,2,2,0,15
Escuintla,Ignorado(a),45 - 64,0,0,0,15
Escuintla,Ignorado(a),65 y más,2,2,0,15
Escuintla,Ignorado(a),Ignorado,1,0,1,15
Santa Rosa,Todos los estados civiles,Todas las edades,2246,1298,948,15
Santa Rosa,Todos los estados civiles,Menos de 15 años,165,80,85,15
Santa Rosa,Todos los estados civiles,15 - 24,131,113,18,15
Santa Rosa,Todos los estados civiles,25 - 44,346,236,110,15
Santa Rosa,Todos los estados civiles,45 - 64,458,253,205,15
Santa Rosa,Todos los estados civiles,65 y más,1144,615,529,15
Santa Rosa,Todos los estados civiles,Ignorado,2,1,1,15
Santa Rosa,Soltero(a),Todas las edades,1443,828,615,15
Santa Rosa,Soltero(a),Menos de 15 años,165,80,85,15
Santa Rosa,Soltero(a),15 - 24,124,109,15,15
Santa Rosa,Soltero(a),25 - 44,217,152,65,15
Santa Rosa,Soltero(a),45 - 64,230,131,99,15
Santa Rosa,Soltero(a),65 y más,705,355,350,15
Santa Rosa,Soltero(a),Ignorado,2,1,1,15
Santa Rosa,Casado(a),Todas las edades,778,451,327,15
Santa Rosa,Casado(a),Menos de 15 años,0,0,0,15
Santa Rosa,Casado(a),15 - 24,7,4,3,15
Santa Rosa,Casado(a),25 - 44,128,83,45,15
Santa Rosa,Casado(a),45 - 64,224,118,106,15
Santa Rosa,Casado(a),65 y más,419,246,173,15
Santa Rosa,Casado(a),Ignorado,0,0,0,15
Santa Rosa,Unido(a),Todas las edades,25,19,6,15
Santa Rosa,Unido(a),Menos de 15 años,0,0,0,15
Santa Rosa,Unido(a),15 - 24,0,0,0,15
Santa Rosa,Unido(a),25 - 44,1,1,0,15
Santa Rosa,Unido(a),45 - 64,4,4,0,15
Santa Rosa,Unido(a),65 y más,20,14,6,15
Santa Rosa,Unido(a),Ignorado,0,0,0,15
Santa Rosa,Ignorado(a),Todas las edades,0,0,0,15
Santa Rosa,Ignorado(a),Menos de 15 años,0,0,0,15
Santa Rosa,Ignorado(a),15 - 24,0,0,0,15
Santa Rosa,Ignorado(a),25 - 44,0,0,0,15
Santa Rosa,Ignorado(a),45 - 64,0,0,0,15
Santa Rosa,Ignorado(a),65 y más,0,0,0,15
Santa Rosa,Ignorado(a),Ignorado,0,0,0,15
Sololá,Todos los estados civiles,Todas las edades,1760,980,780,15
Sololá,Todos los estados civiles,Menos de 15 años,209,122,87,15
Sololá,Todos los estados civiles,15 - 24,84,52,32,15
Sololá,Todos los estados civiles,25 - 44,251,170,81,15
Sololá,Todos los estados civiles,45 - 64,390,223,167,15
Sololá,Todos los estados civiles,65 y más,813,407,406,15
Sololá,Todos los estados civiles,Ignorado,13,6,7,15
Sololá,Soltero(a),Todas las edades,1137,629,508,15
Sololá,Soltero(a),Menos de 15 años,209,122,87,15
Sololá,Soltero(a),15 - 24,79,50,29,15
Sololá,Soltero(a),25 - 44,161,119,42,15
Sololá,Soltero(a),45 - 64,181,102,79,15
Sololá,Soltero(a),65 y más,495,230,265,15
Sololá,Soltero(a),Ignorado,12,6,6,15
Sololá,Casado(a),Todas las edades,531,302,229,15
Sololá,Casado(a),Menos de 15 años,0,0,0,15
Sololá,Casado(a),15 - 24,5,2,3,15
Sololá,Casado(a),25 - 44,88,50,38,15
Sololá,Casado(a),45 - 64,184,107,77,15
Sololá,Casado(a),65 y más,253,143,110,15
Sololá,Casado(a),Ignorado,1,0,1,15
Sololá,Unido(a),Todas las edades,92,49,43,15
Sololá,Unido(a),Menos de 15 años,0,0,0,15
Sololá,Unido(a),15 - 24,0,0,0,15
Sololá,Unido(a),25 - 44,2,1,1,15
Sololá,Unido(a),45 - 64,25,14,11,15
Sololá,Unido(a),65 y más,65,34,31,15
Sololá,Unido(a),Ignorado,0,0,0,15
Sololá,Ignorado(a),Todas las edades,0,0,0,15
Sololá,Ignorado(a),Menos de 15 años,0,0,0,15
Sololá,Ignorado(a),15 - 24,0,0,0,15
Sololá,Ignorado(a),25 - 44,0,0,0,15
Sololá,Ignorado(a),45 - 64,0,0,0,15
Sololá,Ignorado(a),65 y más,0,0,0,15
Sololá,Ignorado(a),Ignorado,0,0,0,15
Totonicapán,Todos los estados civiles,Todas las edades,2305,1257,1048,15
Totonicapán,Todos los estados civiles,Menos de 15 años,304,177,127,15
Totonicapán,Todos los estados civiles,15 - 24,97,63,34,15
Totonicapán,Todos los estados civiles,25 - 44,349,212,137,15
Totonicapán,Todos los estados civiles,45 - 64,486,281,205,15
Totonicapán,Todos los estados civiles,65 y más,1059,520,539,15
Totonicapán,Todos los estados civiles,Ignorado,10,4,6,15
Totonicapán,Soltero(a),Todas las edades,1322,647,675,15
Totonicapán,Soltero(a),Menos de 15 años,304,177,127,15
Totonicapán,Soltero(a),15 - 24,80,53,27,15
Totonicapán,Soltero(a),25 - 44,178,108,70,15
Totonicapán,Soltero(a),45 - 64,167,88,79,15
Totonicapán,Soltero(a),65 y más,589,221,368,15
Totonicapán,Soltero(a),Ignorado,4,0,4,15
Totonicapán,Casado(a),Todas las edades,894,553,341,15
Totonicapán,Casado(a),Menos de 15 años,0,0,0,15
Totonicapán,Casado(a),15 - 24,17,10,7,15
Totonicapán,Casado(a),25 - 44,168,101,67,15
Totonicapán,Casado(a),45 - 64,305,184,121,15
Totonicapán,Casado(a),65 y más,401,257,144,15
Totonicapán,Casado(a),Ignorado,3,1,2,15
Totonicapán,Unido(a),Todas las edades,85,53,32,15
Totonicapán,Unido(a),Menos de 15 años,0,0,0,15
Totonicapán,Unido(a),15 - 24,0,0,0,15
Totonicapán,Unido(a),25 - 44,2,2,0,15
Totonicapán,Unido(a),45 - 64,14,9,5,15
Totonicapán,Unido(a),65 y más,69,42,27,15
Totonicapán,Unido(a),Ignorado,0,0,0,15
Totonicapán,Ignorado(a),Todas las edades,4,4,0,15
Totonicapán,Ignorado(a),Menos de 15 años,0,0,0,15
Totonicapán,Ignorado(a),15 - 24,0,0,0,15
Totonicapán,Ignorado(a),25 - 44,1,1,0,15
Totonicapán,Ignorado(a),45 - 64,0,0,0,15
Totonicapán,Ignorado(a),65 y más,0,0,0,15
Totonicapán,Ignorado(a),Ignorado,3,3,0,15
Quetzaltenango,Todos los estados civiles,Todas las edades,4210,2326,1884,15
Quetzaltenango,Todos los estados civiles,Menos de 15 años,445,230,215,15
Quetzaltenango,Todos los estados civiles,15 - 24,226,166,60,15
Quetzaltenango,Todos los estados civiles,25 - 44,595,419,176,15
Quetzaltenango,Todos los estados civiles,45 - 64,868,486,382,15
Quetzaltenango,Todos los estados civiles,65 y más,2042,1006,1036,15
Quetzaltenango,Todos los estados civiles,Ignorado,34,19,15,15
Quetzaltenango,Soltero(a),Todas las edades,2590,1349,1241,15
Quetzaltenango,Soltero(a),Menos de 15 años,445,230,215,15
Quetzaltenango,Soltero(a),15 - 24,197,143,54,15
Quetzaltenango,Soltero(a),25 - 44,352,253,99,15
Quetzaltenango,Soltero(a),45 - 64,369,189,180,15
Quetzaltenango,Soltero(a),65 y más,1204,521,683,15
Quetzaltenango,Soltero(a),Ignorado,23,13,10,15
Quetzaltenango,Casado(a),Todas las edades,1532,928,604,15
Quetzaltenango,Casado(a),Menos de 15 años,0,0,0,15
Quetzaltenango,Casado(a),15 - 24,29,23,6,15
Quetzaltenango,Casado(a),25 - 44,236,162,74,15
Quetzaltenango,Casado(a),45 - 64,489,295,194,15
Quetzaltenango,Casado(a),65 y más,772,444,328,15
Quetzaltenango,Casado(a),Ignorado,6,4,2,15
Quetzaltenango,Unido(a),Todas las edades,80,45,35,15
Quetzaltenango,Unido(a),Menos de 15 años,0,0,0,15
Quetzaltenango,Unido(a),15 - 24,0,0,0,15
Quetzaltenango,Unido(a),25 - 44,6,3,3,15
Quetzaltenango,Unido(a),45 - 64,10,2,8,15
Quetzaltenango,Unido(a),65 y más,64,40,24,15
Quetzaltenango,Unido(a),Ignorado,0,0,0,15
Quetzaltenango,Ignorado(a),Todas las edades,8,4,4,15
Quetzaltenango,Ignorado(a),Menos de 15 años,0,0,0,15
Quetzaltenango,Ignorado(a),15 - 24,0,0,0,15
Quetzaltenango,Ignorado(a),25 - 44,1,1,0,15
Quetzaltenango,Ignorado(a),45 - 64,0,0,0,15
Quetzaltenango,Ignorado(a),65 y más,2,1,1,15
Quetzaltenango,Ignorado(a),Ignorado,5,2,3,15
Suchitepéquez,Todos los estados civiles,Todas las edades,3046,1717,1329,15
Suchitepéquez,Todos los estados civiles,Menos de 15 años,267,144,123,15
Suchitepéquez,Todos los estados civiles,15 - 24,176,130,46,15
Suchitepéquez,Todos los estados civiles,25 - 44,443,333,110,15
Suchitepéquez,Todos los estados civiles,45 - 64,689,382,307,15
Suchitepéquez,Todos los estados civiles,65 y más,1455,724,731,15
Suchitepéquez,Todos los estados civiles,Ignorado,16,4,12,15
Suchitepéquez,Soltero(a),Todas las edades,1908,1038,870,15
Suchitepéquez,Soltero(a),Menos de 15 años,267,144,123,15
Suchitepéquez,Soltero(a),15 - 24,160,117,43,15
Suchitepéquez,Soltero(a),25 - 44,264,207,57,15
Suchitepéquez,Soltero(a),45 - 64,302,174,128,15
Suchitepéquez,Soltero(a),65 y más,906,395,511,15
Suchitepéquez,Soltero(a),Ignorado,9,1,8,15
Suchitepéquez,Casado(a),Todas las edades,1115,668,447,15
Suchitepéquez,Casado(a),Menos de 15 años,0,0,0,15
Suchitepéquez,Casado(a),15 - 24,16,13,3,15
Suchitepéquez,Casado(a),25 - 44,178,125,53,15
Suchitepéquez,Casado(a),45 - 64,386,208,178,15
Suchitepéquez,Casado(a),65 y más,532,320,212,15
Suchitepéquez,Casado(a),Ignorado,3,2,1,15
Suchitepéquez,Unido(a),Todas las edades,17,9,8,15
Suchitepéquez,Unido(a),Menos de 15 años,0,0,0,15
Suchitepéquez,Unido(a),15 - 24,0,0,0,15
Suchitepéquez,Unido(a),25 - 44,1,1,0,15
Suchitepéquez,Unido(a),45 - 64,1,0,1,15
Suchitepéquez,Unido(a),65 y más,15,8,7,15
Suchitepéquez,Unido(a),Ignorado,0,0,0,15
Suchitepéquez,Ignorado(a),Todas las edades,6,2,4,15
Suchitepéquez,Ignorado(a),Menos de 15 años,0,0,0,15
Suchitepéquez,Ignorado(a),15 - 24,0,0,0,15
Suchitepéquez,Ignorado(a),25 - 44,0,0,0,15
Suchitepéquez,Ignorado(a),45 - 64,0,0,0,15
Suchitepéquez,Ignorado(a),65 y más,2,1,1,15
Suchitepéquez,Ignorado(a),Ignorado,4,1,3,15
Retalhuleu,Todos los estados civiles,Todas las edades,1910,1134,776,15
Retalhuleu,Todos los estados civiles,Menos de 15 años,143,83,60,15
Retalhuleu,Todos los estados civiles,15 - 24,121,93,28,15
Retalhuleu,Todos los estados civiles,25 - 44,277,200,77,15
Retalhuleu,Todos los estados civiles,45 - 64,453,247,206,15
Retalhuleu,Todos los estados civiles,65 y más,911,508,403,15
Retalhuleu,Todos los estados civiles,Ignorado,5,3,2,15
Retalhuleu,Soltero(a),Todas las edades,1151,662,489,15
Retalhuleu,Soltero(a),Menos de 15 años,143,83,60,15
Retalhuleu,Soltero(a),15 - 24,109,83,26,15
Retalhuleu,Soltero(a),25 - 44,171,126,45,15
Retalhuleu,Soltero(a),45 - 64,217,114,103,15
Retalhuleu,Soltero(a),65 y más,507,253,254,15
Retalhuleu,Soltero(a),Ignorado,4,3,1,15
Retalhuleu,Casado(a),Todas las edades,707,445,262,15
Retalhuleu,Casado(a),Menos de 15 años,0,0,0,15
Retalhuleu,Casado(a),15 - 24,12,10,2,15
Retalhuleu,Casado(a),25 - 44,104,73,31,15
Retalhuleu,Casado(a),45 - 64,225,129,96,15
Retalhuleu,Casado(a),65 y más,365,233,132,15
Retalhuleu,Casado(a),Ignorado,1,0,1,15
Retalhuleu,Unido(a),Todas las edades,52,27,25,15
Retalhuleu,Unido(a),Menos de 15 años,0,0,0,15
Retalhuleu,Unido(a),15 - 24,0,0,0,15
Retalhuleu,Unido(a),25 - 44,2,1,1,15
Retalhuleu,Unido(a),45 - 64,11,4,7,15
Retalhuleu,Unido(a),65 y más,39,22,17,15
Retalhuleu,Unido(a),Ignorado,0,0,0,15
Retalhuleu,Ignorado(a),Todas las edades,0,0,0,15
Retalhuleu,Ignorado(a),Menos de 15 años,0,0,0,15
Retalhuleu,Ignorado(a),15 - 24,0,0,0,15
Retalhuleu,Ignorado(a),25 - 44,0,0,0,15
Retalhuleu,Ignorado(a),45 - 64,0,0,0,15
Retalhuleu,Ignorado(a),65 y más,0,0,0,15
Retalhuleu,Ignorado(a),Ignorado,0,0,0,15
San Marcos,Todos los estados civiles,Todas las edades,4872,2796,2076,15
San Marcos,Todos los estados civiles,Menos de 15 años,574,327,247,15
San Marcos,Todos los estados civiles,15 - 24,259,173,86,15
San Marcos,Todos los estados civiles,25 - 44,699,501,198,15
San Marcos,Todos los estados civiles,45 - 64,1045,600,445,15
San Marcos,Todos los estados civiles,65 y más,2283,1188,1095,15
San Marcos,Todos los estados civiles,Ignorado,12,7,5,15
San Marcos,Soltero(a),Todas las edades,3179,1785,1394,15
San Marcos,Soltero(a),Menos de 15 años,574,327,247,15
San Marcos,Soltero(a),15 - 24,235,154,81,15
San Marcos,Soltero(a),25 - 44,480,344,136,15
San Marcos,Soltero(a),45 - 64,515,300,215,15
San Marcos,Soltero(a),65 y más,1366,654,712,15
San Marcos,Soltero(a),Ignorado,9,6,3,15
San Marcos,Casado(a),Todas las edades,1626,981,645,15
San Marcos,Casado(a),Menos de 15 años,0,0,0,15
San Marcos,Casado(a),15 - 24,24,19,5,15
San Marcos,Casado(a),25 - 44,213,154,59,15
San Marcos,Casado(a),45 - 64,508,291,217,15
San Marcos,Casado(a),65 y más,879,516,363,15
San Marcos,Casado(a),Ignorado,2,1,1,15
San Marcos,Unido(a),Todas las edades,66,30,36,15
San Marcos,Unido(a),Menos de 15 años,0,0,0,15
San Marcos,Unido(a),15 - 24,0,0,0,15
San Marcos,Unido(a),25 - 44,6,3,3,15
San Marcos,Unido(a),45 - 64,22,9,13,15
San Marcos,Unido(a),65 y más,38,18,20,15
San Marcos,Unido(a),Ignorado,0,0,0,15
San Marcos,Ignorado(a),Todas las edades,1,0,1,15
San Marcos,Ignorado(a),Menos de 15 años,0,0,0,15
San Marcos,Ignorado(a),15 - 24,0,0,0,15
San Marcos,Ignorado(a),25 - 44,0,0,0,15
San Marcos,Ignorado(a),45 - 64,0,0,0,15
San Marcos,Ignorado(a),65 y más,0,0,0,15
San Marcos,Ignorado(a),Ignorado,1,0,1,15
Huehuetenango,Todos los estados civiles,Todas las edades,4231,2280,1951,15
Huehuetenango,Todos los estados civiles,Menos de 15 años,641,347,294,15
Huehuetenango,Todos los estados civiles,15 - 24,276,146,130,15
Huehuetenango,Todos los estados civiles,25 - 44,566,316,250,15
Huehuetenango,Todos los estados civiles,45 - 64,807,427,380,15
Huehuetenango,Todos los estados civiles,65 y más,1932,1041,891,15
Huehuetenango,Todos los estados civiles,Ignorado,9,3,6,15
Huehuetenango,Soltero(a),Todas las edades,2975,1582,1393,15
Huehuetenango,Soltero(a),Menos de 15 años,641,347,294,15
Huehuetenango,Soltero(a),15 - 24,250,136,114,15
Huehuetenango,Soltero(a),25 - 44,336,185,151,15
Huehuetenango,Soltero(a),45 - 64,412,217,195,15
Huehuetenango,Soltero(a),65 y más,1327,694,633,15
Huehuetenango,Soltero(a),Ignorado,9,3,6,15
Huehuetenango,Casado(a),Todas las edades,1247,694,553,15
Huehuetenango,Casado(a),Menos de 15 años,0,0,0,15
Huehuetenango,Casado(a),15 - 24,26,10,16,15
Huehuetenango,Casado(a),25 - 44,230,131,99,15
Huehuetenango,Casado(a),45 - 64,395,210,185,15
Huehuetenango,Casado(a),65 y más,596,343,253,15
Huehuetenango,Casado(a),Ignorado,0,0,0,15
Huehuetenango,Unido(a),Todas las edades,8,3,5,15
Huehuetenango,Unido(a),Menos de 15 años,0,0,0,15
Huehuetenango,Unido(a),15 - 24,0,0,0,15
Huehuetenango,Unido(a),25 - 44,0,0,0,15
Huehuetenango,Unido(a),45 - 64,0,0,0,15
Huehuetenango,Unido(a),65 y más,8,3,5,15
Huehuetenango,Unido(a),Ignorado,0,0,0,15
Huehuetenango,Ignorado(a),Todas las edades,1,1,0,15
Huehuetenango,Ignorado(a),Menos de 15 años,0,0,0,15
Huehuetenango,Ignorado(a),15 - 24,0,0,0,15
Huehuetenango,Ignorado(a),25 - 44,0,0,0,15
Huehuetenango,Ignorado(a),45 - 64,0,0,0,15
Huehuetenango,Ignorado(a),65 y más,1,1,0,15
Huehuetenango,Ignorado(a),Ignorado,0,0,0,15
Quiché,Todos los estados civiles,Todas las edades,3836,1998,1838,15
Quiché,Todos los estados civiles,Menos de 15 años,705,374,331,15
Quiché,Todos los estados civiles,15 - 24,211,128,83,15
Quiché,Todos los estados civiles,25 - 44,607,378,229,15
Quiché,Todos los estados civiles,45 - 64,724,400,324,15
Quiché,Todos los estados civiles,65 y más,1561,708,853,15
Quiché,Todos los estados civiles,Ignorado,28,10,18,15
Quiché,Soltero(a),Todas las edades,2654,1320,1334,15
Quiché,Soltero(a),Menos de 15 años,705,374,331,15
Quiché,Soltero(a),15 - 24,195,120,75,15
Quiché,Soltero(a),25 - 44,329,221,108,15
Quiché,Soltero(a),45 - 64,343,179,164,15
Quiché,Soltero(a),65 y más,1061,418,643,15
Quiché,Soltero(a),Ignorado,21,8,13,15
Quiché,Casado(a),Todas las edades,1153,663,490,15
Quiché,Casado(a),Menos de 15 años,0,0,0,15
Quiché,Casado(a),15 - 24,16,8,8,15
Quiché,Casado(a),25 - 44,278,157,121,15
Quiché,Casado(a),45 - 64,380,221,159,15
Quiché,Casado(a),65 y más,477,275,202,15
Quiché,Casado(a),Ignorado,2,2,0,15
Quiché,Unido(a),Todas las edades,24,14,10,15
Quiché,Unido(a),Menos de 15 años,0,0,0,15
Quiché,Unido(a),15 - 24,0,0,0,15
Quiché,Unido(a),25 - 44,0,0,0,15
Quiché,Unido(a),45 - 64,1,0,1,15
Quiché,Unido(a),65 y más,22,14,8,15
Quiché,Unido(a),Ignorado,1,0,1,15
Quiché,Ignorado(a),Todas las edades,5,1,4,15
Quiché,Ignorado(a),Menos de 15 años,0,0,0,15
Quiché,Ignorado(a),15 - 24,0,0,0,15
Quiché,Ignorado(a),25 - 44,0,0,0,15
Quiché,Ignorado(a),45 - 64,0,0,0,15
Quiché,Ignorado(a),65 y más,1,1,0,15
Quiché,Ignorado(a),Ignorado,4,0,4,15
Baja Verapaz,Todos los estados civiles,Todas las edades,1322,699,623,15
Baja Verapaz,Todos los estados civiles,Menos de 15 años,180,101,79,15
Baja Verapaz,Todos los estados civiles,15 - 24,73,41,32,15
Baja Verapaz,Todos los estados civiles,25 - 44,147,89,58,15
Baja Verapaz,Todos los estados civiles,45 - 64,239,127,112,15
Baja Verapaz,Todos los estados civiles,65 y más,674,336,338,15
Baja Verapaz,Todos los estados civiles,Ignorado,9,5,4,15
Baja Verapaz,Soltero(a),Todas las edades,836,419,417,15
Baja Verapaz,Soltero(a),Menos de 15 años,180,101,79,15
Baja Verapaz,Soltero(a),15 - 24,58,32,26,15
Baja Verapaz,Soltero(a),25 - 44,79,53,26,15
Baja Verapaz,Soltero(a),45 - 64,109,54,55,15
Baja Verapaz,Soltero(a),65 y más,404,175,229,15
Baja Verapaz,Soltero(a),Ignorado,6,4,2,15
Baja Verapaz,Casado(a),Todas las edades,464,266,198,15
Baja Verapaz,Casado(a),Menos de 15 años,0,0,0,15
Baja Verapaz,Casado(a),15 - 24,15,9,6,15
Baja Verapaz,Casado(a),25 - 44,67,35,32,15
Baja Verapaz,Casado(a),45 - 64,129,72,57,15
Baja Verapaz,Casado(a),65 y más,250,149,101,15
Baja Verapaz,Casado(a),Ignorado,3,1,2,15
Baja Verapaz,Unido(a),Todas las edades,21,13,8,15
Baja Verapaz,Unido(a),Menos de 15 años,0,0,0,15
Baja Verapaz,Unido(a),15 - 24,0,0,0,15
Baja Verapaz,Unido(a),25 - 44,1,1,0,15
Baja Verapaz,Unido(a),45 - 64,1,1,0,15
Baja Verapaz,Unido(a),65 y más,19,11,8,15
Baja Verapaz,Unido(a),Ignorado,0,0,0,15
Baja Verapaz,Ignorado(a),Todas las edades,1,1,0,15
Baja Verapaz,Ignorado(a),Menos de 15 años,0,0,0,15
Baja Verapaz,Ignorado(a),15 - 24,0,0,0,15
Baja Verapaz,Ignorado(a),25 - 44,0,0,0,15
Baja Verapaz,Ignorado(a),45 - 64,0,0,0,15
Baja Verapaz,Ignorado(a),65 y más,1,1,0,15
Baja Verapaz,Ignorado(a),Ignorado,0,0,0,15
Alta Verapaz,Todos los estados civiles,Todas las edades,4668,2444,2224,15
Alta Verapaz,Todos los estados civiles,Menos de 15 años,1171,636,535,15
Alta Verapaz,Todos los estados civiles,15 - 24,276,175,101,15
Alta Verapaz,Todos los estados civiles,25 - 44,605,363,242,15
Alta Verapaz,Todos los estados civiles,45 - 64,856,428,428,15
Alta Verapaz,Todos los estados civiles,65 y más,1745,834,911,15
Alta Verapaz,Todos los estados civiles,Ignorado,15,8,7,15
Alta Verapaz,Soltero(a),Todas las edades,2963,1525,1438,15
Alta Verapaz,Soltero(a),Menos de 15 años,1171,636,535,15
Alta Verapaz,Soltero(a),15 - 24,248,165,83,15
Alta Verapaz,Soltero(a),25 - 44,328,203,125,15
Alta Verapaz,Soltero(a),45 - 64,300,152,148,15
Alta Verapaz,Soltero(a),65 y más,906,363,543,15
Alta Verapaz,Soltero(a),Ignorado,10,6,4,15
Alta Verapaz,Casado(a),Todas las edades,1645,885,760,15
Alta Verapaz,Casado(a),Menos de 15 años,0,0,0,15
Alta Verapaz,Casado(a),15 - 24,28,10,18,15
Alta Verapaz,Casado(a),25 - 44,275,160,115,15
Alta Verapaz,Casado(a),45 - 64,542,267,275,15
Alta Verapaz,Casado(a),65 y más,796,446,350,15
Alta Verapaz,Casado(a),Ignorado,4,2,2,15
Alta Verapaz,Unido(a),Todas las edades,57,32,25,15
Alta Verapaz,Unido(a),Menos de 15 años,0,0,0,15
Alta Verapaz,Unido(a),15 - 24,0,0,0,15
Alta Verapaz,Unido(a),25 - 44,2,0,2,15
Alta Verapaz,Unido(a),45 - 64,14,9,5,15
Alta Verapaz,Unido(a),65 y más,41,23,18,15
Alta Verapaz,Unido(a),Ignorado,0,0,0,15
Alta Verapaz,Ignorado(a),Todas las edades,3,2,1,15
Alta Verapaz,Ignorado(a),Menos de 15 años,0,0,0,15
Alta Verapaz,Ignorado(a),15 - 24,0,0,0,15
Alta Verapaz,Ignorado(a),25 - 44,0,0,0,15
Alta Verapaz,Ignorado(a),45 - 64,0,0,0,15
Alta Verapaz,Ignorado(a),65 y más,2,2,0,15
Alta Verapaz,Ignorado(a),Ignorado,1,0,1,15
Petén,Todos los estados civiles,Todas las edades,2005,1209,796,15
Petén,Todos los estados civiles,Menos de 15 años,218,121,97,15
Petén,Todos los estados civiles,15 - 24,211,170,41,15
Petén,Todos los estados civiles,25 - 44,381,272,109,15
Petén,Todos los estados civiles,45 - 64,451,227,224,15
Petén,Todos los estados civiles,65 y más,732,409,323,15
Petén,Todos los estados civiles,Ignorado,12,10,2,15
Petén,Soltero(a),Todas las edades,1343,834,509,15
Petén,Soltero(a),Menos de 15 años,218,121,97,15
Petén,Soltero(a),15 - 24,197,160,37,15
Petén,Soltero(a),25 - 44,255,195,60,15
Petén,Soltero(a),45 - 64,208,103,105,15
Petén,Soltero(a),65 y más,459,250,209,15
Petén,Soltero(a),Ignorado,6,5,1,15
Petén,Casado(a),Todas las edades,543,308,235,15
Petén,Casado(a),Menos de 15 años,0,0,0,15
Petén,Casado(a),15 - 24,14,10,4,15
Petén,Casado(a),25 - 44,105,65,40,15
Petén,Casado(a),45 - 64,200,106,94,15
Petén,Casado(a),65 y más,224,127,97,15
Petén,Casado(a),Ignorado,0,0,0,15
Petén,Unido(a),Todas las edades,111,60,51,15
Petén,Unido(a),Menos de 15 años,0,0,0,15
Petén,Unido(a),15 - 24,0,0,0,15
Petén,Unido(a),25 - 44,21,12,9,15
Petén,Unido(a),45 - 64,42,17,25,15
Petén,Unido(a),65 y más,48,31,17,15
Petén,Unido(a),Ignorado,0,0,0,15
Petén,Ignorado(a),Todas las edades,8,7,1,15
Petén,Ignorado(a),Menos de 15 años,0,0,0,15
Petén,Ignorado(a),15 - 24,0,0,0,15
Petén,Ignorado(a),25 - 44,0,0,0,15
Petén,Ignorado(a),45 - 64,1,1,0,15
Petén,Ignorado(a),65 y más,1,1,0,15
Petén,Ignorado(a),Ignorado,6,5,1,15
Izabal,Todos los estados civiles,Todas las edades,2121,1234,887,15
Izabal,Todos los estados civiles,Menos de 15 años,241,134,107,15
Izabal,Todos los estados civiles,15 - 24,163,122,41,15
Izabal,Todos los estados civiles,25 - 44,362,249,113,15
Izabal,Todos los estados civiles,45 - 64,451,229,222,15
Izabal,Todos los estados civiles,65 y más,900,497,403,15
Izabal,Todos los estados civiles,Ignorado,4,3,1,15
Izabal,Soltero(a),Todas las edades,1455,834,621,15
Izabal,Soltero(a),Menos de 15 años,241,134,107,15
Izabal,Soltero(a),15 - 24,154,119,35,15
Izabal,Soltero(a),25 - 44,260,181,79,15
Izabal,Soltero(a),45 - 64,235,120,115,15
Izabal,Soltero(a),65 y más,561,277,284,15
Izabal,Soltero(a),Ignorado,4,3,1,15
Izabal,Casado(a),Todas las edades,626,383,243,15
Izabal,Casado(a),Menos de 15 años,0,0,0,15
Izabal,Casado(a),15 - 24,9,3,6,15
Izabal,Casado(a),25 - 44,102,68,34,15
Izabal,Casado(a),45 - 64,209,106,103,15
Izabal,Casado(a),65 y más,306,206,100,15
Izabal,Casado(a),Ignorado,0,0,0,15
Izabal,Unido(a),Todas las edades,40,17,23,15
Izabal,Unido(a),Menos de 15 años,0,0,0,15
Izabal,Unido(a),15 - 24,0,0,0,15
Izabal,Unido(a),25 - 44,0,0,0,15
Izabal,Unido(a),45 - 64,7,3,4,15
Izabal,Unido(a),65 y más,33,14,19,15
Izabal,Unido(a),Ignorado,0,0,0,15
Izabal,Ignorado(a),Todas las edades,0,0,0,15
Izabal,Ignorado(a),Menos de 15 años,0,0,0,15
Izabal,Ignorado(a),15 - 24,0,0,0,15
Izabal,Ignorado(a),25 - 44,0,0,0,15
Izabal,Ignorado(a),45 - 64,0,0,0,15
Izabal,Ignorado(a),65 y más,0,0,0,15
Izabal,Ignorado(a),Ignorado,0,0,0,15
Zacapa,Todos los estados civiles,Todas las edades,1446,829,617,15
Zacapa,Todos los estados civiles,Menos de 15 años,106,63,43,15
Zacapa,Todos los estados civiles,15 - 24,84,66,18,15
Zacapa,Todos los estados civiles,25 - 44,198,151,47,15
Zacapa,Todos los estados civiles,45 - 64,298,160,138,15
Zacapa,Todos los estados civiles,65 y más,755,387,368,15
Zacapa,Todos los estados civiles,Ignorado,5,2,3,15
Zacapa,Soltero(a),Todas las edades,930,513,417,15
Zacapa,Soltero(a),Menos de 15 años,106,63,43,15
Zacapa,Soltero(a),15 - 24,79,63,16,15
Zacapa,Soltero(a),25 - 44,129,100,29,15
Zacapa,Soltero(a),45 - 64,157,92,65,15
Zacapa,Soltero(a),65 y más,455,193,262,15
Zacapa,Soltero(a),Ignorado,4,2,2,15
Zacapa,Casado(a),Todas las edades,510,313,197,15
Zacapa,Casado(a),Menos de 15 años,0,0,0,15
Zacapa,Casado(a),15 - 24,5,3,2,15
Zacapa,Casado(a),25 - 44,68,50,18,15
Zacapa,Casado(a),45 - 64,141,68,73,15
Zacapa,Casado(a),65 y más,295,192,103,15
Zacapa,Casado(a),Ignorado,1,0,1,15
Zacapa,Unido(a),Todas las edades,6,3,3,15
Zacapa,Unido(a),Menos de 15 años,0,0,0,15
Zacapa,Unido(a),15 - 24,0,0,0,15
Zacapa,Unido(a),25 - 44,1,1,0,15
Zacapa,Unido(a),45 - 64,0,0,0,15
Zacapa,Unido(a),65 y más,5,2,3,15
Zacapa,Unido(a),Ignorado,0,0,0,15
Zacapa,Ignorado(a),Todas las edades,0,0,0,15
Zacapa,Ignorado(a),Menos de 15 años,0,0,0,15
Zacapa,Ignorado(a),15 - 24,0,0,0,15
Zacapa,Ignorado(a),25 - 44,0,0,0,15
Zacapa,Ignorado(a),45 - 64,0,0,0,15
Zacapa,Ignorado(a),65 y más,0,0,0,15
Zacapa,Ignorado(a),Ignorado,0,0,0,15
Chiquimula,Todos los estados civiles,Todas las edades,2134,1231,903,15
Chiquimula,Todos los estados civiles,Menos de 15 años,211,114,97,15
Chiquimula,Todos los estados civiles,15 - 24,145,112,33,15
Chiquimula,Todos los estados civiles,25 - 44,332,253,79,15
Chiquimula,Todos los estados civiles,45 - 64,438,222,216,15
Chiquimula,Todos los estados civiles,65 y más,997,521,476,15
Chiquimula,Todos los estados civiles,Ignorado,11,9,2,15
Chiquimula,Soltero(a),Todas las edades,1475,817,658,15
Chiquimula,Soltero(a),Menos de 15 años,211,114,97,15
Chiquimula,Soltero(a),15 - 24,136,107,29,15
Chiquimula,Soltero(a),25 - 44,230,180,50,15
Chiquimula,Soltero(a),45 - 64,236,114,122,15
Chiquimula,Soltero(a),65 y más,655,297,358,15
Chiquimula,Soltero(a),Ignorado,7,5,2,15
Chiquimula,Casado(a),Todas las edades,653,409,244,15
Chiquimula,Casado(a),Menos de 15 años,0,0,0,15
Chiquimula,Casado(a),15 - 24,9,5,4,15
Chiquimula,Casado(a),25 - 44,102,73,29,15
Chiquimula,Casado(a),45 - 64,202,108,94,15
Chiquimula,Casado(a),65 y más,340,223,117,15
Chiquimula,Casado(a),Ignorado,0,0,0,15
Chiquimula,Unido(a),Todas las edades,2,1,1,15
Chiquimula,Unido(a),Menos de 15 años,0,0,0,15
Chiquimula,Unido(a),15 - 24,0,0,0,15
Chiquimula,Unido(a),25 - 44,0,0,0,15
Chiquimula,Unido(a),45 - 64,0,0,0,15
Chiquimula,Unido(a),65 y más,2,1,1,15
Chiquimula,Unido(a),Ignorado,0,0,0,15
Chiquimula,Ignorado(a),Todas las edades,4,4,0,15
Chiquimula,Ignorado(a),Menos de 15 años,0,0,0,15
Chiquimula,Ignorado(a),15 - 24,0,0,0,15
Chiquimula,Ignorado(a),25 - 44,0,0,0,15
Chiquimula,Ignorado(a),45 - 64,0,0,0,15
Chiquimula,Ignorado(a),65 y más,0,0,0,15
Chiquimula,Ignorado(a),Ignorado,4,4,0,15
Jalapa,Todos los estados civiles,Todas las edades,1731,970,761,15
Jalapa,Todos los estados civiles,Menos de 15 años,219,112,107,15
Jalapa,Todos los estados civiles,15 - 24,123,88,35,15
Jalapa,Todos los estados civiles,25 - 44,237,177,60,15
Jalapa,Todos los estados civiles,45 - 64,340,187,153,15
Jalapa,Todos los estados civiles,65 y más,811,405,406,15
Jalapa,Todos los estados civiles,Ignorado,1,1,0,15
Jalapa,Soltero(a),Todas las edades,1020,532,488,15
Jalapa,Soltero(a),Menos de 15 años,219,112,107,15
Jalapa,Soltero(a),15 - 24,118,83,35,15
Jalapa,Soltero(a),25 - 44,147,110,37,15
Jalapa,Soltero(a),45 - 64,118,66,52,15
Jalapa,Soltero(a),65 y más,417,160,257,15
Jalapa,Soltero(a),Ignorado,1,1,0,15
Jalapa,Casado(a),Todas las edades,707,435,272,15
Jalapa,Casado(a),Menos de 15 años,0,0,0,15
Jalapa,Casado(a),15 - 24,5,5,0,15
Jalapa,Casado(a),25 - 44,90,67,23,15
Jalapa,Casado(a),45 - 64,222,121,101,15
Jalapa,Casado(a),65 y más,390,242,148,15
Jalapa,Casado(a),Ignorado,0,0,0,15
Jalapa,Unido(a),Todas las edades,4,3,1,15
Jalapa,Unido(a),Menos de 15 años,0,0,0,15
Jalapa,Unido(a),15 - 24,0,0,0,15
Jalapa,Unido(a),25 - 44,0,0,0,15
Jalapa,Unido(a),45 - 64,0,0,0,15
Jalapa,Unido(a),65 y más,4,3,1,15
Jalapa,Unido(a),Ignorado,0,0,0,15
Jalapa,Ignorado(a),Todas las edades,0,0,0,15
Jalapa,Ignorado(a),Menos de 15 años,0,0,0,15
Jalapa,Ignorado(a),15 - 24,0,0,0,15
Jalapa,Ignorado(a),25 - 44,0,0,0,15
Jalapa,Ignorado(a),45 - 64,0,0,0,15
Jalapa,Ignorado(a),65 y más,0,0,0,15
Jalapa,Ignorado(a),Ignorado,0,0,0,15
Jutiapa,Todos los estados civiles,Todas las edades,2784,1563,1221,15
Jutiapa,Todos los estados civiles,Menos de 15 años,187,104,83,15
Jutiapa,Todos los estados civiles,15 - 24,173,128,45,15
Jutiapa,Todos los estados civiles,25 - 44,380,267,113,15
Jutiapa,Todos los estados civiles,45 - 64,581,301,280,15
Jutiapa,Todos los estados civiles,65 y más,1460,761,699,15
Jutiapa,Todos los estados civiles,Ignorado,3,2,1,15
Jutiapa,Soltero(a),Todas las edades,1864,997,867,15
Jutiapa,Soltero(a),Menos de 15 años,187,104,83,15
Jutiapa,Soltero(a),15 - 24,161,123,38,15
Jutiapa,Soltero(a),25 - 44,238,170,68,15
Jutiapa,Soltero(a),45 - 64,309,155,154,15
Jutiapa,Soltero(a),65 y más,966,443,523,15
Jutiapa,Soltero(a),Ignorado,3,2,1,15
Jutiapa,Casado(a),Todas las edades,902,557,345,15
Jutiapa,Casado(a),Menos de 15 años,0,0,0,15
Jutiapa,Casado(a),15 - 24,12,5,7,15
Jutiapa,Casado(a),25 - 44,141,96,45,15
Jutiapa,Casado(a),45 - 64,269,145,124,15
Jutiapa,Casado(a),65 y más,480,311,169,15
Jutiapa,Casado(a),Ignorado,0,0,0,15
Jutiapa,Unido(a),Todas las edades,17,9,8,15
Jutiapa,Unido(a),Menos de 15 años,0,0,0,15
Jutiapa,Unido(a),15 - 24,0,0,0,15
Jutiapa,Unido(a),25 - 44,1,1,0,15
Jutiapa,Unido(a),45 - 64,3,1,2,15
Jutiapa,Unido(a),65 y más,13,7,6,15
Jutiapa,Unido(a),Ignorado,0,0,0,15
Jutiapa,Ignorado(a),Todas las edades,1,0,1,15
Jutiapa,Ignorado(a),Menos de 15 años,0,0,0,15
Jutiapa,Ignorado(a),15 - 24,0,0,0,15
Jutiapa,Ignorado(a),25 - 44,0,0,0,15
Jutiapa,Ignorado(a),45 - 64,0,0,0,15
Jutiapa,Ignorado(a),65 y más,1,0,1,15
Jutiapa,Ignorado(a),Ignorado,0,0,0,15
Extranjero,Todos los estados civiles,Todas las edades,85,52,33,15
Extranjero,Todos los estados civiles,Menos de 15 años,5,2,3,15
Extranjero,Todos los estados civiles,15 - 24,14,11,3,15
Extranjero,Todos los estados civiles,25 - 44,27,19,8,15
Extranjero,Todos los estados civiles,45 - 64,25,12,13,15
Extranjero,Todos los estados civiles,65 y más,13,7,6,15
Extranjero,Todos los estados civiles,Ignorado,1,1,0,15
Extranjero,Soltero(a),Todas las edades,64,40,24,15
Extranjero,Soltero(a),Menos de 15 años,5,2,3,15
Extranjero,Soltero(a),15 - 24,13,11,2,15
Extranjero,Soltero(a),25 - 44,20,14,6,15
Extranjero,Soltero(a),45 - 64,17,7,10,15
Extranjero,Soltero(a),65 y más,8,5,3,15
Extranjero,Soltero(a),Ignorado,1,1,0,15
Extranjero,Casado(a),Todas las edades,19,11,8,15
Extranjero,Casado(a),Menos de 15 años,0,0,0,15
Extranjero,Casado(a),15 - 24,0,0,0,15
Extranjero,Casado(a),25 - 44,6,4,2,15
Extranjero,Casado(a),45 - 64,8,5,3,15
Extranjero,Casado(a),65 y más,5,2,3,15
Extranjero,Casado(a),Ignorado,0,0,0,15
Extranjero,Unido(a),Todas las edades,0,0,0,15
Extranjero,Unido(a),Menos de 15 años,0,0,0,15
Extranjero,Unido(a),15 - 24,0,0,0,15
Extranjero,Unido(a),25 - 44,0,0,0,15
Extranjero,Unido(a),45 - 64,0,0,0,15
Extranjero,Unido(a),65 y más,0,0,0,15
Extranjero,Unido(a),Ignorado,0,0,0,15
Extranjero,Ignorado(a),Todas las edades,2,1,1,15
Extranjero,Ignorado(a),Menos de 15 años,0,0,0,15
Extranjero,Ignorado(a),15 - 24,1,0,1,15
Extranjero,Ignorado(a),25 - 44,1,1,0,15
Extranjero,Ignorado(a),45 - 64,0,0,0,15
Extranjero,Ignorado(a),65 y más,0,0,0,15
Extranjero,Ignorado(a),Ignorado,0,0,0,15
Ignorado,Todos los estados civiles,Todas las edades,5487,3350,2137,15
Ignorado,Todos los estados civiles,Menos de 15 años,4013,2293,1720,15
Ignorado,Todos los estados civiles,15 - 24,560,416,144,15
Ignorado,Todos los estados civiles,25 - 44,228,192,36,15
Ignorado,Todos los estados civiles,45 - 64,201,148,53,15
Ignorado,Todos los estados civiles,65 y más,275,139,136,15
Ignorado,Todos los estados civiles,Ignorado,210,162,48,15
Ignorado,Todos los estados civiles,Todas las edades,5072,3033,2039,15
Ignorado,Soltero(a),Menos de 15 años,4012,2292,1720,15
Ignorado,Soltero(a),15 - 24,530,398,132,15
Ignorado,Soltero(a),25 - 44,144,119,25,15
Ignorado,Soltero(a),45 - 64,114,79,35,15
Ignorado,Soltero(a),65 y más,208,97,111,15
Ignorado,Soltero(a),Ignorado,64,48,16,15
Ignorado,Casado(a),Todas las edades,85,58,27,15
Ignorado,Casado(a),Menos de 15 años,0,0,0,15
Ignorado,Casado(a),15 - 24,4,3,1,15
Ignorado,Casado(a),25 - 44,17,16,1,15
Ignorado,Casado(a),45 - 64,34,28,6,15
Ignorado,Casado(a),65 y más,29,11,18,15
Ignorado,Casado(a),Ignorado,1,0,1,15
Ignorado,Unido(a),Todas las edades,0,0,0,15
Ignorado,Unido(a),Menos de 15 años,0,0,0,15
Ignorado,Unido(a),15 - 24,0,0,0,15
Ignorado,Unido(a),25 - 44,0,0,0,15
Ignorado,Unido(a),45 - 64,0,0,0,15
Ignorado,Unido(a),65 y más,0,0,0,15
Ignorado,Unido(a),Ignorado,0,0,0,15
Ignorado,Ignorado(a),Todas las edades,330,259,71,15
Ignorado,Ignorado(a),Menos de 15 años,1,1,0,15
Ignorado,Ignorado(a),15 - 24,26,15,11,15
Ignorado,Ignorado(a),25 - 44,67,57,10,15
Ignorado,Ignorado(a),45 - 64,53,41,12,15
Ignorado,Ignorado(a),65 y más,38,31,7,15
Ignorado,Ignorado(a),Ignorado,145,114,31,15
Todos los departamentos,Todos los estados civiles,Todas las edades,82565,46267,36298,16
Todos los departamentos,Todos los estados civiles,Menos de 15 años,12570,7029,5541,16
Todos los departamentos,Todos los estados civiles,15 - 24,5309,3837,1472,16
Todos los departamentos,Todos los estados civiles,25 - 44,11457,8001,3456,16
Todos los departamentos,Todos los estados civiles,45 - 64,16846,9275,7571,16
Todos los departamentos,Todos los estados civiles,65 y más,35918,17842,18076,16
Todos los departamentos,Todos los estados civiles,Ignorado,465,283,182,16
Todos los departamentos,Soltero(a),Todas las edades,53660,29175,24485,16
Todos los departamentos,Soltero(a),Menos de 15 años,12556,7023,5533,16
Todos los departamentos,Soltero(a),15 - 24,4887,3588,1299,16
Todos los departamentos,Soltero(a),25 - 44,7227,5189,2038,16
Todos los departamentos,Soltero(a),45 - 64,7736,4172,3564,16
Todos los departamentos,Soltero(a),65 y más,21085,9119,11966,16
Todos los departamentos,Soltero(a),Ignorado,169,84,85,16
Todos los departamentos,Casado(a),Todas las edades,27523,16249,11274,16
Todos los departamentos,Casado(a),Menos de 15 años,1,1,0,16
Todos los departamentos,Casado(a),15 - 24,380,222,158,16
Todos los departamentos,Casado(a),25 - 44,4074,2698,1376,16
Todos los departamentos,Casado(a),45 - 64,8811,4924,3887,16
Todos los departamentos,Casado(a),65 y más,14227,8388,5839,16
Todos los departamentos,Casado(a),Ignorado,30,16,14,16
Todos los departamentos,Unido(a),Todas las edades,808,436,372,16
Todos los departamentos,Unido(a),Menos de 15 años,0,0,0,16
Todos los departamentos,Unido(a),15 - 24,0,0,0,16
Todos los departamentos,Unido(a),25 - 44,53,31,22,16
Todos los departamentos,Unido(a),45 - 64,225,117,108,16
Todos los departamentos,Unido(a),65 y más,528,286,242,16
Todos los departamentos,Unido(a),Ignorado,2,2,0,16
Todos los departamentos,Ignorado(a),Todas las edades,574,407,167,16
Todos los departamentos,Ignorado(a),Menos de 15 años,13,5,8,16
Todos los departamentos,Ignorado(a),15 - 24,42,27,15,16
Todos los departamentos,Ignorado(a),25 - 44,103,83,20,16
Todos los departamentos,Ignorado(a),45 - 64,74,62,12,16
Todos los departamentos,Ignorado(a),65 y más,78,49,29,16
Todos los departamentos,Ignorado(a),Ignorado,264,181,83,16
Guatemala,Todos los estados civiles,Todas las edades,18540,10224,8316,16
Guatemala,Todos los estados civiles,Menos de 15 años,1174,654,520,16
Guatemala,Todos los estados civiles,15 - 24,1210,946,264,16
Guatemala,Todos los estados civiles,25 - 44,2775,2033,742,16
Guatemala,Todos los estados civiles,45 - 64,4334,2385,1949,16
Guatemala,Todos los estados civiles,65 y más,9004,4188,4816,16
Guatemala,Todos los estados civiles,Ignorado,43,18,25,16
Guatemala,Soltero(a),Todas las edades,11383,6005,5378,16
Guatemala,Soltero(a),Menos de 15 años,1173,654,519,16
Guatemala,Soltero(a),15 - 24,1118,883,235,16
Guatemala,Soltero(a),25 - 44,1828,1374,454,16
Guatemala,Soltero(a),45 - 64,2144,1134,1010,16
Guatemala,Soltero(a),65 y más,5099,1952,3147,16
Guatemala,Soltero(a),Ignorado,21,8,13,16
Guatemala,Casado(a),Todas las edades,7055,4167,2888,16
Guatemala,Casado(a),Menos de 15 años,0,0,0,16
Guatemala,Casado(a),15 - 24,90,61,29,16
Guatemala,Casado(a),25 - 44,930,645,285,16
Guatemala,Casado(a),45 - 64,2170,1240,930,16
Guatemala,Casado(a),65 y más,3863,2219,1644,16
Guatemala,Casado(a),Ignorado,2,2,0,16
Guatemala,Unido(a),Todas las edades,30,12,18,16
Guatemala,Unido(a),Menos de 15 años,0,0,0,16
Guatemala,Unido(a),15 - 24,0,0,0,16
Guatemala,Unido(a),25 - 44,0,0,0,16
Guatemala,Unido(a),45 - 64,9,4,5,16
Guatemala,Unido(a),65 y más,21,8,13,16
Guatemala,Unido(a),Ignorado,0,0,0,16
Guatemala,Ignorado(a),Todas las edades,72,40,32,16
Guatemala,Ignorado(a),Menos de 15 años,1,0,1,16
Guatemala,Ignorado(a),15 - 24,2,2,0,16
Guatemala,Ignorado(a),25 - 44,17,14,3,16
Guatemala,Ignorado(a),45 - 64,11,7,4,16
Guatemala,Ignorado(a),65 y más,21,9,12,16
Guatemala,Ignorado(a),Ignorado,20,8,12,16
El Progreso,Todos los estados civiles,Todas las edades,1043,589,454,16
El Progreso,Todos los estados civiles,Menos de 15 años,74,36,38,16
El Progreso,Todos los estados civiles,15 - 24,63,48,15,16
El Progreso,Todos los estados civiles,25 - 44,129,102,27,16
El Progreso,Todos los estados civiles,45 - 64,233,131,102,16
El Progreso,Todos los estados civiles,65 y más,543,272,271,16
El Progreso,Todos los estados civiles,Ignorado,1,0,1,16
El Progreso,Soltero(a),Todas las edades,665,366,299,16
El Progreso,Soltero(a),Menos de 15 años,74,36,38,16
El Progreso,Soltero(a),15 - 24,58,45,13,16
El Progreso,Soltero(a),25 - 44,95,77,18,16
El Progreso,Soltero(a),45 - 64,112,63,49,16
El Progreso,Soltero(a),65 y más,325,145,180,16
El Progreso,Soltero(a),Ignorado,1,0,1,16
El Progreso,Casado(a),Todas las edades,371,220,151,16
El Progreso,Casado(a),Menos de 15 años,0,0,0,16
El Progreso,Casado(a),15 - 24,5,3,2,16
El Progreso,Casado(a),25 - 44,34,25,9,16
El Progreso,Casado(a),45 - 64,121,68,53,16
El Progreso,Casado(a),65 y más,211,124,87,16
El Progreso,Casado(a),Ignorado,0,0,0,16
El Progreso,Unido(a),Todas las edades,7,3,4,16
El Progreso,Unido(a),Menos de 15 años,0,0,0,16
El Progreso,Unido(a),15 - 24,0,0,0,16
El Progreso,Unido(a),25 - 44,0,0,0,16
El Progreso,Unido(a),45 - 64,0,0,0,16
El Progreso,Unido(a),65 y más,7,3,4,16
El Progreso,Unido(a),Ignorado,0,0,0,16
El Progreso,Ignorado(a),Todas las edades,0,0,0,16
El Progreso,Ignorado(a),Menos de 15 años,0,0,0,16
El Progreso,Ignorado(a),15 - 24,0,0,0,16
El Progreso,Ignorado(a),25 - 44,0,0,0,16
El Progreso,Ignorado(a),45 - 64,0,0,0,16
El Progreso,Ignorado(a),65 y más,0,0,0,16
El Progreso,Ignorado(a),Ignorado,0,0,0,16
Sacatepéquez,Todos los estados civiles,Todas las edades,1657,918,739,16
Sacatepéquez,Todos los estados civiles,Menos de 15 años,58,29,29,16
Sacatepéquez,Todos los estados civiles,15 - 24,79,66,13,16
Sacatepéquez,Todos los estados civiles,25 - 44,229,164,65,16
Sacatepéquez,Todos los estados civiles,45 - 64,418,232,186,16
Sacatepéquez,Todos los estados civiles,65 y más,859,419,440,16
Sacatepéquez,Todos los estados civiles,Ignorado,14,8,6,16
Sacatepéquez,Soltero(a),Todas las edades,816,446,370,16
Sacatepéquez,Soltero(a),Menos de 15 años,58,29,29,16
Sacatepéquez,Soltero(a),15 - 24,69,59,10,16
Sacatepéquez,Soltero(a),25 - 44,127,94,33,16
Sacatepéquez,Soltero(a),45 - 64,136,74,62,16
Sacatepéquez,Soltero(a),65 y más,422,187,235,16
Sacatepéquez,Soltero(a),Ignorado,4,3,1,16
Sacatepéquez,Casado(a),Todas las edades,827,464,363,16
Sacatepéquez,Casado(a),Menos de 15 años,0,0,0,16
Sacatepéquez,Casado(a),15 - 24,9,6,3,16
Sacatepéquez,Casado(a),25 - 44,102,70,32,16
Sacatepéquez,Casado(a),45 - 64,281,157,124,16
Sacatepéquez,Casado(a),65 y más,435,231,204,16
Sacatepéquez,Casado(a),Ignorado,0,0,0,16
Sacatepéquez,Unido(a),Todas las edades,3,2,1,16
Sacatepéquez,Unido(a),Menos de 15 años,0,0,0,16
Sacatepéquez,Unido(a),15 - 24,0,0,0,16
Sacatepéquez,Unido(a),25 - 44,0,0,0,16
Sacatepéquez,Unido(a),45 - 64,1,1,0,16
Sacatepéquez,Unido(a),65 y más,2,1,1,16
Sacatepéquez,Unido(a),Ignorado,0,0,0,16
Sacatepéquez,Ignorado(a),Todas las edades,11,6,5,16
Sacatepéquez,Ignorado(a),Menos de 15 años,0,0,0,16
Sacatepéquez,Ignorado(a),15 - 24,1,1,0,16
Sacatepéquez,Ignorado(a),25 - 44,0,0,0,16
Sacatepéquez,Ignorado(a),45 - 64,0,0,0,16
Sacatepéquez,Ignorado(a),65 y más,0,0,0,16
Sacatepéquez,Ignorado(a),Ignorado,10,5,5,16
Chimaltenango,Todos los estados civiles,Todas las edades,2883,1565,1318,16
Chimaltenango,Todos los estados civiles,Menos de 15 años,387,206,181,16
Chimaltenango,Todos los estados civiles,15 - 24,152,96,56,16
Chimaltenango,Todos los estados civiles,25 - 44,396,267,129,16
Chimaltenango,Todos los estados civiles,45 - 64,618,321,297,16
Chimaltenango,Todos los estados civiles,65 y más,1317,670,647,16
Chimaltenango,Todos los estados civiles,Ignorado,13,5,8,16
Chimaltenango,Soltero(a),Todas las edades,1545,810,735,16
Chimaltenango,Soltero(a),Menos de 15 años,387,206,181,16
Chimaltenango,Soltero(a),15 - 24,128,83,45,16
Chimaltenango,Soltero(a),25 - 44,205,140,65,16
Chimaltenango,Soltero(a),45 - 64,174,97,77,16
Chimaltenango,Soltero(a),65 y más,644,280,364,16
Chimaltenango,Soltero(a),Ignorado,7,4,3,16
Chimaltenango,Casado(a),Todas las edades,1323,749,574,16
Chimaltenango,Casado(a),Menos de 15 años,0,0,0,16
Chimaltenango,Casado(a),15 - 24,24,13,11,16
Chimaltenango,Casado(a),25 - 44,191,127,64,16
Chimaltenango,Casado(a),45 - 64,443,224,219,16
Chimaltenango,Casado(a),65 y más,663,385,278,16
Chimaltenango,Casado(a),Ignorado,2,0,2,16
Chimaltenango,Unido(a),Todas las edades,11,5,6,16
Chimaltenango,Unido(a),Menos de 15 años,0,0,0,16
Chimaltenango,Unido(a),15 - 24,0,0,0,16
Chimaltenango,Unido(a),25 - 44,0,0,0,16
Chimaltenango,Unido(a),45 - 64,1,0,1,16
Chimaltenango,Unido(a),65 y más,10,5,5,16
Chimaltenango,Unido(a),Ignorado,0,0,0,16
Chimaltenango,Ignorado(a),Todas las edades,4,1,3,16
Chimaltenango,Ignorado(a),Menos de 15 años,0,0,0,16
Chimaltenango,Ignorado(a),15 - 24,0,0,0,16
Chimaltenango,Ignorado(a),25 - 44,0,0,0,16
Chimaltenango,Ignorado(a),45 - 64,0,0,0,16
Chimaltenango,Ignorado(a),65 y más,0,0,0,16
Chimaltenango,Ignorado(a),Ignorado,4,1,3,16
Escuintla,Todos los estados civiles,Todas las edades,4294,2550,1744,16
Escuintla,Todos los estados civiles,Menos de 15 años,145,87,58,16
Escuintla,Todos los estados civiles,15 - 24,317,265,52,16
Escuintla,Todos los estados civiles,25 - 44,807,577,230,16
Escuintla,Todos los estados civiles,45 - 64,1140,633,507,16
Escuintla,Todos los estados civiles,65 y más,1873,978,895,16
Escuintla,Todos los estados civiles,Ignorado,12,10,2,16
Escuintla,Soltero(a),Todas las edades,2796,1666,1130,16
Escuintla,Soltero(a),Menos de 15 años,145,87,58,16
Escuintla,Soltero(a),15 - 24,297,252,45,16
Escuintla,Soltero(a),25 - 44,559,406,153,16
Escuintla,Soltero(a),45 - 64,614,351,263,16
Escuintla,Soltero(a),65 y más,1177,566,611,16
Escuintla,Soltero(a),Ignorado,4,4,0,16
Escuintla,Casado(a),Todas las edades,1471,869,602,16
Escuintla,Casado(a),Menos de 15 años,0,0,0,16
Escuintla,Casado(a),15 - 24,20,13,7,16
Escuintla,Casado(a),25 - 44,245,170,75,16
Escuintla,Casado(a),45 - 64,522,280,242,16
Escuintla,Casado(a),65 y más,683,406,277,16
Escuintla,Casado(a),Ignorado,1,0,1,16
Escuintla,Unido(a),Todas las edades,16,6,10,16
Escuintla,Unido(a),Menos de 15 años,0,0,0,16
Escuintla,Unido(a),15 - 24,0,0,0,16
Escuintla,Unido(a),25 - 44,2,0,2,16
Escuintla,Unido(a),45 - 64,4,2,2,16
Escuintla,Unido(a),65 y más,10,4,6,16
Escuintla,Unido(a),Ignorado,0,0,0,16
Escuintla,Ignorado(a),Todas las edades,11,9,2,16
Escuintla,Ignorado(a),Menos de 15 años,0,0,0,16
Escuintla,Ignorado(a),15 - 24,0,0,0,16
Escuintla,Ignorado(a),25 - 44,1,1,0,16
Escuintla,Ignorado(a),45 - 64,0,0,0,16
Escuintla,Ignorado(a),65 y más,3,2,1,16
Escuintla,Ignorado(a),Ignorado,7,6,1,16
Santa Rosa,Todos los estados civiles,Todas las edades,1974,1134,840,16
Santa Rosa,Todos los estados civiles,Menos de 15 años,59,33,26,16
Santa Rosa,Todos los estados civiles,15 - 24,127,99,28,16
Santa Rosa,Todos los estados civiles,25 - 44,289,205,84,16
Santa Rosa,Todos los estados civiles,45 - 64,463,266,197,16
Santa Rosa,Todos los estados civiles,65 y más,1033,530,503,16
Santa Rosa,Todos los estados civiles,Ignorado,3,1,2,16
Santa Rosa,Soltero(a),Todas las edades,1255,712,543,16
Santa Rosa,Soltero(a),Menos de 15 años,59,33,26,16
Santa Rosa,Soltero(a),15 - 24,118,95,23,16
Santa Rosa,Soltero(a),25 - 44,192,142,50,16
Santa Rosa,Soltero(a),45 - 64,245,132,113,16
Santa Rosa,Soltero(a),65 y más,641,310,331,16
Santa Rosa,Soltero(a),Ignorado,0,0,0,16
Santa Rosa,Casado(a),Todas las edades,697,413,284,16
Santa Rosa,Casado(a),Menos de 15 años,0,0,0,16
Santa Rosa,Casado(a),15 - 24,9,4,5,16
Santa Rosa,Casado(a),25 - 44,96,62,34,16
Santa Rosa,Casado(a),45 - 64,212,131,81,16
Santa Rosa,Casado(a),65 y más,378,215,163,16
Santa Rosa,Casado(a),Ignorado,2,1,1,16
Santa Rosa,Unido(a),Todas las edades,20,8,12,16
Santa Rosa,Unido(a),Menos de 15 años,0,0,0,16
Santa Rosa,Unido(a),15 - 24,0,0,0,16
Santa Rosa,Unido(a),25 - 44,1,1,0,16
Santa Rosa,Unido(a),45 - 64,5,2,3,16
Santa Rosa,Unido(a),65 y más,14,5,9,16
Santa Rosa,Unido(a),Ignorado,0,0,0,16
Santa Rosa,Ignorado(a),Todas las edades,2,1,1,16
Santa Rosa,Ignorado(a),Menos de 15 años,0,0,0,16
Santa Rosa,Ignorado(a),15 - 24,0,0,0,16
Santa Rosa,Ignorado(a),25 - 44,0,0,0,16
Santa Rosa,Ignorado(a),45 - 64,1,1,0,16
Santa Rosa,Ignorado(a),65 y más,0,0,0,16
Santa Rosa,Ignorado(a),Ignorado,1,0,1,16
Sololá,Todos los estados civiles,Todas las edades,1746,915,831,16
Sololá,Todos los estados civiles,Menos de 15 años,109,53,56,16
Sololá,Todos los estados civiles,15 - 24,71,47,24,16
Sololá,Todos los estados civiles,25 - 44,265,179,86,16
Sololá,Todos los estados civiles,45 - 64,405,219,186,16
Sololá,Todos los estados civiles,65 y más,892,414,478,16
Sololá,Todos los estados civiles,Ignorado,4,3,1,16
Sololá,Soltero(a),Todas las edades,1063,528,535,16
Sololá,Soltero(a),Menos de 15 años,108,52,56,16
Sololá,Soltero(a),15 - 24,62,41,21,16
Sololá,Soltero(a),25 - 44,156,110,46,16
Sololá,Soltero(a),45 - 64,175,99,76,16
Sololá,Soltero(a),65 y más,562,226,336,16
Sololá,Soltero(a),Ignorado,0,0,0,16
Sololá,Casado(a),Todas las edades,576,325,251,16
Sololá,Casado(a),Menos de 15 años,0,0,0,16
Sololá,Casado(a),15 - 24,9,6,3,16
Sololá,Casado(a),25 - 44,106,66,40,16
Sololá,Casado(a),45 - 64,201,105,96,16
Sololá,Casado(a),65 y más,260,148,112,16
Sololá,Casado(a),Ignorado,0,0,0,16
Sololá,Unido(a),Todas las edades,100,57,43,16
Sololá,Unido(a),Menos de 15 años,0,0,0,16
Sololá,Unido(a),15 - 24,0,0,0,16
Sololá,Unido(a),25 - 44,3,3,0,16
Sololá,Unido(a),45 - 64,28,14,14,16
Sololá,Unido(a),65 y más,67,38,29,16
Sololá,Unido(a),Ignorado,2,2,0,16
Sololá,Ignorado(a),Todas las edades,7,5,2,16
Sololá,Ignorado(a),Menos de 15 años,1,1,0,16
Sololá,Ignorado(a),15 - 24,0,0,0,16
Sololá,Ignorado(a),25 - 44,0,0,0,16
Sololá,Ignorado(a),45 - 64,1,1,0,16
Sololá,Ignorado(a),65 y más,3,2,1,16
Sololá,Ignorado(a),Ignorado,2,1,1,16
Totonicapán,Todos los estados civiles,Todas las edades,2331,1260,1071,16
Totonicapán,Todos los estados civiles,Menos de 15 años,259,148,111,16
Totonicapán,Todos los estados civiles,15 - 24,105,63,42,16
Totonicapán,Todos los estados civiles,25 - 44,355,237,118,16
Totonicapán,Todos los estados civiles,45 - 64,531,305,226,16
Totonicapán,Todos los estados civiles,65 y más,1071,503,568,16
Totonicapán,Todos los estados civiles,Ignorado,10,4,6,16
Totonicapán,Soltero(a),Todas las edades,1308,637,671,16
Totonicapán,Soltero(a),Menos de 15 años,259,148,111,16
Totonicapán,Soltero(a),15 - 24,92,59,33,16
Totonicapán,Soltero(a),25 - 44,182,124,58,16
Totonicapán,Soltero(a),45 - 64,182,94,88,16
Totonicapán,Soltero(a),65 y más,591,212,379,16
Totonicapán,Soltero(a),Ignorado,2,0,2,16
Totonicapán,Casado(a),Todas las edades,934,572,362,16
Totonicapán,Casado(a),Menos de 15 años,0,0,0,16
Totonicapán,Casado(a),15 - 24,13,4,9,16
Totonicapán,Casado(a),25 - 44,168,109,59,16
Totonicapán,Casado(a),45 - 64,336,202,134,16
Totonicapán,Casado(a),65 y más,417,257,160,16
Totonicapán,Casado(a),Ignorado,0,0,0,16
Totonicapán,Unido(a),Todas las edades,78,44,34,16
Totonicapán,Unido(a),Menos de 15 años,0,0,0,16
Totonicapán,Unido(a),15 - 24,0,0,0,16
Totonicapán,Unido(a),25 - 44,3,2,1,16
Totonicapán,Unido(a),45 - 64,13,9,4,16
Totonicapán,Unido(a),65 y más,62,33,29,16
Totonicapán,Unido(a),Ignorado,0,0,0,16
Totonicapán,Ignorado(a),Todas las edades,11,7,4,16
Totonicapán,Ignorado(a),Menos de 15 años,0,0,0,16
Totonicapán,Ignorado(a),15 - 24,0,0,0,16
Totonicapán,Ignorado(a),25 - 44,2,2,0,16
Totonicapán,Ignorado(a),45 - 64,0,0,0,16
Totonicapán,Ignorado(a),65 y más,1,1,0,16
Totonicapán,Ignorado(a),Ignorado,8,4,4,16
Quetzaltenango,Todos los estados civiles,Todas las edades,4476,2450,2026,16
Quetzaltenango,Todos los estados civiles,Menos de 15 años,464,264,200,16
Quetzaltenango,Todos los estados civiles,15 - 24,202,143,59,16
Quetzaltenango,Todos los estados civiles,25 - 44,613,418,195,16
Quetzaltenango,Todos los estados civiles,45 - 64,947,550,397,16
Quetzaltenango,Todos los estados civiles,65 y más,2224,1061,1163,16
Quetzaltenango,Todos los estados civiles,Ignorado,26,14,12,16
Quetzaltenango,Soltero(a),Todas las edades,2691,1408,1283,16
Quetzaltenango,Soltero(a),Menos de 15 años,462,263,199,16
Quetzaltenango,Soltero(a),15 - 24,190,135,55,16
Quetzaltenango,Soltero(a),25 - 44,403,282,121,16
Quetzaltenango,Soltero(a),45 - 64,377,209,168,16
Quetzaltenango,Soltero(a),65 y más,1251,514,737,16
Quetzaltenango,Soltero(a),Ignorado,8,5,3,16
Quetzaltenango,Casado(a),Todas las edades,1682,988,694,16
Quetzaltenango,Casado(a),Menos de 15 años,0,0,0,16
Quetzaltenango,Casado(a),15 - 24,12,8,4,16
Quetzaltenango,Casado(a),25 - 44,202,132,70,16
Quetzaltenango,Casado(a),45 - 64,542,327,215,16
Quetzaltenango,Casado(a),65 y más,920,520,400,16
Quetzaltenango,Casado(a),Ignorado,6,1,5,16
Quetzaltenango,Unido(a),Todas las edades,85,43,42,16
Quetzaltenango,Unido(a),Menos de 15 años,0,0,0,16
Quetzaltenango,Unido(a),15 - 24,0,0,0,16
Quetzaltenango,Unido(a),25 - 44,8,4,4,16
Quetzaltenango,Unido(a),45 - 64,27,13,14,16
Quetzaltenango,Unido(a),65 y más,50,26,24,16
Quetzaltenango,Unido(a),Ignorado,0,0,0,16
Quetzaltenango,Ignorado(a),Todas las edades,18,11,7,16
Quetzaltenango,Ignorado(a),Menos de 15 años,2,1,1,16
Quetzaltenango,Ignorado(a),15 - 24,0,0,0,16
Quetzaltenango,Ignorado(a),25 - 44,0,0,0,16
Quetzaltenango,Ignorado(a),45 - 64,1,1,0,16
Quetzaltenango,Ignorado(a),65 y más,3,1,2,16
Quetzaltenango,Ignorado(a),Ignorado,12,8,4,16
Suchitepéquez,Todos los estados civiles,Todas las edades,2831,1612,1219,16
Suchitepéquez,Todos los estados civiles,Menos de 15 años,184,114,70,16
Suchitepéquez,Todos los estados civiles,15 - 24,138,109,29,16
Suchitepéquez,Todos los estados civiles,25 - 44,403,292,111,16
Suchitepéquez,Todos los estados civiles,45 - 64,718,380,338,16
Suchitepéquez,Todos los estados civiles,65 y más,1381,715,666,16
Suchitepéquez,Todos los estados civiles,Ignorado,7,2,5,16
Suchitepéquez,Soltero(a),Todas las edades,1676,919,757,16
Suchitepéquez,Soltero(a),Menos de 15 años,184,114,70,16
Suchitepéquez,Soltero(a),15 - 24,123,102,21,16
Suchitepéquez,Soltero(a),25 - 44,232,171,61,16
Suchitepéquez,Soltero(a),45 - 64,309,150,159,16
Suchitepéquez,Soltero(a),65 y más,824,381,443,16
Suchitepéquez,Soltero(a),Ignorado,4,1,3,16
Suchitepéquez,Casado(a),Todas las edades,1138,684,454,16
Suchitepéquez,Casado(a),Menos de 15 años,0,0,0,16
Suchitepéquez,Casado(a),15 - 24,15,7,8,16
Suchitepéquez,Casado(a),25 - 44,171,121,50,16
Suchitepéquez,Casado(a),45 - 64,408,229,179,16
Suchitepéquez,Casado(a),65 y más,543,326,217,16
Suchitepéquez,Casado(a),Ignorado,1,1,0,16
Suchitepéquez,Unido(a),Todas las edades,15,9,6,16
Suchitepéquez,Unido(a),Menos de 15 años,0,0,0,16
Suchitepéquez,Unido(a),15 - 24,0,0,0,16
Suchitepéquez,Unido(a),25 - 44,0,0,0,16
Suchitepéquez,Unido(a),45 - 64,1,1,0,16
Suchitepéquez,Unido(a),65 y más,14,8,6,16
Suchitepéquez,Unido(a),Ignorado,0,0,0,16
Suchitepéquez,Ignorado(a),Todas las edades,2,0,2,16
Suchitepéquez,Ignorado(a),Menos de 15 años,0,0,0,16
Suchitepéquez,Ignorado(a),15 - 24,0,0,0,16
Suchitepéquez,Ignorado(a),25 - 44,0,0,0,16
Suchitepéquez,Ignorado(a),45 - 64,0,0,0,16
Suchitepéquez,Ignorado(a),65 y más,0,0,0,16
Suchitepéquez,Ignorado(a),Ignorado,2,0,2,16
Retalhuleu,Todos los estados civiles,Todas las edades,1874,1088,786,16
Retalhuleu,Todos los estados civiles,Menos de 15 años,159,93,66,16
Retalhuleu,Todos los estados civiles,15 - 24,95,77,18,16
Retalhuleu,Todos los estados civiles,25 - 44,271,197,74,16
Retalhuleu,Todos los estados civiles,45 - 64,428,263,165,16
Retalhuleu,Todos los estados civiles,65 y más,917,456,461,16
Retalhuleu,Todos los estados civiles,Ignorado,4,2,2,16
Retalhuleu,Soltero(a),Todas las edades,1124,643,481,16
Retalhuleu,Soltero(a),Menos de 15 años,159,93,66,16
Retalhuleu,Soltero(a),15 - 24,82,69,13,16
Retalhuleu,Soltero(a),25 - 44,170,124,46,16
Retalhuleu,Soltero(a),45 - 64,189,124,65,16
Retalhuleu,Soltero(a),65 y más,520,231,289,16
Retalhuleu,Soltero(a),Ignorado,4,2,2,16
Retalhuleu,Casado(a),Todas las edades,706,423,283,16
Retalhuleu,Casado(a),Menos de 15 años,0,0,0,16
Retalhuleu,Casado(a),15 - 24,13,8,5,16
Retalhuleu,Casado(a),25 - 44,101,73,28,16
Retalhuleu,Casado(a),45 - 64,225,134,91,16
Retalhuleu,Casado(a),65 y más,367,208,159,16
Retalhuleu,Casado(a),Ignorado,0,0,0,16
Retalhuleu,Unido(a),Todas las edades,42,21,21,16
Retalhuleu,Unido(a),Menos de 15 años,0,0,0,16
Retalhuleu,Unido(a),15 - 24,0,0,0,16
Retalhuleu,Unido(a),25 - 44,0,0,0,16
Retalhuleu,Unido(a),45 - 64,14,5,9,16
Retalhuleu,Unido(a),65 y más,28,16,12,16
Retalhuleu,Unido(a),Ignorado,0,0,0,16
Retalhuleu,Ignorado(a),Todas las edades,2,1,1,16
Retalhuleu,Ignorado(a),Menos de 15 años,0,0,0,16
Retalhuleu,Ignorado(a),15 - 24,0,0,0,16
Retalhuleu,Ignorado(a),25 - 44,0,0,0,16
Retalhuleu,Ignorado(a),45 - 64,0,0,0,16
Retalhuleu,Ignorado(a),65 y más,2,1,1,16
Retalhuleu,Ignorado(a),Ignorado,0,0,0,16
San Marcos,Todos los estados civiles,Todas las edades,4508,2538,1970,16
San Marcos,Todos los estados civiles,Menos de 15 años,372,195,177,16
San Marcos,Todos los estados civiles,15 - 24,208,138,70,16
San Marcos,Todos los estados civiles,25 - 44,705,482,223,16
San Marcos,Todos los estados civiles,45 - 64,999,574,425,16
San Marcos,Todos los estados civiles,65 y más,2212,1141,1071,16
San Marcos,Todos los estados civiles,Ignorado,12,8,4,16
San Marcos,Soltero(a),Todas las edades,2804,1536,1268,16
San Marcos,Soltero(a),Menos de 15 años,372,195,177,16
San Marcos,Soltero(a),15 - 24,189,126,63,16
San Marcos,Soltero(a),25 - 44,451,321,130,16
San Marcos,Soltero(a),45 - 64,506,294,212,16
San Marcos,Soltero(a),65 y más,1277,595,682,16
San Marcos,Soltero(a),Ignorado,9,5,4,16
San Marcos,Casado(a),Todas las edades,1622,955,667,16
San Marcos,Casado(a),Menos de 15 años,0,0,0,16
San Marcos,Casado(a),15 - 24,19,12,7,16
San Marcos,Casado(a),25 - 44,252,159,93,16
San Marcos,Casado(a),45 - 64,467,269,198,16
San Marcos,Casado(a),65 y más,882,513,369,16
San Marcos,Casado(a),Ignorado,2,2,0,16
San Marcos,Unido(a),Todas las edades,79,45,34,16
San Marcos,Unido(a),Menos de 15 años,0,0,0,16
San Marcos,Unido(a),15 - 24,0,0,0,16
San Marcos,Unido(a),25 - 44,2,2,0,16
San Marcos,Unido(a),45 - 64,26,11,15,16
San Marcos,Unido(a),65 y más,51,32,19,16
San Marcos,Unido(a),Ignorado,0,0,0,16
San Marcos,Ignorado(a),Todas las edades,3,2,1,16
San Marcos,Ignorado(a),Menos de 15 años,0,0,0,16
San Marcos,Ignorado(a),15 - 24,0,0,0,16
San Marcos,Ignorado(a),25 - 44,0,0,0,16
San Marcos,Ignorado(a),45 - 64,0,0,0,16
San Marcos,Ignorado(a),65 y más,2,1,1,16
San Marcos,Ignorado(a),Ignorado,1,1,0,16
Huehuetenango,Todos los estados civiles,Todas las edades,4324,2344,1980,16
Huehuetenango,Todos los estados civiles,Menos de 15 años,539,304,235,16
Huehuetenango,Todos los estados civiles,15 - 24,248,143,105,16
Huehuetenango,Todos los estados civiles,25 - 44,635,353,282,16
Huehuetenango,Todos los estados civiles,45 - 64,825,435,390,16
Huehuetenango,Todos los estados civiles,65 y más,2069,1105,964,16
Huehuetenango,Todos los estados civiles,Ignorado,8,4,4,16
Huehuetenango,Soltero(a),Todas las edades,2935,1563,1372,16
Huehuetenango,Soltero(a),Menos de 15 años,539,304,235,16
Huehuetenango,Soltero(a),15 - 24,225,133,92,16
Huehuetenango,Soltero(a),25 - 44,382,211,171,16
Huehuetenango,Soltero(a),45 - 64,400,216,184,16
Huehuetenango,Soltero(a),65 y más,1382,695,687,16
Huehuetenango,Soltero(a),Ignorado,7,4,3,16
Huehuetenango,Casado(a),Todas las edades,1375,773,602,16
Huehuetenango,Casado(a),Menos de 15 años,0,0,0,16
Huehuetenango,Casado(a),15 - 24,23,10,13,16
Huehuetenango,Casado(a),25 - 44,252,141,111,16
Huehuetenango,Casado(a),45 - 64,425,219,206,16
Huehuetenango,Casado(a),65 y más,674,403,271,16
Huehuetenango,Casado(a),Ignorado,1,0,1,16
Huehuetenango,Unido(a),Todas las edades,14,8,6,16
Huehuetenango,Unido(a),Menos de 15 años,0,0,0,16
Huehuetenango,Unido(a),15 - 24,0,0,0,16
Huehuetenango,Unido(a),25 - 44,1,1,0,16
Huehuetenango,Unido(a),45 - 64,0,0,0,16
Huehuetenango,Unido(a),65 y más,13,7,6,16
Huehuetenango,Unido(a),Ignorado,0,0,0,16
Huehuetenango,Ignorado(a),Todas las edades,0,0,0,16
Huehuetenango,Ignorado(a),Menos de 15 años,0,0,0,16
Huehuetenango,Ignorado(a),15 - 24,0,0,0,16
Huehuetenango,Ignorado(a),25 - 44,0,0,0,16
Huehuetenango,Ignorado(a),45 - 64,0,0,0,16
Huehuetenango,Ignorado(a),65 y más,0,0,0,16
Huehuetenango,Ignorado(a),Ignorado,0,0,0,16
Quiché,Todos los estados civiles,Todas las edades,3670,1941,1729,16
Quiché,Todos los estados civiles,Menos de 15 años,416,238,178,16
Quiché,Todos los estados civiles,15 - 24,213,131,82,16
Quiché,Todos los estados civiles,25 - 44,590,367,223,16
Quiché,Todos los estados civiles,45 - 64,758,411,347,16
Quiché,Todos los estados civiles,65 y más,1676,785,891,16
Quiché,Todos los estados civiles,Ignorado,17,9,8,16
Quiché,Soltero(a),Todas las edades,2438,1205,1233,16
Quiché,Soltero(a),Menos de 15 años,416,238,178,16
Quiché,Soltero(a),15 - 24,190,118,72,16
Quiché,Soltero(a),25 - 44,342,218,124,16
Quiché,Soltero(a),45 - 64,350,180,170,16
Quiché,Soltero(a),65 y más,1130,444,686,16
Quiché,Soltero(a),Ignorado,10,7,3,16
Quiché,Casado(a),Todas las edades,1207,723,484,16
Quiché,Casado(a),Menos de 15 años,0,0,0,16
Quiché,Casado(a),15 - 24,23,13,10,16
Quiché,Casado(a),25 - 44,247,149,98,16
Quiché,Casado(a),45 - 64,404,228,176,16
Quiché,Casado(a),65 y más,529,331,198,16
Quiché,Casado(a),Ignorado,4,2,2,16
Quiché,Unido(a),Todas las edades,22,13,9,16
Quiché,Unido(a),Menos de 15 años,0,0,0,16
Quiché,Unido(a),15 - 24,0,0,0,16
Quiché,Unido(a),25 - 44,1,0,1,16
Quiché,Unido(a),45 - 64,4,3,1,16
Quiché,Unido(a),65 y más,17,10,7,16
Quiché,Unido(a),Ignorado,0,0,0,16
Quiché,Ignorado(a),Todas las edades,3,0,3,16
Quiché,Ignorado(a),Menos de 15 años,0,0,0,16
Quiché,Ignorado(a),15 - 24,0,0,0,16
Quiché,Ignorado(a),25 - 44,0,0,0,16
Quiché,Ignorado(a),45 - 64,0,0,0,16
Quiché,Ignorado(a),65 y más,0,0,0,16
Quiché,Ignorado(a),Ignorado,3,0,3,16
Baja Verapaz,Todos los estados civiles,Todas las edades,1363,728,635,16
Baja Verapaz,Todos los estados civiles,Menos de 15 años,150,67,83,16
Baja Verapaz,Todos los estados civiles,15 - 24,92,58,34,16
Baja Verapaz,Todos los estados civiles,25 - 44,152,109,43,16
Baja Verapaz,Todos los estados civiles,45 - 64,255,138,117,16
Baja Verapaz,Todos los estados civiles,65 y más,710,353,357,16
Baja Verapaz,Todos los estados civiles,Ignorado,4,3,1,16
Baja Verapaz,Soltero(a),Todas las edades,816,386,430,16
Baja Verapaz,Soltero(a),Menos de 15 años,149,67,82,16
Baja Verapaz,Soltero(a),15 - 24,79,49,30,16
Baja Verapaz,Soltero(a),25 - 44,74,53,21,16
Baja Verapaz,Soltero(a),45 - 64,103,51,52,16
Baja Verapaz,Soltero(a),65 y más,409,164,245,16
Baja Verapaz,Soltero(a),Ignorado,2,2,0,16
Baja Verapaz,Casado(a),Todas las edades,523,332,191,16
Baja Verapaz,Casado(a),Menos de 15 años,0,0,0,16
Baja Verapaz,Casado(a),15 - 24,13,9,4,16
Baja Verapaz,Casado(a),25 - 44,78,56,22,16
Baja Verapaz,Casado(a),45 - 64,152,87,65,16
Baja Verapaz,Casado(a),65 y más,278,179,99,16
Baja Verapaz,Casado(a),Ignorado,2,1,1,16
Baja Verapaz,Unido(a),Todas las edades,23,10,13,16
Baja Verapaz,Unido(a),Menos de 15 años,0,0,0,16
Baja Verapaz,Unido(a),15 - 24,0,0,0,16
Baja Verapaz,Unido(a),25 - 44,0,0,0,16
Baja Verapaz,Unido(a),45 - 64,0,0,0,16
Baja Verapaz,Unido(a),65 y más,23,10,13,16
Baja Verapaz,Unido(a),Ignorado,0,0,0,16
Baja Verapaz,Ignorado(a),Todas las edades,1,0,1,16
Baja Verapaz,Ignorado(a),Menos de 15 años,1,0,1,16
Baja Verapaz,Ignorado(a),15 - 24,0,0,0,16
Baja Verapaz,Ignorado(a),25 - 44,0,0,0,16
Baja Verapaz,Ignorado(a),45 - 64,0,0,0,16
Baja Verapaz,Ignorado(a),65 y más,0,0,0,16
Baja Verapaz,Ignorado(a),Ignorado,0,0,0,16
Alta Verapaz,Todos los estados civiles,Todas las edades,4822,2485,2337,16
Alta Verapaz,Todos los estados civiles,Menos de 15 años,987,541,446,16
Alta Verapaz,Todos los estados civiles,15 - 24,267,163,104,16
Alta Verapaz,Todos los estados civiles,25 - 44,618,357,261,16
Alta Verapaz,Todos los estados civiles,45 - 64,896,426,470,16
Alta Verapaz,Todos los estados civiles,65 y más,2038,991,1047,16
Alta Verapaz,Todos los estados civiles,Ignorado,16,7,9,16
Alta Verapaz,Soltero(a),Todas las edades,2811,1371,1440,16
Alta Verapaz,Soltero(a),Menos de 15 años,987,541,446,16
Alta Verapaz,Soltero(a),15 - 24,237,149,88,16
Alta Verapaz,Soltero(a),25 - 44,309,173,136,16
Alta Verapaz,Soltero(a),45 - 64,291,130,161,16
Alta Verapaz,Soltero(a),65 y más,978,376,602,16
Alta Verapaz,Soltero(a),Ignorado,9,2,7,16
Alta Verapaz,Casado(a),Todas las edades,1948,1081,867,16
Alta Verapaz,Casado(a),Menos de 15 años,0,0,0,16
Alta Verapaz,Casado(a),15 - 24,30,14,16,16
Alta Verapaz,Casado(a),25 - 44,305,180,125,16
Alta Verapaz,Casado(a),45 - 64,588,288,300,16
Alta Verapaz,Casado(a),65 y más,1019,594,425,16
Alta Verapaz,Casado(a),Ignorado,6,5,1,16
Alta Verapaz,Unido(a),Todas las edades,59,31,28,16
Alta Verapaz,Unido(a),Menos de 15 años,0,0,0,16
Alta Verapaz,Unido(a),15 - 24,0,0,0,16
Alta Verapaz,Unido(a),25 - 44,4,4,0,16
Alta Verapaz,Unido(a),45 - 64,17,8,9,16
Alta Verapaz,Unido(a),65 y más,38,19,19,16
Alta Verapaz,Unido(a),Ignorado,0,0,0,16
Alta Verapaz,Ignorado(a),Todas las edades,4,2,2,16
Alta Verapaz,Ignorado(a),Menos de 15 años,0,0,0,16
Alta Verapaz,Ignorado(a),15 - 24,0,0,0,16
Alta Verapaz,Ignorado(a),25 - 44,0,0,0,16
Alta Verapaz,Ignorado(a),45 - 64,0,0,0,16
Alta Verapaz,Ignorado(a),65 y más,3,2,1,16
Alta Verapaz,Ignorado(a),Ignorado,1,0,1,16
Petén,Todos los estados civiles,Todas las edades,2074,1277,797,16
Petén,Todos los estados civiles,Menos de 15 años,210,131,79,16
Petén,Todos los estados civiles,15 - 24,198,151,47,16
Petén,Todos los estados civiles,25 - 44,388,276,112,16
Petén,Todos los estados civiles,45 - 64,461,244,217,16
Petén,Todos los estados civiles,65 y más,804,463,341,16
Petén,Todos los estados civiles,Ignorado,13,12,1,16
Petén,Soltero(a),Todas las edades,1400,882,518,16
Petén,Soltero(a),Menos de 15 años,209,130,79,16
Petén,Soltero(a),15 - 24,190,149,41,16
Petén,Soltero(a),25 - 44,263,197,66,16
Petén,Soltero(a),45 - 64,231,127,104,16
Petén,Soltero(a),65 y más,504,277,227,16
Petén,Soltero(a),Ignorado,3,2,1,16
Petén,Casado(a),Todas las edades,536,311,225,16
Petén,Casado(a),Menos de 15 años,1,1,0,16
Petén,Casado(a),15 - 24,8,2,6,16
Petén,Casado(a),25 - 44,99,68,31,16
Petén,Casado(a),45 - 64,179,83,96,16
Petén,Casado(a),65 y más,249,157,92,16
Petén,Casado(a),Ignorado,0,0,0,16
Petén,Unido(a),Todas las edades,126,73,53,16
Petén,Unido(a),Menos de 15 años,0,0,0,16
Petén,Unido(a),15 - 24,0,0,0,16
Petén,Unido(a),25 - 44,25,11,14,16
Petén,Unido(a),45 - 64,51,34,17,16
Petén,Unido(a),65 y más,50,28,22,16
Petén,Unido(a),Ignorado,0,0,0,16
Petén,Ignorado(a),Todas las edades,12,11,1,16
Petén,Ignorado(a),Menos de 15 años,0,0,0,16
Petén,Ignorado(a),15 - 24,0,0,0,16
Petén,Ignorado(a),25 - 44,1,0,1,16
Petén,Ignorado(a),45 - 64,0,0,0,16
Petén,Ignorado(a),65 y más,1,1,0,16
Petén,Ignorado(a),Ignorado,10,10,0,16
Izabal,Todos los estados civiles,Todas las edades,2219,1288,931,16
Izabal,Todos los estados civiles,Menos de 15 años,203,105,98,16
Izabal,Todos los estados civiles,15 - 24,191,144,47,16
Izabal,Todos los estados civiles,25 - 44,362,264,98,16
Izabal,Todos los estados civiles,45 - 64,484,254,230,16
Izabal,Todos los estados civiles,65 y más,976,520,456,16
Izabal,Todos los estados civiles,Ignorado,3,1,2,16
Izabal,Soltero(a),Todas las edades,1521,869,652,16
Izabal,Soltero(a),Menos de 15 años,203,105,98,16
Izabal,Soltero(a),15 - 24,183,142,41,16
Izabal,Soltero(a),25 - 44,272,206,66,16
Izabal,Soltero(a),45 - 64,251,124,127,16
Izabal,Soltero(a),65 y más,609,291,318,16
Izabal,Soltero(a),Ignorado,3,1,2,16
Izabal,Casado(a),Todas las edades,662,401,261,16
Izabal,Casado(a),Menos de 15 años,0,0,0,16
Izabal,Casado(a),15 - 24,8,2,6,16
Izabal,Casado(a),25 - 44,90,58,32,16
Izabal,Casado(a),45 - 64,220,125,95,16
Izabal,Casado(a),65 y más,344,216,128,16
Izabal,Casado(a),Ignorado,0,0,0,16
Izabal,Unido(a),Todas las edades,35,17,18,16
Izabal,Unido(a),Menos de 15 años,0,0,0,16
Izabal,Unido(a),15 - 24,0,0,0,16
Izabal,Unido(a),25 - 44,0,0,0,16
Izabal,Unido(a),45 - 64,12,4,8,16
Izabal,Unido(a),65 y más,23,13,10,16
Izabal,Unido(a),Ignorado,0,0,0,16
Izabal,Ignorado(a),Todas las edades,1,1,0,16
Izabal,Ignorado(a),Menos de 15 años,0,0,0,16
Izabal,Ignorado(a),15 - 24,0,0,0,16
Izabal,Ignorado(a),25 - 44,0,0,0,16
Izabal,Ignorado(a),45 - 64,1,1,0,16
Izabal,Ignorado(a),65 y más,0,0,0,16
Izabal,Ignorado(a),Ignorado,0,0,0,16
Zacapa,Todos los estados civiles,Todas las edades,1545,900,645,16
Zacapa,Todos los estados civiles,Menos de 15 años,115,65,50,16
Zacapa,Todos los estados civiles,15 - 24,76,57,19,16
Zacapa,Todos los estados civiles,25 - 44,237,190,47,16
Zacapa,Todos los estados civiles,45 - 64,338,177,161,16
Zacapa,Todos los estados civiles,65 y más,779,411,368,16
Zacapa,Todos los estados civiles,Ignorado,0,0,0,16
Zacapa,Soltero(a),Todas las edades,1003,559,444,16
Zacapa,Soltero(a),Menos de 15 años,115,65,50,16
Zacapa,Soltero(a),15 - 24,74,55,19,16
Zacapa,Soltero(a),25 - 44,162,132,30,16
Zacapa,Soltero(a),45 - 64,178,89,89,16
Zacapa,Soltero(a),65 y más,474,218,256,16
Zacapa,Soltero(a),Ignorado,0,0,0,16
Zacapa,Casado(a),Todas las edades,537,337,200,16
Zacapa,Casado(a),Menos de 15 años,0,0,0,16
Zacapa,Casado(a),15 - 24,2,2,0,16
Zacapa,Casado(a),25 - 44,75,58,17,16
Zacapa,Casado(a),45 - 64,159,87,72,16
Zacapa,Casado(a),65 y más,301,190,111,16
Zacapa,Casado(a),Ignorado,0,0,0,16
Zacapa,Unido(a),Todas las edades,4,3,1,16
Zacapa,Unido(a),Menos de 15 años,0,0,0,16
Zacapa,Unido(a),15 - 24,0,0,0,16
Zacapa,Unido(a),25 - 44,0,0,0,16
Zacapa,Unido(a),45 - 64,0,0,0,16
Zacapa,Unido(a),65 y más,4,3,1,16
Zacapa,Unido(a),Ignorado,0,0,0,16
Zacapa,Ignorado(a),Todas las edades,1,1,0,16
Zacapa,Ignorado(a),Menos de 15 años,0,0,0,16
Zacapa,Ignorado(a),15 - 24,0,0,0,16
Zacapa,Ignorado(a),25 - 44,0,0,0,16
Zacapa,Ignorado(a),45 - 64,1,1,0,16
Zacapa,Ignorado(a),65 y más,0,0,0,16
Zacapa,Ignorado(a),Ignorado,0,0,0,16
Chiquimula,Todos los estados civiles,Todas las edades,2022,1190,832,16
Chiquimula,Todos los estados civiles,Menos de 15 años,171,80,91,16
Chiquimula,Todos los estados civiles,15 - 24,138,100,38,16
Chiquimula,Todos los estados civiles,25 - 44,296,227,69,16
Chiquimula,Todos los estados civiles,45 - 64,388,218,170,16
Chiquimula,Todos los estados civiles,65 y más,1018,562,456,16
Chiquimula,Todos los estados civiles,Ignorado,11,3,8,16
Chiquimula,Soltero(a),Todas las edades,1373,770,603,16
Chiquimula,Soltero(a),Menos de 15 años,171,80,91,16
Chiquimula,Soltero(a),15 - 24,125,93,32,16
Chiquimula,Soltero(a),25 - 44,196,157,39,16
Chiquimula,Soltero(a),45 - 64,182,94,88,16
Chiquimula,Soltero(a),65 y más,691,345,346,16
Chiquimula,Soltero(a),Ignorado,8,1,7,16
Chiquimula,Casado(a),Todas las edades,630,403,227,16
Chiquimula,Casado(a),Menos de 15 años,0,0,0,16
Chiquimula,Casado(a),15 - 24,13,7,6,16
Chiquimula,Casado(a),25 - 44,98,68,30,16
Chiquimula,Casado(a),45 - 64,202,120,82,16
Chiquimula,Casado(a),65 y más,317,208,109,16
Chiquimula,Casado(a),Ignorado,0,0,0,16
Chiquimula,Unido(a),Todas las edades,14,13,1,16
Chiquimula,Unido(a),Menos de 15 años,0,0,0,16
Chiquimula,Unido(a),15 - 24,0,0,0,16
Chiquimula,Unido(a),25 - 44,2,2,0,16
Chiquimula,Unido(a),45 - 64,3,3,0,16
Chiquimula,Unido(a),65 y más,9,8,1,16
Chiquimula,Unido(a),Ignorado,0,0,0,16
Chiquimula,Ignorado(a),Todas las edades,5,4,1,16
Chiquimula,Ignorado(a),Menos de 15 años,0,0,0,16
Chiquimula,Ignorado(a),15 - 24,0,0,0,16
Chiquimula,Ignorado(a),25 - 44,0,0,0,16
Chiquimula,Ignorado(a),45 - 64,1,1,0,16
Chiquimula,Ignorado(a),65 y más,1,1,0,16
Chiquimula,Ignorado(a),Ignorado,3,2,1,16
Jalapa,Todos los estados civiles,Todas las edades,1767,993,774,16
Jalapa,Todos los estados civiles,Menos de 15 años,222,124,98,16
Jalapa,Todos los estados civiles,15 - 24,130,87,43,16
Jalapa,Todos los estados civiles,25 - 44,262,185,77,16
Jalapa,Todos los estados civiles,45 - 64,374,206,168,16
Jalapa,Todos los estados civiles,65 y más,778,391,387,16
Jalapa,Todos los estados civiles,Ignorado,1,0,1,16
Jalapa,Soltero(a),Todas las edades,1045,569,476,16
Jalapa,Soltero(a),Menos de 15 años,222,124,98,16
Jalapa,Soltero(a),15 - 24,124,83,41,16
Jalapa,Soltero(a),25 - 44,170,127,43,16
Jalapa,Soltero(a),45 - 64,124,66,58,16
Jalapa,Soltero(a),65 y más,404,169,235,16
Jalapa,Soltero(a),Ignorado,1,0,1,16
Jalapa,Casado(a),Todas las edades,716,421,295,16
Jalapa,Casado(a),Menos de 15 años,0,0,0,16
Jalapa,Casado(a),15 - 24,5,3,2,16
Jalapa,Casado(a),25 - 44,92,58,34,16
Jalapa,Casado(a),45 - 64,248,140,108,16
Jalapa,Casado(a),65 y más,371,220,151,16
Jalapa,Casado(a),Ignorado,0,0,0,16
Jalapa,Unido(a),Todas las edades,5,2,3,16
Jalapa,Unido(a),Menos de 15 años,0,0,0,16
Jalapa,Unido(a),15 - 24,0,0,0,16
Jalapa,Unido(a),25 - 44,0,0,0,16
Jalapa,Unido(a),45 - 64,2,0,2,16
Jalapa,Unido(a),65 y más,3,2,1,16
Jalapa,Unido(a),Ignorado,0,0,0,16
Jalapa,Ignorado(a),Todas las edades,1,1,0,16
Jalapa,Ignorado(a),Menos de 15 años,0,0,0,16
Jalapa,Ignorado(a),15 - 24,1,1,0,16
Jalapa,Ignorado(a),25 - 44,0,0,0,16
Jalapa,Ignorado(a),45 - 64,0,0,0,16
Jalapa,Ignorado(a),65 y más,0,0,0,16
Jalapa,Ignorado(a),Ignorado,0,0,0,16
Jutiapa,Todos los estados civiles,Todas las edades,2708,1582,1126,16
Jutiapa,Todos los estados civiles,Menos de 15 años,90,48,42,16
Jutiapa,Todos los estados civiles,15 - 24,163,126,37,16
Jutiapa,Todos los estados civiles,25 - 44,427,317,110,16
Jutiapa,Todos los estados civiles,45 - 64,614,348,266,16
Jutiapa,Todos los estados civiles,65 y más,1411,741,670,16
Jutiapa,Todos los estados civiles,Ignorado,3,2,1,16
Jutiapa,Soltero(a),Todas las edades,1775,987,788,16
Jutiapa,Soltero(a),Menos de 15 años,90,48,42,16
Jutiapa,Soltero(a),15 - 24,152,117,35,16
Jutiapa,Soltero(a),25 - 44,300,225,75,16
Jutiapa,Soltero(a),45 - 64,323,181,142,16
Jutiapa,Soltero(a),65 y más,908,415,493,16
Jutiapa,Soltero(a),Ignorado,2,1,1,16
Jutiapa,Casado(a),Todas las edades,912,584,328,16
Jutiapa,Casado(a),Menos de 15 años,0,0,0,16
Jutiapa,Casado(a),15 - 24,11,9,2,16
Jutiapa,Casado(a),25 - 44,126,91,35,16
Jutiapa,Casado(a),45 - 64,285,165,120,16
Jutiapa,Casado(a),65 y más,489,318,171,16
Jutiapa,Casado(a),Ignorado,1,1,0,16
Jutiapa,Unido(a),Todas las edades,19,10,9,16
Jutiapa,Unido(a),Menos de 15 años,0,0,0,16
Jutiapa,Unido(a),15 - 24,0,0,0,16
Jutiapa,Unido(a),25 - 44,1,1,0,16
Jutiapa,Unido(a),45 - 64,6,2,4,16
Jutiapa,Unido(a),65 y más,12,7,5,16
Jutiapa,Unido(a),Ignorado,0,0,0,16
Jutiapa,Ignorado(a),Todas las edades,2,1,1,16
Jutiapa,Ignorado(a),Menos de 15 años,0,0,0,16
Jutiapa,Ignorado(a),15 - 24,0,0,0,16
Jutiapa,Ignorado(a),25 - 44,0,0,0,16
Jutiapa,Ignorado(a),45 - 64,0,0,0,16
Jutiapa,Ignorado(a),65 y más,2,1,1,16
Jutiapa,Ignorado(a),Ignorado,0,0,0,16
Extranjero,Todos los estados civiles,Todas las edades,83,53,30,16
Extranjero,Todos los estados civiles,Menos de 15 años,7,4,3,16
Extranjero,Todos los estados civiles,15 - 24,6,5,1,16
Extranjero,Todos los estados civiles,25 - 44,31,24,7,16
Extranjero,Todos los estados civiles,45 - 64,19,8,11,16
Extranjero,Todos los estados civiles,65 y más,19,12,7,16
Extranjero,Todos los estados civiles,Ignorado,1,0,1,16
Extranjero,Soltero(a),Todas las edades,64,39,25,16
Extranjero,Soltero(a),Menos de 15 años,7,4,3,16
Extranjero,Soltero(a),15 - 24,6,5,1,16
Extranjero,Soltero(a),25 - 44,25,18,7,16
Extranjero,Soltero(a),45 - 64,14,5,9,16
Extranjero,Soltero(a),65 y más,12,7,5,16
Extranjero,Soltero(a),Ignorado,0,0,0,16
Extranjero,Casado(a),Todas las edades,10,8,2,16
Extranjero,Casado(a),Menos de 15 años,0,0,0,16
Extranjero,Casado(a),15 - 24,0,0,0,16
Extranjero,Casado(a),25 - 44,2,2,0,16
Extranjero,Casado(a),45 - 64,2,2,0,16
Extranjero,Casado(a),65 y más,6,4,2,16
Extranjero,Casado(a),Ignorado,0,0,0,16
Extranjero,Unido(a),Todas las edades,0,0,0,16
Extranjero,Unido(a),Menos de 15 años,0,0,0,16
Extranjero,Unido(a),15 - 24,0,0,0,16
Extranjero,Unido(a),25 - 44,0,0,0,16
Extranjero,Unido(a),45 - 64,0,0,0,16
Extranjero,Unido(a),65 y más,0,0,0,16
Extranjero,Unido(a),Ignorado,0,0,0,16
Extranjero,Ignorado(a),Todas las edades,9,6,3,16
Extranjero,Ignorado(a),Menos de 15 años,0,0,0,16
Extranjero,Ignorado(a),15 - 24,0,0,0,16
Extranjero,Ignorado(a),25 - 44,4,4,0,16
Extranjero,Ignorado(a),45 - 64,3,1,2,16
Extranjero,Ignorado(a),65 y más,1,1,0,16
Extranjero,Ignorado(a),Ignorado,1,0,1,16
Ignorado,Todos los estados civiles,Todas las edades,7811,4643,3168,16
Ignorado,Todos los estados civiles,Menos de 15 años,6016,3410,2606,16
Ignorado,Todos los estados civiles,15 - 24,820,575,245,16
Ignorado,Todos los estados civiles,25 - 44,222,179,43,16
Ignorado,Todos los estados civiles,45 - 64,200,151,49,16
Ignorado,Todos los estados civiles,65 y más,314,161,153,16
Ignorado,Todos los estados civiles,Ignorado,239,167,72,16
Ignorado,Todos los estados civiles,Todas las edades,7353,4299,3054,16
Ignorado,Soltero(a),Menos de 15 años,6008,3407,2601,16
Ignorado,Soltero(a),15 - 24,776,546,230,16
Ignorado,Soltero(a),25 - 44,132,107,25,16
Ignorado,Soltero(a),45 - 64,126,88,38,16
Ignorado,Soltero(a),65 y más,251,119,132,16
Ignorado,Soltero(a),Ignorado,60,32,28,16
Ignorado,Casado(a),Todas las edades,65,46,19,16
Ignorado,Casado(a),Menos de 15 años,0,0,0,16
Ignorado,Casado(a),15 - 24,6,6,0,16
Ignorado,Casado(a),25 - 44,12,10,2,16
Ignorado,Casado(a),45 - 64,19,14,5,16
Ignorado,Casado(a),65 y más,28,16,12,16
Ignorado,Casado(a),Ignorado,0,0,0,16
Ignorado,Unido(a),Todas las edades,1,1,0,16
Ignorado,Unido(a),Menos de 15 años,0,0,0,16
Ignorado,Unido(a),15 - 24,0,0,0,16
Ignorado,Unido(a),25 - 44,0,0,0,16
Ignorado,Unido(a),45 - 64,1,1,0,16
Ignorado,Unido(a),65 y más,0,0,0,16
Ignorado,Unido(a),Ignorado,0,0,0,16
Ignorado,Ignorado(a),Todas las edades,392,297,95,16
Ignorado,Ignorado(a),Menos de 15 años,8,3,5,16
Ignorado,Ignorado(a),15 - 24,38,23,15,16
Ignorado,Ignorado(a),25 - 44,78,62,16,16
Ignorado,Ignorado(a),45 - 64,54,48,6,16
Ignorado,Ignorado(a),65 y más,35,26,9,16
Ignorado,Ignorado(a),Ignorado,179,135,44,16
Todos los departamentos,Todos los estados civiles,Todas las edades,81726,45726,36000,17
Todos los departamentos,Todos los estados civiles,Menos de 15 años,11383,6399,4984,17
Todos los departamentos,Todos los estados civiles,15 - 24,5419,3973,1446,17
Todos los departamentos,Todos los estados civiles,25 - 44,11223,7781,3442,17
Todos los departamentos,Todos los estados civiles,45 - 64,16474,9005,7469,17
Todos los departamentos,Todos los estados civiles,65 y más,36875,18368,18507,17
Todos los departamentos,Todos los estados civiles,Ignorado,352,200,152,17
Todos los departamentos,Soltero(a),Todas las edades,52592,28586,24006,17
Todos los departamentos,Soltero(a),Menos de 15 años,11380,6398,4982,17
Todos los departamentos,Soltero(a),15 - 24,5053,3747,1306,17
Todos los departamentos,Soltero(a),25 - 44,6995,5013,1982,17
Todos los departamentos,Soltero(a),45 - 64,7400,3974,3426,17
Todos los departamentos,Soltero(a),65 y más,21633,9398,12235,17
Todos los departamentos,Soltero(a),Ignorado,131,56,75,17
Todos los departamentos,Casado(a),Todas las edades,27850,16375,11475,17
Todos los departamentos,Casado(a),Menos de 15 años,0,0,0,17
Todos los departamentos,Casado(a),15 - 24,323,194,129,17
Todos los departamentos,Casado(a),25 - 44,4066,2646,1420,17
Todos los departamentos,Casado(a),45 - 64,8782,4876,3906,17
Todos los departamentos,Casado(a),65 y más,14645,8646,5999,17
Todos los departamentos,Casado(a),Ignorado,34,13,21,17
Todos los departamentos,Unido(a),Todas las edades,781,411,370,17
Todos los departamentos,Unido(a),Menos de 15 años,0,0,0,17
Todos los departamentos,Unido(a),15 - 24,0,0,0,17
Todos los departamentos,Unido(a),25 - 44,42,27,15,17
Todos los departamentos,Unido(a),45 - 64,213,100,113,17
Todos los departamentos,Unido(a),65 y más,524,284,240,17
Todos los departamentos,Unido(a),Ignorado,2,0,2,17
Todos los departamentos,Ignorado(a),Todas las edades,503,354,149,17
Todos los departamentos,Ignorado(a),Menos de 15 años,3,1,2,17
Todos los departamentos,Ignorado(a),15 - 24,43,32,11,17
Todos los departamentos,Ignorado(a),25 - 44,120,95,25,17
Todos los departamentos,Ignorado(a),45 - 64,79,55,24,17
Todos los departamentos,Ignorado(a),65 y más,73,40,33,17
Todos los departamentos,Ignorado(a),Ignorado,185,131,54,17
Guatemala,Todos los estados civiles,Todas las edades,18182,10129,8053,17
Guatemala,Todos los estados civiles,Menos de 15 años,1010,569,441,17
Guatemala,Todos los estados civiles,15 - 24,1290,1002,288,17
Guatemala,Todos los estados civiles,25 - 44,2778,2013,765,17
Guatemala,Todos los estados civiles,45 - 64,4112,2341,1771,17
Guatemala,Todos los estados civiles,65 y más,8962,4192,4770,17
Guatemala,Todos los estados civiles,Ignorado,30,12,18,17
Guatemala,Soltero(a),Todas las edades,11092,5979,5113,17
Guatemala,Soltero(a),Menos de 15 años,1010,569,441,17
Guatemala,Soltero(a),15 - 24,1223,953,270,17
Guatemala,Soltero(a),25 - 44,1832,1368,464,17
Guatemala,Soltero(a),45 - 64,2034,1121,913,17
Guatemala,Soltero(a),65 y más,4979,1963,3016,17
Guatemala,Soltero(a),Ignorado,14,5,9,17
Guatemala,Casado(a),Todas las edades,6964,4087,2877,17
Guatemala,Casado(a),Menos de 15 años,0,0,0,17
Guatemala,Casado(a),15 - 24,63,46,17,17
Guatemala,Casado(a),25 - 44,920,627,293,17
Guatemala,Casado(a),45 - 64,2050,1205,845,17
Guatemala,Casado(a),65 y más,3930,2209,1721,17
Guatemala,Casado(a),Ignorado,1,0,1,17
Guatemala,Unido(a),Todas las edades,38,15,23,17
Guatemala,Unido(a),Menos de 15 años,0,0,0,17
Guatemala,Unido(a),15 - 24,0,0,0,17
Guatemala,Unido(a),25 - 44,4,4,0,17
Guatemala,Unido(a),45 - 64,5,2,3,17
Guatemala,Unido(a),65 y más,29,9,20,17
Guatemala,Unido(a),Ignorado,0,0,0,17
Guatemala,Ignorado(a),Todas las edades,88,48,40,17
Guatemala,Ignorado(a),Menos de 15 años,0,0,0,17
Guatemala,Ignorado(a),15 - 24,4,3,1,17
Guatemala,Ignorado(a),25 - 44,22,14,8,17
Guatemala,Ignorado(a),45 - 64,23,13,10,17
Guatemala,Ignorado(a),65 y más,24,11,13,17
Guatemala,Ignorado(a),Ignorado,15,7,8,17
El Progreso,Todos los estados civiles,Todas las edades,1079,596,483,17
El Progreso,Todos los estados civiles,Menos de 15 años,74,39,35,17
El Progreso,Todos los estados civiles,15 - 24,50,36,14,17
El Progreso,Todos los estados civiles,25 - 44,131,81,50,17
El Progreso,Todos los estados civiles,45 - 64,226,130,96,17
El Progreso,Todos los estados civiles,65 y más,597,309,288,17
El Progreso,Todos los estados civiles,Ignorado,1,1,0,17
El Progreso,Soltero(a),Todas las edades,692,375,317,17
El Progreso,Soltero(a),Menos de 15 años,74,39,35,17
El Progreso,Soltero(a),15 - 24,50,36,14,17
El Progreso,Soltero(a),25 - 44,88,60,28,17
El Progreso,Soltero(a),45 - 64,112,66,46,17
El Progreso,Soltero(a),65 y más,367,173,194,17
El Progreso,Soltero(a),Ignorado,1,1,0,17
El Progreso,Casado(a),Todas las edades,377,216,161,17
El Progreso,Casado(a),Menos de 15 años,0,0,0,17
El Progreso,Casado(a),15 - 24,0,0,0,17
El Progreso,Casado(a),25 - 44,43,21,22,17
El Progreso,Casado(a),45 - 64,112,64,48,17
El Progreso,Casado(a),65 y más,222,131,91,17
El Progreso,Casado(a),Ignorado,0,0,0,17
El Progreso,Unido(a),Todas las edades,10,5,5,17
El Progreso,Unido(a),Menos de 15 años,0,0,0,17
El Progreso,Unido(a),15 - 24,0,0,0,17
El Progreso,Unido(a),25 - 44,0,0,0,17
El Progreso,Unido(a),45 - 64,2,0,2,17
El Progreso,Unido(a),65 y más,8,5,3,17
El Progreso,Unido(a),Ignorado,0,0,0,17
El Progreso,Ignorado(a),Todas las edades,0,0,0,17
El Progreso,Ignorado(a),Menos de 15 años,0,0,0,17
El Progreso,Ignorado(a),15 - 24,0,0,0,17
El Progreso,Ignorado(a),25 - 44,0,0,0,17
El Progreso,Ignorado(a),45 - 64,0,0,0,17
El Progreso,Ignorado(a),65 y más,0,0,0,17
El Progreso,Ignorado(a),Ignorado,0,0,0,17
Sacatepéquez,Todos los estados civiles,Todas las edades,1652,901,751,17
Sacatepéquez,Todos los estados civiles,Menos de 15 años,69,41,28,17
Sacatepéquez,Todos los estados civiles,15 - 24,62,49,13,17
Sacatepéquez,Todos los estados civiles,25 - 44,217,157,60,17
Sacatepéquez,Todos los estados civiles,45 - 64,401,208,193,17
Sacatepéquez,Todos los estados civiles,65 y más,896,441,455,17
Sacatepéquez,Todos los estados civiles,Ignorado,7,5,2,17
Sacatepéquez,Soltero(a),Todas las edades,825,429,396,17
Sacatepéquez,Soltero(a),Menos de 15 años,69,41,28,17
Sacatepéquez,Soltero(a),15 - 24,59,47,12,17
Sacatepéquez,Soltero(a),25 - 44,119,89,30,17
Sacatepéquez,Soltero(a),45 - 64,137,70,67,17
Sacatepéquez,Soltero(a),65 y más,441,182,259,17
Sacatepéquez,Soltero(a),Ignorado,0,0,0,17
Sacatepéquez,Casado(a),Todas las edades,807,460,347,17
Sacatepéquez,Casado(a),Menos de 15 años,0,0,0,17
Sacatepéquez,Casado(a),15 - 24,3,2,1,17
Sacatepéquez,Casado(a),25 - 44,98,68,30,17
Sacatepéquez,Casado(a),45 - 64,262,136,126,17
Sacatepéquez,Casado(a),65 y más,444,254,190,17
Sacatepéquez,Casado(a),Ignorado,0,0,0,17
Sacatepéquez,Unido(a),Todas las edades,11,7,4,17
Sacatepéquez,Unido(a),Menos de 15 años,0,0,0,17
Sacatepéquez,Unido(a),15 - 24,0,0,0,17
Sacatepéquez,Unido(a),25 - 44,0,0,0,17
Sacatepéquez,Unido(a),45 - 64,2,2,0,17
Sacatepéquez,Unido(a),65 y más,9,5,4,17
Sacatepéquez,Unido(a),Ignorado,0,0,0,17
Sacatepéquez,Ignorado(a),Todas las edades,9,5,4,17
Sacatepéquez,Ignorado(a),Menos de 15 años,0,0,0,17
Sacatepéquez,Ignorado(a),15 - 24,0,0,0,17
Sacatepéquez,Ignorado(a),25 - 44,0,0,0,17
Sacatepéquez,Ignorado(a),45 - 64,0,0,0,17
Sacatepéquez,Ignorado(a),65 y más,2,0,2,17
Sacatepéquez,Ignorado(a),Ignorado,7,5,2,17
Chimaltenango,Todos los estados civiles,Todas las edades,2893,1557,1336,17
Chimaltenango,Todos los estados civiles,Menos de 15 años,339,185,154,17
Chimaltenango,Todos los estados civiles,15 - 24,166,118,48,17
Chimaltenango,Todos los estados civiles,25 - 44,430,286,144,17
Chimaltenango,Todos los estados civiles,45 - 64,610,330,280,17
Chimaltenango,Todos los estados civiles,65 y más,1343,635,708,17
Chimaltenango,Todos los estados civiles,Ignorado,5,3,2,17
Chimaltenango,Soltero(a),Todas las edades,1508,778,730,17
Chimaltenango,Soltero(a),Menos de 15 años,339,185,154,17
Chimaltenango,Soltero(a),15 - 24,144,105,39,17
Chimaltenango,Soltero(a),25 - 44,215,155,60,17
Chimaltenango,Soltero(a),45 - 64,175,89,86,17
Chimaltenango,Soltero(a),65 y más,632,243,389,17
Chimaltenango,Soltero(a),Ignorado,3,1,2,17
Chimaltenango,Casado(a),Todas las edades,1372,771,601,17
Chimaltenango,Casado(a),Menos de 15 años,0,0,0,17
Chimaltenango,Casado(a),15 - 24,22,13,9,17
Chimaltenango,Casado(a),25 - 44,215,131,84,17
Chimaltenango,Casado(a),45 - 64,435,241,194,17
Chimaltenango,Casado(a),65 y más,698,384,314,17
Chimaltenango,Casado(a),Ignorado,2,2,0,17
Chimaltenango,Unido(a),Todas las edades,13,8,5,17
Chimaltenango,Unido(a),Menos de 15 años,0,0,0,17
Chimaltenango,Unido(a),15 - 24,0,0,0,17
Chimaltenango,Unido(a),25 - 44,0,0,0,17
Chimaltenango,Unido(a),45 - 64,0,0,0,17
Chimaltenango,Unido(a),65 y más,13,8,5,17
Chimaltenango,Unido(a),Ignorado,0,0,0,17
Chimaltenango,Ignorado(a),Todas las edades,0,0,0,17
Chimaltenango,Ignorado(a),Menos de 15 años,0,0,0,17
Chimaltenango,Ignorado(a),15 - 24,0,0,0,17
Chimaltenango,Ignorado(a),25 - 44,0,0,0,17
Chimaltenango,Ignorado(a),45 - 64,0,0,0,17
Chimaltenango,Ignorado(a),65 y más,0,0,0,17
Chimaltenango,Ignorado(a),Ignorado,0,0,0,17
Escuintla,Todos los estados civiles,Todas las edades,4278,2481,1797,17
Escuintla,Todos los estados civiles,Menos de 15 años,154,94,60,17
Escuintla,Todos los estados civiles,15 - 24,296,234,62,17
Escuintla,Todos los estados civiles,25 - 44,716,510,206,17
Escuintla,Todos los estados civiles,45 - 64,1099,571,528,17
Escuintla,Todos los estados civiles,65 y más,2004,1064,940,17
Escuintla,Todos los estados civiles,Ignorado,9,8,1,17
Escuintla,Soltero(a),Todas las edades,2785,1581,1204,17
Escuintla,Soltero(a),Menos de 15 años,153,94,59,17
Escuintla,Soltero(a),15 - 24,273,218,55,17
Escuintla,Soltero(a),25 - 44,500,362,138,17
Escuintla,Soltero(a),45 - 64,586,294,292,17
Escuintla,Soltero(a),65 y más,1272,612,660,17
Escuintla,Soltero(a),Ignorado,1,1,0,17
Escuintla,Casado(a),Todas las edades,1468,888,580,17
Escuintla,Casado(a),Menos de 15 años,0,0,0,17
Escuintla,Casado(a),15 - 24,23,16,7,17
Escuintla,Casado(a),25 - 44,213,146,67,17
Escuintla,Casado(a),45 - 64,510,275,235,17
Escuintla,Casado(a),65 y más,722,451,271,17
Escuintla,Casado(a),Ignorado,0,0,0,17
Escuintla,Unido(a),Todas las edades,11,2,9,17
Escuintla,Unido(a),Menos de 15 años,0,0,0,17
Escuintla,Unido(a),15 - 24,0,0,0,17
Escuintla,Unido(a),25 - 44,2,1,1,17
Escuintla,Unido(a),45 - 64,2,1,1,17
Escuintla,Unido(a),65 y más,7,0,7,17
Escuintla,Unido(a),Ignorado,0,0,0,17
Escuintla,Ignorado(a),Todas las edades,14,10,4,17
Escuintla,Ignorado(a),Menos de 15 años,1,0,1,17
Escuintla,Ignorado(a),15 - 24,0,0,0,17
Escuintla,Ignorado(a),25 - 44,1,1,0,17
Escuintla,Ignorado(a),45 - 64,1,1,0,17
Escuintla,Ignorado(a),65 y más,3,1,2,17
Escuintla,Ignorado(a),Ignorado,8,7,1,17
Santa Rosa,Todos los estados civiles,Todas las edades,2206,1277,929,17
Santa Rosa,Todos los estados civiles,Menos de 15 años,39,26,13,17
Santa Rosa,Todos los estados civiles,15 - 24,129,107,22,17
Santa Rosa,Todos los estados civiles,25 - 44,325,236,89,17
Santa Rosa,Todos los estados civiles,45 - 64,498,265,233,17
Santa Rosa,Todos los estados civiles,65 y más,1214,642,572,17
Santa Rosa,Todos los estados civiles,Ignorado,1,1,0,17
Santa Rosa,Soltero(a),Todas las edades,1375,792,583,17
Santa Rosa,Soltero(a),Menos de 15 años,39,26,13,17
Santa Rosa,Soltero(a),15 - 24,119,102,17,17
Santa Rosa,Soltero(a),25 - 44,221,170,51,17
Santa Rosa,Soltero(a),45 - 64,242,129,113,17
Santa Rosa,Soltero(a),65 y más,754,365,389,17
Santa Rosa,Soltero(a),Ignorado,0,0,0,17
Santa Rosa,Casado(a),Todas las edades,798,467,331,17
Santa Rosa,Casado(a),Menos de 15 años,0,0,0,17
Santa Rosa,Casado(a),15 - 24,10,5,5,17
Santa Rosa,Casado(a),25 - 44,103,65,38,17
Santa Rosa,Casado(a),45 - 64,249,135,114,17
Santa Rosa,Casado(a),65 y más,436,262,174,17
Santa Rosa,Casado(a),Ignorado,0,0,0,17
Santa Rosa,Unido(a),Todas las edades,32,17,15,17
Santa Rosa,Unido(a),Menos de 15 años,0,0,0,17
Santa Rosa,Unido(a),15 - 24,0,0,0,17
Santa Rosa,Unido(a),25 - 44,1,1,0,17
Santa Rosa,Unido(a),45 - 64,7,1,6,17
Santa Rosa,Unido(a),65 y más,24,15,9,17
Santa Rosa,Unido(a),Ignorado,0,0,0,17
Santa Rosa,Ignorado(a),Todas las edades,1,1,0,17
Santa Rosa,Ignorado(a),Menos de 15 años,0,0,0,17
Santa Rosa,Ignorado(a),15 - 24,0,0,0,17
Santa Rosa,Ignorado(a),25 - 44,0,0,0,17
Santa Rosa,Ignorado(a),45 - 64,0,0,0,17
Santa Rosa,Ignorado(a),65 y más,0,0,0,17
Santa Rosa,Ignorado(a),Ignorado,1,1,0,17
Sololá,Todos los estados civiles,Todas las edades,1837,980,857,17
Sololá,Todos los estados civiles,Menos de 15 años,175,85,90,17
Sololá,Todos los estados civiles,15 - 24,85,59,26,17
Sololá,Todos los estados civiles,25 - 44,259,171,88,17
Sololá,Todos los estados civiles,45 - 64,417,223,194,17
Sololá,Todos los estados civiles,65 y más,895,439,456,17
Sololá,Todos los estados civiles,Ignorado,6,3,3,17
Sololá,Soltero(a),Todas las edades,1165,592,573,17
Sololá,Soltero(a),Menos de 15 años,175,85,90,17
Sololá,Soltero(a),15 - 24,82,58,24,17
Sololá,Soltero(a),25 - 44,155,107,48,17
Sololá,Soltero(a),45 - 64,191,96,95,17
Sololá,Soltero(a),65 y más,558,244,314,17
Sololá,Soltero(a),Ignorado,4,2,2,17
Sololá,Casado(a),Todas las edades,570,328,242,17
Sololá,Casado(a),Menos de 15 años,0,0,0,17
Sololá,Casado(a),15 - 24,3,1,2,17
Sololá,Casado(a),25 - 44,103,63,40,17
Sololá,Casado(a),45 - 64,201,110,91,17
Sololá,Casado(a),65 y más,263,154,109,17
Sololá,Casado(a),Ignorado,0,0,0,17
Sololá,Unido(a),Todas las edades,98,57,41,17
Sololá,Unido(a),Menos de 15 años,0,0,0,17
Sololá,Unido(a),15 - 24,0,0,0,17
Sololá,Unido(a),25 - 44,1,1,0,17
Sololá,Unido(a),45 - 64,23,15,8,17
Sololá,Unido(a),65 y más,74,41,33,17
Sololá,Unido(a),Ignorado,0,0,0,17
Sololá,Ignorado(a),Todas las edades,4,3,1,17
Sololá,Ignorado(a),Menos de 15 años,0,0,0,17
Sololá,Ignorado(a),15 - 24,0,0,0,17
Sololá,Ignorado(a),25 - 44,0,0,0,17
Sololá,Ignorado(a),45 - 64,2,2,0,17
Sololá,Ignorado(a),65 y más,0,0,0,17
Sololá,Ignorado(a),Ignorado,2,1,1,17
Totonicapán,Todos los estados civiles,Todas las edades,2420,1325,1095,17
Totonicapán,Todos los estados civiles,Menos de 15 años,292,162,130,17
Totonicapán,Todos los estados civiles,15 - 24,119,67,52,17
Totonicapán,Todos los estados civiles,25 - 44,363,238,125,17
Totonicapán,Todos los estados civiles,45 - 64,533,331,202,17
Totonicapán,Todos los estados civiles,65 y más,1101,525,576,17
Totonicapán,Todos los estados civiles,Ignorado,12,2,10,17
Totonicapán,Soltero(a),Todas las edades,1404,676,728,17
Totonicapán,Soltero(a),Menos de 15 años,292,162,130,17
Totonicapán,Soltero(a),15 - 24,101,60,41,17
Totonicapán,Soltero(a),25 - 44,196,129,67,17
Totonicapán,Soltero(a),45 - 64,195,107,88,17
Totonicapán,Soltero(a),65 y más,615,218,397,17
Totonicapán,Soltero(a),Ignorado,5,0,5,17
Totonicapán,Casado(a),Todas las edades,940,609,331,17
Totonicapán,Casado(a),Menos de 15 años,0,0,0,17
Totonicapán,Casado(a),15 - 24,18,7,11,17
Totonicapán,Casado(a),25 - 44,167,109,58,17
Totonicapán,Casado(a),45 - 64,323,213,110,17
Totonicapán,Casado(a),65 y más,428,278,150,17
Totonicapán,Casado(a),Ignorado,4,2,2,17
Totonicapán,Unido(a),Todas las edades,72,39,33,17
Totonicapán,Unido(a),Menos de 15 años,0,0,0,17
Totonicapán,Unido(a),15 - 24,0,0,0,17
Totonicapán,Unido(a),25 - 44,0,0,0,17
Totonicapán,Unido(a),45 - 64,15,11,4,17
Totonicapán,Unido(a),65 y más,57,28,29,17
Totonicapán,Unido(a),Ignorado,0,0,0,17
Totonicapán,Ignorado(a),Todas las edades,4,1,3,17
Totonicapán,Ignorado(a),Menos de 15 años,0,0,0,17
Totonicapán,Ignorado(a),15 - 24,0,0,0,17
Totonicapán,Ignorado(a),25 - 44,0,0,0,17
Totonicapán,Ignorado(a),45 - 64,0,0,0,17
Totonicapán,Ignorado(a),65 y más,1,1,0,17
Totonicapán,Ignorado(a),Ignorado,3,0,3,17
Quetzaltenango,Todos los estados civiles,Todas las edades,4362,2375,1987,17
Quetzaltenango,Todos los estados civiles,Menos de 15 años,506,278,228,17
Quetzaltenango,Todos los estados civiles,15 - 24,218,160,58,17
Quetzaltenango,Todos los estados civiles,25 - 44,533,372,161,17
Quetzaltenango,Todos los estados civiles,45 - 64,893,495,398,17
Quetzaltenango,Todos los estados civiles,65 y más,2193,1063,1130,17
Quetzaltenango,Todos los estados civiles,Ignorado,19,7,12,17
Quetzaltenango,Soltero(a),Todas las edades,2648,1375,1273,17
Quetzaltenango,Soltero(a),Menos de 15 años,506,278,228,17
Quetzaltenango,Soltero(a),15 - 24,200,145,55,17
Quetzaltenango,Soltero(a),25 - 44,317,221,96,17
Quetzaltenango,Soltero(a),45 - 64,369,205,164,17
Quetzaltenango,Soltero(a),65 y más,1242,522,720,17
Quetzaltenango,Soltero(a),Ignorado,14,4,10,17
Quetzaltenango,Casado(a),Todas las edades,1630,955,675,17
Quetzaltenango,Casado(a),Menos de 15 años,0,0,0,17
Quetzaltenango,Casado(a),15 - 24,18,15,3,17
Quetzaltenango,Casado(a),25 - 44,213,149,64,17
Quetzaltenango,Casado(a),45 - 64,496,277,219,17
Quetzaltenango,Casado(a),65 y más,900,512,388,17
Quetzaltenango,Casado(a),Ignorado,3,2,1,17
Quetzaltenango,Unido(a),Todas las edades,79,41,38,17
Quetzaltenango,Unido(a),Menos de 15 años,0,0,0,17
Quetzaltenango,Unido(a),15 - 24,0,0,0,17
Quetzaltenango,Unido(a),25 - 44,3,2,1,17
Quetzaltenango,Unido(a),45 - 64,26,11,15,17
Quetzaltenango,Unido(a),65 y más,50,28,22,17
Quetzaltenango,Unido(a),Ignorado,0,0,0,17
Quetzaltenango,Ignorado(a),Todas las edades,5,4,1,17
Quetzaltenango,Ignorado(a),Menos de 15 años,0,0,0,17
Quetzaltenango,Ignorado(a),15 - 24,0,0,0,17
Quetzaltenango,Ignorado(a),25 - 44,0,0,0,17
Quetzaltenango,Ignorado(a),45 - 64,2,2,0,17
Quetzaltenango,Ignorado(a),65 y más,1,1,0,17
Quetzaltenango,Ignorado(a),Ignorado,2,1,1,17
Suchitepéquez,Todos los estados civiles,Todas las edades,2927,1633,1294,17
Suchitepéquez,Todos los estados civiles,Menos de 15 años,165,86,79,17
Suchitepéquez,Todos los estados civiles,15 - 24,160,120,40,17
Suchitepéquez,Todos los estados civiles,25 - 44,423,276,147,17
Suchitepéquez,Todos los estados civiles,45 - 64,698,372,326,17
Suchitepéquez,Todos los estados civiles,65 y más,1464,771,693,17
Suchitepéquez,Todos los estados civiles,Ignorado,17,8,9,17
Suchitepéquez,Soltero(a),Todas las edades,1678,901,777,17
Suchitepéquez,Soltero(a),Menos de 15 años,165,86,79,17
Suchitepéquez,Soltero(a),15 - 24,142,109,33,17
Suchitepéquez,Soltero(a),25 - 44,235,166,69,17
Suchitepéquez,Soltero(a),45 - 64,290,147,143,17
Suchitepéquez,Soltero(a),65 y más,841,390,451,17
Suchitepéquez,Soltero(a),Ignorado,5,3,2,17
Suchitepéquez,Casado(a),Todas las edades,1234,724,510,17
Suchitepéquez,Casado(a),Menos de 15 años,0,0,0,17
Suchitepéquez,Casado(a),15 - 24,18,11,7,17
Suchitepéquez,Casado(a),25 - 44,186,108,78,17
Suchitepéquez,Casado(a),45 - 64,406,224,182,17
Suchitepéquez,Casado(a),65 y más,617,378,239,17
Suchitepéquez,Casado(a),Ignorado,7,3,4,17
Suchitepéquez,Unido(a),Todas las edades,9,5,4,17
Suchitepéquez,Unido(a),Menos de 15 años,0,0,0,17
Suchitepéquez,Unido(a),15 - 24,0,0,0,17
Suchitepéquez,Unido(a),25 - 44,1,1,0,17
Suchitepéquez,Unido(a),45 - 64,2,1,1,17
Suchitepéquez,Unido(a),65 y más,6,3,3,17
Suchitepéquez,Unido(a),Ignorado,0,0,0,17
Suchitepéquez,Ignorado(a),Todas las edades,6,3,3,17
Suchitepéquez,Ignorado(a),Menos de 15 años,0,0,0,17
Suchitepéquez,Ignorado(a),15 - 24,0,0,0,17
Suchitepéquez,Ignorado(a),25 - 44,1,1,0,17
Suchitepéquez,Ignorado(a),45 - 64,0,0,0,17
Suchitepéquez,Ignorado(a),65 y más,0,0,0,17
Suchitepéquez,Ignorado(a),Ignorado,5,2,3,17
Retalhuleu,Todos los estados civiles,Todas las edades,1837,1038,799,17
Retalhuleu,Todos los estados civiles,Menos de 15 años,130,77,53,17
Retalhuleu,Todos los estados civiles,15 - 24,90,75,15,17
Retalhuleu,Todos los estados civiles,25 - 44,283,200,83,17
Retalhuleu,Todos los estados civiles,45 - 64,445,234,211,17
Retalhuleu,Todos los estados civiles,65 y más,884,449,435,17
Retalhuleu,Todos los estados civiles,Ignorado,5,3,2,17
Retalhuleu,Soltero(a),Todas las edades,1080,598,482,17
Retalhuleu,Soltero(a),Menos de 15 años,130,77,53,17
Retalhuleu,Soltero(a),15 - 24,86,72,14,17
Retalhuleu,Soltero(a),25 - 44,164,120,44,17
Retalhuleu,Soltero(a),45 - 64,184,99,85,17
Retalhuleu,Soltero(a),65 y más,513,228,285,17
Retalhuleu,Soltero(a),Ignorado,3,2,1,17
Retalhuleu,Casado(a),Todas las edades,709,411,298,17
Retalhuleu,Casado(a),Menos de 15 años,0,0,0,17
Retalhuleu,Casado(a),15 - 24,4,3,1,17
Retalhuleu,Casado(a),25 - 44,119,80,39,17
Retalhuleu,Casado(a),45 - 64,250,130,120,17
Retalhuleu,Casado(a),65 y más,335,198,137,17
Retalhuleu,Casado(a),Ignorado,1,0,1,17
Retalhuleu,Unido(a),Todas las edades,47,28,19,17
Retalhuleu,Unido(a),Menos de 15 años,0,0,0,17
Retalhuleu,Unido(a),15 - 24,0,0,0,17
Retalhuleu,Unido(a),25 - 44,0,0,0,17
Retalhuleu,Unido(a),45 - 64,11,5,6,17
Retalhuleu,Unido(a),65 y más,36,23,13,17
Retalhuleu,Unido(a),Ignorado,0,0,0,17
Retalhuleu,Ignorado(a),Todas las edades,1,1,0,17
Retalhuleu,Ignorado(a),Menos de 15 años,0,0,0,17
Retalhuleu,Ignorado(a),15 - 24,0,0,0,17
Retalhuleu,Ignorado(a),25 - 44,0,0,0,17
Retalhuleu,Ignorado(a),45 - 64,0,0,0,17
Retalhuleu,Ignorado(a),65 y más,0,0,0,17
Retalhuleu,Ignorado(a),Ignorado,1,1,0,17
San Marcos,Todos los estados civiles,Todas las edades,4853,2755,2098,17
San Marcos,Todos los estados civiles,Menos de 15 años,512,290,222,17
San Marcos,Todos los estados civiles,15 - 24,225,158,67,17
San Marcos,Todos los estados civiles,25 - 44,713,480,233,17
San Marcos,Todos los estados civiles,45 - 64,989,572,417,17
San Marcos,Todos los estados civiles,65 y más,2406,1249,1157,17
San Marcos,Todos los estados civiles,Ignorado,8,6,2,17
San Marcos,Soltero(a),Todas las edades,3069,1711,1358,17
San Marcos,Soltero(a),Menos de 15 años,512,290,222,17
San Marcos,Soltero(a),15 - 24,207,144,63,17
San Marcos,Soltero(a),25 - 44,453,310,143,17
San Marcos,Soltero(a),45 - 64,450,274,176,17
San Marcos,Soltero(a),65 y más,1443,689,754,17
San Marcos,Soltero(a),Ignorado,4,4,0,17
San Marcos,Casado(a),Todas las edades,1707,1003,704,17
San Marcos,Casado(a),Menos de 15 años,0,0,0,17
San Marcos,Casado(a),15 - 24,18,14,4,17
San Marcos,Casado(a),25 - 44,255,169,86,17
San Marcos,Casado(a),45 - 64,511,282,229,17
San Marcos,Casado(a),65 y más,920,537,383,17
San Marcos,Casado(a),Ignorado,3,1,2,17
San Marcos,Unido(a),Todas las edades,76,40,36,17
San Marcos,Unido(a),Menos de 15 años,0,0,0,17
San Marcos,Unido(a),15 - 24,0,0,0,17
San Marcos,Unido(a),25 - 44,5,1,4,17
San Marcos,Unido(a),45 - 64,28,16,12,17
San Marcos,Unido(a),65 y más,43,23,20,17
San Marcos,Unido(a),Ignorado,0,0,0,17
San Marcos,Ignorado(a),Todas las edades,1,1,0,17
San Marcos,Ignorado(a),Menos de 15 años,0,0,0,17
San Marcos,Ignorado(a),15 - 24,0,0,0,17
San Marcos,Ignorado(a),25 - 44,0,0,0,17
San Marcos,Ignorado(a),45 - 64,0,0,0,17
San Marcos,Ignorado(a),65 y más,0,0,0,17
San Marcos,Ignorado(a),Ignorado,1,1,0,17
Huehuetenango,Todos los estados civiles,Todas las edades,4554,2548,2006,17
Huehuetenango,Todos los estados civiles,Menos de 15 años,650,362,288,17
Huehuetenango,Todos los estados civiles,15 - 24,251,157,94,17
Huehuetenango,Todos los estados civiles,25 - 44,631,381,250,17
Huehuetenango,Todos los estados civiles,45 - 64,867,464,403,17
Huehuetenango,Todos los estados civiles,65 y más,2150,1182,968,17
Huehuetenango,Todos los estados civiles,Ignorado,5,2,3,17
Huehuetenango,Soltero(a),Todas las edades,3091,1681,1410,17
Huehuetenango,Soltero(a),Menos de 15 años,648,361,287,17
Huehuetenango,Soltero(a),15 - 24,230,149,81,17
Huehuetenango,Soltero(a),25 - 44,412,254,158,17
Huehuetenango,Soltero(a),45 - 64,398,205,193,17
Huehuetenango,Soltero(a),65 y más,1399,710,689,17
Huehuetenango,Soltero(a),Ignorado,4,2,2,17
Huehuetenango,Casado(a),Todas las edades,1449,860,589,17
Huehuetenango,Casado(a),Menos de 15 años,0,0,0,17
Huehuetenango,Casado(a),15 - 24,21,8,13,17
Huehuetenango,Casado(a),25 - 44,218,126,92,17
Huehuetenango,Casado(a),45 - 64,469,259,210,17
Huehuetenango,Casado(a),65 y más,740,467,273,17
Huehuetenango,Casado(a),Ignorado,1,0,1,17
Huehuetenango,Unido(a),Todas las edades,12,6,6,17
Huehuetenango,Unido(a),Menos de 15 años,0,0,0,17
Huehuetenango,Unido(a),15 - 24,0,0,0,17
Huehuetenango,Unido(a),25 - 44,1,1,0,17
Huehuetenango,Unido(a),45 - 64,0,0,0,17
Huehuetenango,Unido(a),65 y más,11,5,6,17
Huehuetenango,Unido(a),Ignorado,0,0,0,17
Huehuetenango,Ignorado(a),Todas las edades,2,1,1,17
Huehuetenango,Ignorado(a),Menos de 15 años,2,1,1,17
Huehuetenango,Ignorado(a),15 - 24,0,0,0,17
Huehuetenango,Ignorado(a),25 - 44,0,0,0,17
Huehuetenango,Ignorado(a),45 - 64,0,0,0,17
Huehuetenango,Ignorado(a),65 y más,0,0,0,17
Huehuetenango,Ignorado(a),Ignorado,0,0,0,17
Quiché,Todos los estados civiles,Todas las edades,3841,2078,1763,17
Quiché,Todos los estados civiles,Menos de 15 años,526,300,226,17
Quiché,Todos los estados civiles,15 - 24,233,159,74,17
Quiché,Todos los estados civiles,25 - 44,582,398,184,17
Quiché,Todos los estados civiles,45 - 64,762,391,371,17
Quiché,Todos los estados civiles,65 y más,1727,826,901,17
Quiché,Todos los estados civiles,Ignorado,11,4,7,17
Quiché,Soltero(a),Todas las edades,2617,1363,1254,17
Quiché,Soltero(a),Menos de 15 años,526,300,226,17
Quiché,Soltero(a),15 - 24,206,146,60,17
Quiché,Soltero(a),25 - 44,351,244,107,17
Quiché,Soltero(a),45 - 64,353,177,176,17
Quiché,Soltero(a),65 y más,1172,493,679,17
Quiché,Soltero(a),Ignorado,9,3,6,17
Quiché,Casado(a),Todas las edades,1202,704,498,17
Quiché,Casado(a),Menos de 15 años,0,0,0,17
Quiché,Casado(a),15 - 24,27,13,14,17
Quiché,Casado(a),25 - 44,231,154,77,17
Quiché,Casado(a),45 - 64,408,214,194,17
Quiché,Casado(a),65 y más,535,322,213,17
Quiché,Casado(a),Ignorado,1,1,0,17
Quiché,Unido(a),Todas las edades,18,11,7,17
Quiché,Unido(a),Menos de 15 años,0,0,0,17
Quiché,Unido(a),15 - 24,0,0,0,17
Quiché,Unido(a),25 - 44,0,0,0,17
Quiché,Unido(a),45 - 64,1,0,1,17
Quiché,Unido(a),65 y más,17,11,6,17
Quiché,Unido(a),Ignorado,0,0,0,17
Quiché,Ignorado(a),Todas las edades,4,0,4,17
Quiché,Ignorado(a),Menos de 15 años,0,0,0,17
Quiché,Ignorado(a),15 - 24,0,0,0,17
Quiché,Ignorado(a),25 - 44,0,0,0,17
Quiché,Ignorado(a),45 - 64,0,0,0,17
Quiché,Ignorado(a),65 y más,3,0,3,17
Quiché,Ignorado(a),Ignorado,1,0,1,17
Baja Verapaz,Todos los estados civiles,Todas las edades,1352,729,623,17
Baja Verapaz,Todos los estados civiles,Menos de 15 años,181,99,82,17
Baja Verapaz,Todos los estados civiles,15 - 24,75,46,29,17
Baja Verapaz,Todos los estados civiles,25 - 44,150,101,49,17
Baja Verapaz,Todos los estados civiles,45 - 64,261,138,123,17
Baja Verapaz,Todos los estados civiles,65 y más,679,345,334,17
Baja Verapaz,Todos los estados civiles,Ignorado,6,0,6,17
Baja Verapaz,Soltero(a),Todas las edades,835,422,413,17
Baja Verapaz,Soltero(a),Menos de 15 años,181,99,82,17
Baja Verapaz,Soltero(a),15 - 24,63,39,24,17
Baja Verapaz,Soltero(a),25 - 44,79,50,29,17
Baja Verapaz,Soltero(a),45 - 64,106,55,51,17
Baja Verapaz,Soltero(a),65 y más,404,179,225,17
Baja Verapaz,Soltero(a),Ignorado,2,0,2,17
Baja Verapaz,Casado(a),Todas las edades,501,304,197,17
Baja Verapaz,Casado(a),Menos de 15 años,0,0,0,17
Baja Verapaz,Casado(a),15 - 24,12,7,5,17
Baja Verapaz,Casado(a),25 - 44,71,51,20,17
Baja Verapaz,Casado(a),45 - 64,153,82,71,17
Baja Verapaz,Casado(a),65 y más,263,164,99,17
Baja Verapaz,Casado(a),Ignorado,2,0,2,17
Baja Verapaz,Unido(a),Todas las edades,15,3,12,17
Baja Verapaz,Unido(a),Menos de 15 años,0,0,0,17
Baja Verapaz,Unido(a),15 - 24,0,0,0,17
Baja Verapaz,Unido(a),25 - 44,0,0,0,17
Baja Verapaz,Unido(a),45 - 64,2,1,1,17
Baja Verapaz,Unido(a),65 y más,12,2,10,17
Baja Verapaz,Unido(a),Ignorado,1,0,1,17
Baja Verapaz,Ignorado(a),Todas las edades,1,0,1,17
Baja Verapaz,Ignorado(a),Menos de 15 años,0,0,0,17
Baja Verapaz,Ignorado(a),15 - 24,0,0,0,17
Baja Verapaz,Ignorado(a),25 - 44,0,0,0,17
Baja Verapaz,Ignorado(a),45 - 64,0,0,0,17
Baja Verapaz,Ignorado(a),65 y más,0,0,0,17
Baja Verapaz,Ignorado(a),Ignorado,1,0,1,17
Alta Verapaz,Todos los estados civiles,Todas las edades,4899,2522,2377,17
Alta Verapaz,Todos los estados civiles,Menos de 15 años,1108,615,493,17
Alta Verapaz,Todos los estados civiles,15 - 24,239,154,85,17
Alta Verapaz,Todos los estados civiles,25 - 44,573,352,221,17
Alta Verapaz,Todos los estados civiles,45 - 64,900,419,481,17
Alta Verapaz,Todos los estados civiles,65 y más,2066,980,1086,17
Alta Verapaz,Todos los estados civiles,Ignorado,13,2,11,17
Alta Verapaz,Soltero(a),Todas las edades,2889,1424,1465,17
Alta Verapaz,Soltero(a),Menos de 15 años,1108,615,493,17
Alta Verapaz,Soltero(a),15 - 24,211,142,69,17
Alta Verapaz,Soltero(a),25 - 44,280,175,105,17
Alta Verapaz,Soltero(a),45 - 64,260,111,149,17
Alta Verapaz,Soltero(a),65 y más,1022,380,642,17
Alta Verapaz,Soltero(a),Ignorado,8,1,7,17
Alta Verapaz,Casado(a),Todas las edades,1959,1070,889,17
Alta Verapaz,Casado(a),Menos de 15 años,0,0,0,17
Alta Verapaz,Casado(a),15 - 24,27,11,16,17
Alta Verapaz,Casado(a),25 - 44,292,176,116,17
Alta Verapaz,Casado(a),45 - 64,623,303,320,17
Alta Verapaz,Casado(a),65 y más,1014,580,434,17
Alta Verapaz,Casado(a),Ignorado,3,0,3,17
Alta Verapaz,Unido(a),Todas las edades,46,24,22,17
Alta Verapaz,Unido(a),Menos de 15 años,0,0,0,17
Alta Verapaz,Unido(a),15 - 24,0,0,0,17
Alta Verapaz,Unido(a),25 - 44,1,1,0,17
Alta Verapaz,Unido(a),45 - 64,16,4,12,17
Alta Verapaz,Unido(a),65 y más,28,19,9,17
Alta Verapaz,Unido(a),Ignorado,1,0,1,17
Alta Verapaz,Ignorado(a),Todas las edades,5,4,1,17
Alta Verapaz,Ignorado(a),Menos de 15 años,0,0,0,17
Alta Verapaz,Ignorado(a),15 - 24,1,1,0,17
Alta Verapaz,Ignorado(a),25 - 44,0,0,0,17
Alta Verapaz,Ignorado(a),45 - 64,1,1,0,17
Alta Verapaz,Ignorado(a),65 y más,2,1,1,17
Alta Verapaz,Ignorado(a),Ignorado,1,1,0,17
Petén,Todos los estados civiles,Todas las edades,2095,1280,815,17
Petén,Todos los estados civiles,Menos de 15 años,239,142,97,17
Petén,Todos los estados civiles,15 - 24,183,149,34,17
Petén,Todos los estados civiles,25 - 44,382,270,112,17
Petén,Todos los estados civiles,45 - 64,445,241,204,17
Petén,Todos los estados civiles,65 y más,840,474,366,17
Petén,Todos los estados civiles,Ignorado,6,4,2,17
Petén,Soltero(a),Todas las edades,1425,882,543,17
Petén,Soltero(a),Menos de 15 años,239,142,97,17
Petén,Soltero(a),15 - 24,177,145,32,17
Petén,Soltero(a),25 - 44,252,190,62,17
Petén,Soltero(a),45 - 64,209,110,99,17
Petén,Soltero(a),65 y más,546,293,253,17
Petén,Soltero(a),Ignorado,2,2,0,17
Petén,Casado(a),Todas las edades,554,335,219,17
Petén,Casado(a),Menos de 15 años,0,0,0,17
Petén,Casado(a),15 - 24,6,4,2,17
Petén,Casado(a),25 - 44,112,71,41,17
Petén,Casado(a),45 - 64,186,105,81,17
Petén,Casado(a),65 y más,250,155,95,17
Petén,Casado(a),Ignorado,0,0,0,17
Petén,Unido(a),Todas las edades,111,60,51,17
Petén,Unido(a),Menos de 15 años,0,0,0,17
Petén,Unido(a),15 - 24,0,0,0,17
Petén,Unido(a),25 - 44,18,9,9,17
Petén,Unido(a),45 - 64,49,25,24,17
Petén,Unido(a),65 y más,44,26,18,17
Petén,Unido(a),Ignorado,0,0,0,17
Petén,Ignorado(a),Todas las edades,5,3,2,17
Petén,Ignorado(a),Menos de 15 años,0,0,0,17
Petén,Ignorado(a),15 - 24,0,0,0,17
Petén,Ignorado(a),25 - 44,0,0,0,17
Petén,Ignorado(a),45 - 64,1,1,0,17
Petén,Ignorado(a),65 y más,0,0,0,17
Petén,Ignorado(a),Ignorado,4,2,2,17
Izabal,Todos los estados civiles,Todas las edades,2029,1147,882,17
Izabal,Todos los estados civiles,Menos de 15 años,142,78,64,17
Izabal,Todos los estados civiles,15 - 24,155,104,51,17
Izabal,Todos los estados civiles,25 - 44,341,240,101,17
Izabal,Todos los estados civiles,45 - 64,424,227,197,17
Izabal,Todos los estados civiles,65 y más,962,497,465,17
Izabal,Todos los estados civiles,Ignorado,5,1,4,17
Izabal,Soltero(a),Todas las edades,1392,782,610,17
Izabal,Soltero(a),Menos de 15 años,142,78,64,17
Izabal,Soltero(a),15 - 24,150,100,50,17
Izabal,Soltero(a),25 - 44,244,180,64,17
Izabal,Soltero(a),45 - 64,219,124,95,17
Izabal,Soltero(a),65 y más,633,299,334,17
Izabal,Soltero(a),Ignorado,4,1,3,17
Izabal,Casado(a),Todas las edades,605,347,258,17
Izabal,Casado(a),Menos de 15 años,0,0,0,17
Izabal,Casado(a),15 - 24,5,4,1,17
Izabal,Casado(a),25 - 44,95,59,36,17
Izabal,Casado(a),45 - 64,199,102,97,17
Izabal,Casado(a),65 y más,305,182,123,17
Izabal,Casado(a),Ignorado,1,0,1,17
Izabal,Unido(a),Todas las edades,29,16,13,17
Izabal,Unido(a),Menos de 15 años,0,0,0,17
Izabal,Unido(a),15 - 24,0,0,0,17
Izabal,Unido(a),25 - 44,0,0,0,17
Izabal,Unido(a),45 - 64,5,0,5,17
Izabal,Unido(a),65 y más,24,16,8,17
Izabal,Unido(a),Ignorado,0,0,0,17
Izabal,Ignorado(a),Todas las edades,3,2,1,17
Izabal,Ignorado(a),Menos de 15 años,0,0,0,17
Izabal,Ignorado(a),15 - 24,0,0,0,17
Izabal,Ignorado(a),25 - 44,2,1,1,17
Izabal,Ignorado(a),45 - 64,1,1,0,17
Izabal,Ignorado(a),65 y más,0,0,0,17
Izabal,Ignorado(a),Ignorado,0,0,0,17
Zacapa,Todos los estados civiles,Todas las edades,1499,844,655,17
Zacapa,Todos los estados civiles,Menos de 15 años,90,49,41,17
Zacapa,Todos los estados civiles,15 - 24,107,85,22,17
Zacapa,Todos los estados civiles,25 - 44,193,138,55,17
Zacapa,Todos los estados civiles,45 - 64,305,158,147,17
Zacapa,Todos los estados civiles,65 y más,802,413,389,17
Zacapa,Todos los estados civiles,Ignorado,2,1,1,17
Zacapa,Soltero(a),Todas las edades,955,526,429,17
Zacapa,Soltero(a),Menos de 15 años,90,49,41,17
Zacapa,Soltero(a),15 - 24,101,83,18,17
Zacapa,Soltero(a),25 - 44,125,99,26,17
Zacapa,Soltero(a),45 - 64,147,75,72,17
Zacapa,Soltero(a),65 y más,492,220,272,17
Zacapa,Soltero(a),Ignorado,0,0,0,17
Zacapa,Casado(a),Todas las edades,537,317,220,17
Zacapa,Casado(a),Menos de 15 años,0,0,0,17
Zacapa,Casado(a),15 - 24,6,2,4,17
Zacapa,Casado(a),25 - 44,68,39,29,17
Zacapa,Casado(a),45 - 64,157,83,74,17
Zacapa,Casado(a),65 y más,304,192,112,17
Zacapa,Casado(a),Ignorado,2,1,1,17
Zacapa,Unido(a),Todas las edades,7,1,6,17
Zacapa,Unido(a),Menos de 15 años,0,0,0,17
Zacapa,Unido(a),15 - 24,0,0,0,17
Zacapa,Unido(a),25 - 44,0,0,0,17
Zacapa,Unido(a),45 - 64,1,0,1,17
Zacapa,Unido(a),65 y más,6,1,5,17
Zacapa,Unido(a),Ignorado,0,0,0,17
Zacapa,Ignorado(a),Todas las edades,0,0,0,17
Zacapa,Ignorado(a),Menos de 15 años,0,0,0,17
Zacapa,Ignorado(a),15 - 24,0,0,0,17
Zacapa,Ignorado(a),25 - 44,0,0,0,17
Zacapa,Ignorado(a),45 - 64,0,0,0,17
Zacapa,Ignorado(a),65 y más,0,0,0,17
Zacapa,Ignorado(a),Ignorado,0,0,0,17
Chiquimula,Todos los estados civiles,Todas las edades,2137,1235,902,17
Chiquimula,Todos los estados civiles,Menos de 15 años,194,106,88,17
Chiquimula,Todos los estados civiles,15 - 24,141,106,35,17
Chiquimula,Todos los estados civiles,25 - 44,338,242,96,17
Chiquimula,Todos los estados civiles,45 - 64,410,231,179,17
Chiquimula,Todos los estados civiles,65 y más,1038,543,495,17
Chiquimula,Todos los estados civiles,Ignorado,16,7,9,17
Chiquimula,Soltero(a),Todas las edades,1465,811,654,17
Chiquimula,Soltero(a),Menos de 15 años,194,106,88,17
Chiquimula,Soltero(a),15 - 24,138,104,34,17
Chiquimula,Soltero(a),25 - 44,228,171,57,17
Chiquimula,Soltero(a),45 - 64,212,123,89,17
Chiquimula,Soltero(a),65 y más,681,302,379,17
Chiquimula,Soltero(a),Ignorado,12,5,7,17
Chiquimula,Casado(a),Todas las edades,656,413,243,17
Chiquimula,Casado(a),Menos de 15 años,0,0,0,17
Chiquimula,Casado(a),15 - 24,3,2,1,17
Chiquimula,Casado(a),25 - 44,107,68,39,17
Chiquimula,Casado(a),45 - 64,192,104,88,17
Chiquimula,Casado(a),65 y más,351,238,113,17
Chiquimula,Casado(a),Ignorado,3,1,2,17
Chiquimula,Unido(a),Todas las edades,13,9,4,17
Chiquimula,Unido(a),Menos de 15 años,0,0,0,17
Chiquimula,Unido(a),15 - 24,0,0,0,17
Chiquimula,Unido(a),25 - 44,2,2,0,17
Chiquimula,Unido(a),45 - 64,6,4,2,17
Chiquimula,Unido(a),65 y más,5,3,2,17
Chiquimula,Unido(a),Ignorado,0,0,0,17
Chiquimula,Ignorado(a),Todas las edades,3,2,1,17
Chiquimula,Ignorado(a),Menos de 15 años,0,0,0,17
Chiquimula,Ignorado(a),15 - 24,0,0,0,17
Chiquimula,Ignorado(a),25 - 44,1,1,0,17
Chiquimula,Ignorado(a),45 - 64,0,0,0,17
Chiquimula,Ignorado(a),65 y más,1,0,1,17
Chiquimula,Ignorado(a),Ignorado,1,1,0,17
Jalapa,Todos los estados civiles,Todas las edades,1819,1030,789,17
Jalapa,Todos los estados civiles,Menos de 15 años,230,128,102,17
Jalapa,Todos los estados civiles,15 - 24,128,88,40,17
Jalapa,Todos los estados civiles,25 - 44,237,178,59,17
Jalapa,Todos los estados civiles,45 - 64,371,205,166,17
Jalapa,Todos los estados civiles,65 y más,852,430,422,17
Jalapa,Todos los estados civiles,Ignorado,1,1,0,17
Jalapa,Soltero(a),Todas las edades,1036,563,473,17
Jalapa,Soltero(a),Menos de 15 años,230,128,102,17
Jalapa,Soltero(a),15 - 24,124,85,39,17
Jalapa,Soltero(a),25 - 44,142,112,30,17
Jalapa,Soltero(a),45 - 64,117,63,54,17
Jalapa,Soltero(a),65 y más,422,174,248,17
Jalapa,Soltero(a),Ignorado,1,1,0,17
Jalapa,Casado(a),Todas las edades,776,463,313,17
Jalapa,Casado(a),Menos de 15 años,0,0,0,17
Jalapa,Casado(a),15 - 24,4,3,1,17
Jalapa,Casado(a),25 - 44,94,65,29,17
Jalapa,Casado(a),45 - 64,254,142,112,17
Jalapa,Casado(a),65 y más,424,253,171,17
Jalapa,Casado(a),Ignorado,0,0,0,17
Jalapa,Unido(a),Todas las edades,7,4,3,17
Jalapa,Unido(a),Menos de 15 años,0,0,0,17
Jalapa,Unido(a),15 - 24,0,0,0,17
Jalapa,Unido(a),25 - 44,1,1,0,17
Jalapa,Unido(a),45 - 64,0,0,0,17
Jalapa,Unido(a),65 y más,6,3,3,17
Jalapa,Unido(a),Ignorado,0,0,0,17
Jalapa,Ignorado(a),Todas las edades,0,0,0,17
Jalapa,Ignorado(a),Menos de 15 años,0,0,0,17
Jalapa,Ignorado(a),15 - 24,0,0,0,17
Jalapa,Ignorado(a),25 - 44,0,0,0,17
Jalapa,Ignorado(a),45 - 64,0,0,0,17
Jalapa,Ignorado(a),65 y más,0,0,0,17
Jalapa,Ignorado(a),Ignorado,0,0,0,17
Jutiapa,Todos los estados civiles,Todas las edades,2718,1516,1202,17
Jutiapa,Todos los estados civiles,Menos de 15 años,127,70,57,17
Jutiapa,Todos los estados civiles,15 - 24,148,110,38,17
Jutiapa,Todos los estados civiles,25 - 44,364,260,104,17
Jutiapa,Todos los estados civiles,45 - 64,604,326,278,17
Jutiapa,Todos los estados civiles,65 y más,1472,749,723,17
Jutiapa,Todos los estados civiles,Ignorado,3,1,2,17
Jutiapa,Soltero(a),Todas las edades,1736,908,828,17
Jutiapa,Soltero(a),Menos de 15 años,127,70,57,17
Jutiapa,Soltero(a),15 - 24,139,104,35,17
Jutiapa,Soltero(a),25 - 44,238,169,69,17
Jutiapa,Soltero(a),45 - 64,290,157,133,17
Jutiapa,Soltero(a),65 y más,939,407,532,17
Jutiapa,Soltero(a),Ignorado,3,1,2,17
Jutiapa,Casado(a),Todas las edades,957,597,360,17
Jutiapa,Casado(a),Menos de 15 años,0,0,0,17
Jutiapa,Casado(a),15 - 24,9,6,3,17
Jutiapa,Casado(a),25 - 44,126,91,35,17
Jutiapa,Casado(a),45 - 64,304,168,136,17
Jutiapa,Casado(a),65 y más,518,332,186,17
Jutiapa,Casado(a),Ignorado,0,0,0,17
Jutiapa,Unido(a),Todas las edades,25,11,14,17
Jutiapa,Unido(a),Menos de 15 años,0,0,0,17
Jutiapa,Unido(a),15 - 24,0,0,0,17
Jutiapa,Unido(a),25 - 44,0,0,0,17
Jutiapa,Unido(a),45 - 64,10,1,9,17
Jutiapa,Unido(a),65 y más,15,10,5,17
Jutiapa,Unido(a),Ignorado,0,0,0,17
Jutiapa,Ignorado(a),Todas las edades,0,0,0,17
Jutiapa,Ignorado(a),Menos de 15 años,0,0,0,17
Jutiapa,Ignorado(a),15 - 24,0,0,0,17
Jutiapa,Ignorado(a),25 - 44,0,0,0,17
Jutiapa,Ignorado(a),45 - 64,0,0,0,17
Jutiapa,Ignorado(a),65 y más,0,0,0,17
Jutiapa,Ignorado(a),Ignorado,0,0,0,17
Extranjero,Todos los estados civiles,Todas las edades,111,66,45,17
Extranjero,Todos los estados civiles,Menos de 15 años,1,0,1,17
Extranjero,Todos los estados civiles,15 - 24,10,7,3,17
Extranjero,Todos los estados civiles,25 - 44,38,26,12,17
Extranjero,Todos los estados civiles,45 - 64,35,20,15,17
Extranjero,Todos los estados civiles,65 y más,27,13,14,17
Extranjero,Todos los estados civiles,Ignorado,0,0,0,17
Extranjero,Soltero(a),Todas las edades,68,37,31,17
Extranjero,Soltero(a),Menos de 15 años,1,0,1,17
Extranjero,Soltero(a),15 - 24,10,7,3,17
Extranjero,Soltero(a),25 - 44,23,15,8,17
Extranjero,Soltero(a),45 - 64,15,8,7,17
Extranjero,Soltero(a),65 y más,19,7,12,17
Extranjero,Soltero(a),Ignorado,0,0,0,17
Extranjero,Casado(a),Todas las edades,27,18,9,17
Extranjero,Casado(a),Menos de 15 años,0,0,0,17
Extranjero,Casado(a),15 - 24,0,0,0,17
Extranjero,Casado(a),25 - 44,4,1,3,17
Extranjero,Casado(a),45 - 64,17,12,5,17
Extranjero,Casado(a),65 y más,6,5,1,17
Extranjero,Casado(a),Ignorado,0,0,0,17
Extranjero,Unido(a),Todas las edades,2,2,0,17
Extranjero,Unido(a),Menos de 15 años,0,0,0,17
Extranjero,Unido(a),15 - 24,0,0,0,17
Extranjero,Unido(a),25 - 44,2,2,0,17
Extranjero,Unido(a),45 - 64,0,0,0,17
Extranjero,Unido(a),65 y más,0,0,0,17
Extranjero,Unido(a),Ignorado,0,0,0,17
Extranjero,Ignorado(a),Todas las edades,14,9,5,17
Extranjero,Ignorado(a),Menos de 15 años,0,0,0,17
Extranjero,Ignorado(a),15 - 24,0,0,0,17
Extranjero,Ignorado(a),25 - 44,9,8,1,17
Extranjero,Ignorado(a),45 - 64,3,0,3,17
Extranjero,Ignorado(a),65 y más,2,1,1,17
Extranjero,Ignorado(a),Ignorado,0,0,0,17
Ignorado,Todos los estados civiles,Todas las edades,6146,3684,2462,17
Ignorado,Todos los estados civiles,Menos de 15 años,4430,2518,1912,17
Ignorado,Todos los estados civiles,15 - 24,859,623,236,17
Ignorado,Todos los estados civiles,25 - 44,223,175,48,17
Ignorado,Todos los estados civiles,45 - 64,169,113,56,17
Ignorado,Todos los estados civiles,65 y más,301,137,164,17
Ignorado,Todos los estados civiles,Ignorado,164,118,46,17
Ignorado,Todos los estados civiles,Todas las edades,5762,3400,2362,17
Ignorado,Soltero(a),Menos de 15 años,4430,2518,1912,17
Ignorado,Soltero(a),15 - 24,818,594,224,17
Ignorado,Soltero(a),25 - 44,126,97,29,17
Ignorado,Soltero(a),45 - 64,109,69,40,17
Ignorado,Soltero(a),65 y más,247,105,142,17
Ignorado,Soltero(a),Ignorado,32,17,15,17
Ignorado,Casado(a),Todas las edades,51,28,23,17
Ignorado,Casado(a),Menos de 15 años,0,0,0,17
Ignorado,Casado(a),15 - 24,3,1,2,17
Ignorado,Casado(a),25 - 44,13,9,4,17
Ignorado,Casado(a),45 - 64,15,10,5,17
Ignorado,Casado(a),65 y más,20,8,12,17
Ignorado,Casado(a),Ignorado,0,0,0,17
Ignorado,Unido(a),Todas las edades,0,0,0,17
Ignorado,Unido(a),Menos de 15 años,0,0,0,17
Ignorado,Unido(a),15 - 24,0,0,0,17
Ignorado,Unido(a),25 - 44,0,0,0,17
Ignorado,Unido(a),45 - 64,0,0,0,17
Ignorado,Unido(a),65 y más,0,0,0,17
Ignorado,Unido(a),Ignorado,0,0,0,17
Ignorado,Ignorado(a),Todas las edades,333,256,77,17
Ignorado,Ignorado(a),Menos de 15 años,0,0,0,17
Ignorado,Ignorado(a),15 - 24,38,28,10,17
Ignorado,Ignorado(a),25 - 44,84,69,15,17
Ignorado,Ignorado(a),45 - 64,45,34,11,17
Ignorado,Ignorado(a),65 y más,34,24,10,17
Ignorado,Ignorado(a),Ignorado,132,101,31,17
Todos los departamentos,Todos los estados civiles,Todas las edades,83071,45784,37287,18
Todos los departamentos,Todos los estados civiles,Menos de 15 años,11202,6226,4976,18
Todos los departamentos,Todos los estados civiles,15 - 24,4905,3559,1346,18
Todos los departamentos,Todos los estados civiles,25 - 44,11358,7797,3561,18
Todos los departamentos,Todos los estados civiles,45 - 64,17444,9424,8020,18
Todos los departamentos,Todos los estados civiles,65 y más,37837,18576,19261,18
Todos los departamentos,Todos los estados civiles,Ignorado,325,202,123,18
Todos los departamentos,Soltero(a),Todas las edades,51952,27635,24317,18
Todos los departamentos,Soltero(a),Menos de 15 años,11199,6226,4973,18
Todos los departamentos,Soltero(a),15 - 24,4570,3362,1208,18
Todos los departamentos,Soltero(a),25 - 44,7095,5008,2087,18
Todos los departamentos,Soltero(a),45 - 64,7613,4011,3602,18
Todos los departamentos,Soltero(a),65 y más,21383,8987,12396,18
Todos los departamentos,Soltero(a),Ignorado,92,41,51,18
Todos los departamentos,Casado(a),Todas las edades,29765,17321,12444,18
Todos los departamentos,Casado(a),Menos de 15 años,0,0,0,18
Todos los departamentos,Casado(a),15 - 24,300,173,127,18
Todos los departamentos,Casado(a),25 - 44,4136,2698,1438,18
Todos los departamentos,Casado(a),45 - 64,9536,5238,4298,18
Todos los departamentos,Casado(a),65 y más,15772,9201,6571,18
Todos los departamentos,Casado(a),Ignorado,21,11,10,18
Todos los departamentos,Unido(a),Todas las edades,807,441,366,18
Todos los departamentos,Unido(a),Menos de 15 años,0,0,0,18
Todos los departamentos,Unido(a),15 - 24,0,0,0,18
Todos los departamentos,Unido(a),25 - 44,34,15,19,18
Todos los departamentos,Unido(a),45 - 64,191,97,94,18
Todos los departamentos,Unido(a),65 y más,581,328,253,18
Todos los departamentos,Unido(a),Ignorado,1,1,0,18
Todos los departamentos,Ignorado(a),Todas las edades,547,387,160,18
Todos los departamentos,Ignorado(a),Menos de 15 años,3,0,3,18
Todos los departamentos,Ignorado(a),15 - 24,35,24,11,18
Todos los departamentos,Ignorado(a),25 - 44,93,76,17,18
Todos los departamentos,Ignorado(a),45 - 64,104,78,26,18
Todos los departamentos,Ignorado(a),65 y más,101,60,41,18
Todos los departamentos,Ignorado(a),Ignorado,211,149,62,18
Guatemala,Todos los estados civiles,Todas las edades,18247,9916,8331,18
Guatemala,Todos los estados civiles,Menos de 15 años,728,411,317,18
Guatemala,Todos los estados civiles,15 - 24,1120,857,263,18
Guatemala,Todos los estados civiles,25 - 44,2711,1963,748,18
Guatemala,Todos los estados civiles,45 - 64,4447,2483,1964,18
Guatemala,Todos los estados civiles,65 y más,9221,4193,5028,18
Guatemala,Todos los estados civiles,Ignorado,20,9,11,18
Guatemala,Soltero(a),Todas las edades,10806,5557,5249,18
Guatemala,Soltero(a),Menos de 15 años,728,411,317,18
Guatemala,Soltero(a),15 - 24,1051,810,241,18
Guatemala,Soltero(a),25 - 44,1822,1344,478,18
Guatemala,Soltero(a),45 - 64,2115,1150,965,18
Guatemala,Soltero(a),65 y más,5087,1841,3246,18
Guatemala,Soltero(a),Ignorado,3,1,2,18
Guatemala,Casado(a),Todas las edades,7283,4267,3016,18
Guatemala,Casado(a),Menos de 15 años,0,0,0,18
Guatemala,Casado(a),15 - 24,65,43,22,18
Guatemala,Casado(a),25 - 44,869,602,267,18
Guatemala,Casado(a),45 - 64,2283,1301,982,18
Guatemala,Casado(a),65 y más,4063,2319,1744,18
Guatemala,Casado(a),Ignorado,3,2,1,18
Guatemala,Unido(a),Todas las edades,31,12,19,18
Guatemala,Unido(a),Menos de 15 años,0,0,0,18
Guatemala,Unido(a),15 - 24,0,0,0,18
Guatemala,Unido(a),25 - 44,1,0,1,18
Guatemala,Unido(a),45 - 64,7,5,2,18
Guatemala,Unido(a),65 y más,23,7,16,18
Guatemala,Unido(a),Ignorado,0,0,0,18
Guatemala,Ignorado(a),Todas las edades,127,80,47,18
Guatemala,Ignorado(a),Menos de 15 años,0,0,0,18
Guatemala,Ignorado(a),15 - 24,4,4,0,18
Guatemala,Ignorado(a),25 - 44,19,17,2,18
Guatemala,Ignorado(a),45 - 64,42,27,15,18
Guatemala,Ignorado(a),65 y más,48,26,22,18
Guatemala,Ignorado(a),Ignorado,14,6,8,18
El Progreso,Todos los estados civiles,Todas las edades,1044,557,487,18
El Progreso,Todos los estados civiles,Menos de 15 años,41,21,20,18
El Progreso,Todos los estados civiles,15 - 24,48,38,10,18
El Progreso,Todos los estados civiles,25 - 44,123,82,41,18
El Progreso,Todos los estados civiles,45 - 64,225,107,118,18
El Progreso,Todos los estados civiles,65 y más,607,309,298,18
El Progreso,Todos los estados civiles,Ignorado,0,0,0,18
El Progreso,Soltero(a),Todas las edades,632,350,282,18
El Progreso,Soltero(a),Menos de 15 años,41,21,20,18
El Progreso,Soltero(a),15 - 24,47,37,10,18
El Progreso,Soltero(a),25 - 44,85,60,25,18
El Progreso,Soltero(a),45 - 64,105,61,44,18
El Progreso,Soltero(a),65 y más,354,171,183,18
El Progreso,Soltero(a),Ignorado,0,0,0,18
El Progreso,Casado(a),Todas las edades,399,201,198,18
El Progreso,Casado(a),Menos de 15 años,0,0,0,18
El Progreso,Casado(a),15 - 24,1,1,0,18
El Progreso,Casado(a),25 - 44,37,22,15,18
El Progreso,Casado(a),45 - 64,117,46,71,18
El Progreso,Casado(a),65 y más,244,132,112,18
El Progreso,Casado(a),Ignorado,0,0,0,18
El Progreso,Unido(a),Todas las edades,11,6,5,18
El Progreso,Unido(a),Menos de 15 años,0,0,0,18
El Progreso,Unido(a),15 - 24,0,0,0,18
El Progreso,Unido(a),25 - 44,0,0,0,18
El Progreso,Unido(a),45 - 64,3,0,3,18
El Progreso,Unido(a),65 y más,8,6,2,18
El Progreso,Unido(a),Ignorado,0,0,0,18
El Progreso,Ignorado(a),Todas las edades,2,0,2,18
El Progreso,Ignorado(a),Menos de 15 años,0,0,0,18
El Progreso,Ignorado(a),15 - 24,0,0,0,18
El Progreso,Ignorado(a),25 - 44,1,0,1,18
El Progreso,Ignorado(a),45 - 64,0,0,0,18
El Progreso,Ignorado(a),65 y más,1,0,1,18
El Progreso,Ignorado(a),Ignorado,0,0,0,18
Sacatepéquez,Todos los estados civiles,Todas las edades,1737,896,841,18
Sacatepéquez,Todos los estados civiles,Menos de 15 años,61,30,31,18
Sacatepéquez,Todos los estados civiles,15 - 24,66,53,13,18
Sacatepéquez,Todos los estados civiles,25 - 44,230,163,67,18
Sacatepéquez,Todos los estados civiles,45 - 64,420,208,212,18
Sacatepéquez,Todos los estados civiles,65 y más,950,435,515,18
Sacatepéquez,Todos los estados civiles,Ignorado,10,7,3,18
Sacatepéquez,Soltero(a),Todas las edades,844,414,430,18
Sacatepéquez,Soltero(a),Menos de 15 años,61,30,31,18
Sacatepéquez,Soltero(a),15 - 24,59,47,12,18
Sacatepéquez,Soltero(a),25 - 44,137,102,35,18
Sacatepéquez,Soltero(a),45 - 64,142,74,68,18
Sacatepéquez,Soltero(a),65 y más,444,161,283,18
Sacatepéquez,Soltero(a),Ignorado,1,0,1,18
Sacatepéquez,Casado(a),Todas las edades,873,470,403,18
Sacatepéquez,Casado(a),Menos de 15 años,0,0,0,18
Sacatepéquez,Casado(a),15 - 24,7,6,1,18
Sacatepéquez,Casado(a),25 - 44,93,61,32,18
Sacatepéquez,Casado(a),45 - 64,276,133,143,18
Sacatepéquez,Casado(a),65 y más,497,270,227,18
Sacatepéquez,Casado(a),Ignorado,0,0,0,18
Sacatepéquez,Unido(a),Todas las edades,7,2,5,18
Sacatepéquez,Unido(a),Menos de 15 años,0,0,0,18
Sacatepéquez,Unido(a),15 - 24,0,0,0,18
Sacatepéquez,Unido(a),25 - 44,0,0,0,18
Sacatepéquez,Unido(a),45 - 64,1,0,1,18
Sacatepéquez,Unido(a),65 y más,6,2,4,18
Sacatepéquez,Unido(a),Ignorado,0,0,0,18
Sacatepéquez,Ignorado(a),Todas las edades,13,10,3,18
Sacatepéquez,Ignorado(a),Menos de 15 años,0,0,0,18
Sacatepéquez,Ignorado(a),15 - 24,0,0,0,18
Sacatepéquez,Ignorado(a),25 - 44,0,0,0,18
Sacatepéquez,Ignorado(a),45 - 64,1,1,0,18
Sacatepéquez,Ignorado(a),65 y más,3,2,1,18
Sacatepéquez,Ignorado(a),Ignorado,9,7,2,18
Chimaltenango,Todos los estados civiles,Todas las edades,2857,1512,1345,18
Chimaltenango,Todos los estados civiles,Menos de 15 años,238,123,115,18
Chimaltenango,Todos los estados civiles,15 - 24,120,87,33,18
Chimaltenango,Todos los estados civiles,25 - 44,460,328,132,18
Chimaltenango,Todos los estados civiles,45 - 64,634,336,298,18
Chimaltenango,Todos los estados civiles,65 y más,1401,636,765,18
Chimaltenango,Todos los estados civiles,Ignorado,4,2,2,18
Chimaltenango,Soltero(a),Todas las edades,1362,682,680,18
Chimaltenango,Soltero(a),Menos de 15 años,238,123,115,18
Chimaltenango,Soltero(a),15 - 24,99,76,23,18
Chimaltenango,Soltero(a),25 - 44,221,164,57,18
Chimaltenango,Soltero(a),45 - 64,180,93,87,18
Chimaltenango,Soltero(a),65 y más,622,225,397,18
Chimaltenango,Soltero(a),Ignorado,2,1,1,18
Chimaltenango,Casado(a),Todas las edades,1487,825,662,18
Chimaltenango,Casado(a),Menos de 15 años,0,0,0,18
Chimaltenango,Casado(a),15 - 24,21,11,10,18
Chimaltenango,Casado(a),25 - 44,239,164,75,18
Chimaltenango,Casado(a),45 - 64,453,243,210,18
Chimaltenango,Casado(a),65 y más,772,406,366,18
Chimaltenango,Casado(a),Ignorado,2,1,1,18
Chimaltenango,Unido(a),Todas las edades,7,5,2,18
Chimaltenango,Unido(a),Menos de 15 años,0,0,0,18
Chimaltenango,Unido(a),15 - 24,0,0,0,18
Chimaltenango,Unido(a),25 - 44,0,0,0,18
Chimaltenango,Unido(a),45 - 64,0,0,0,18
Chimaltenango,Unido(a),65 y más,7,5,2,18
Chimaltenango,Unido(a),Ignorado,0,0,0,18
Chimaltenango,Ignorado(a),Todas las edades,1,0,1,18
Chimaltenango,Ignorado(a),Menos de 15 años,0,0,0,18
Chimaltenango,Ignorado(a),15 - 24,0,0,0,18
Chimaltenango,Ignorado(a),25 - 44,0,0,0,18
Chimaltenango,Ignorado(a),45 - 64,1,0,1,18
Chimaltenango,Ignorado(a),65 y más,0,0,0,18
Chimaltenango,Ignorado(a),Ignorado,0,0,0,18
Escuintla,Todos los estados civiles,Todas las edades,4416,2564,1852,18
Escuintla,Todos los estados civiles,Menos de 15 años,137,81,56,18
Escuintla,Todos los estados civiles,15 - 24,258,196,62,18
Escuintla,Todos los estados civiles,25 - 44,818,569,249,18
Escuintla,Todos los estados civiles,45 - 64,1130,580,550,18
Escuintla,Todos los estados civiles,65 y más,2068,1133,935,18
Escuintla,Todos los estados civiles,Ignorado,5,5,0,18
Escuintla,Soltero(a),Todas las edades,2743,1563,1180,18
Escuintla,Soltero(a),Menos de 15 años,136,81,55,18
Escuintla,Soltero(a),15 - 24,241,184,57,18
Escuintla,Soltero(a),25 - 44,531,381,150,18
Escuintla,Soltero(a),45 - 64,584,293,291,18
Escuintla,Soltero(a),65 y más,1250,623,627,18
Escuintla,Soltero(a),Ignorado,1,1,0,18
Escuintla,Casado(a),Todas las edades,1653,990,663,18
Escuintla,Casado(a),Menos de 15 años,0,0,0,18
Escuintla,Casado(a),15 - 24,17,12,5,18
Escuintla,Casado(a),25 - 44,284,187,97,18
Escuintla,Casado(a),45 - 64,543,287,256,18
Escuintla,Casado(a),65 y más,809,504,305,18
Escuintla,Casado(a),Ignorado,0,0,0,18
Escuintla,Unido(a),Todas las edades,14,7,7,18
Escuintla,Unido(a),Menos de 15 años,0,0,0,18
Escuintla,Unido(a),15 - 24,0,0,0,18
Escuintla,Unido(a),25 - 44,3,1,2,18
Escuintla,Unido(a),45 - 64,2,0,2,18
Escuintla,Unido(a),65 y más,9,6,3,18
Escuintla,Unido(a),Ignorado,0,0,0,18
Escuintla,Ignorado(a),Todas las edades,6,4,2,18
Escuintla,Ignorado(a),Menos de 15 años,1,0,1,18
Escuintla,Ignorado(a),15 - 24,0,0,0,18
Escuintla,Ignorado(a),25 - 44,0,0,0,18
Escuintla,Ignorado(a),45 - 64,1,0,1,18
Escuintla,Ignorado(a),65 y más,0,0,0,18
Escuintla,Ignorado(a),Ignorado,4,4,0,18
Santa Rosa,Todos los estados civiles,Todas las edades,2126,1188,938,18
Santa Rosa,Todos los estados civiles,Menos de 15 años,65,35,30,18
Santa Rosa,Todos los estados civiles,15 - 24,113,85,28,18
Santa Rosa,Todos los estados civiles,25 - 44,306,210,96,18
Santa Rosa,Todos los estados civiles,45 - 64,515,272,243,18
Santa Rosa,Todos los estados civiles,65 y más,1125,585,540,18
Santa Rosa,Todos los estados civiles,Ignorado,2,1,1,18
Santa Rosa,Soltero(a),Todas las edades,1292,701,591,18
Santa Rosa,Soltero(a),Menos de 15 años,65,35,30,18
Santa Rosa,Soltero(a),15 - 24,106,81,25,18
Santa Rosa,Soltero(a),25 - 44,191,133,58,18
Santa Rosa,Soltero(a),45 - 64,249,128,121,18
Santa Rosa,Soltero(a),65 y más,680,323,357,18
Santa Rosa,Soltero(a),Ignorado,1,1,0,18
Santa Rosa,Casado(a),Todas las edades,811,478,333,18
Santa Rosa,Casado(a),Menos de 15 años,0,0,0,18
Santa Rosa,Casado(a),15 - 24,6,3,3,18
Santa Rosa,Casado(a),25 - 44,113,76,37,18
Santa Rosa,Casado(a),45 - 64,263,142,121,18
Santa Rosa,Casado(a),65 y más,429,257,172,18
Santa Rosa,Casado(a),Ignorado,0,0,0,18
Santa Rosa,Unido(a),Todas las edades,20,7,13,18
Santa Rosa,Unido(a),Menos de 15 años,0,0,0,18
Santa Rosa,Unido(a),15 - 24,0,0,0,18
Santa Rosa,Unido(a),25 - 44,1,0,1,18
Santa Rosa,Unido(a),45 - 64,3,2,1,18
Santa Rosa,Unido(a),65 y más,16,5,11,18
Santa Rosa,Unido(a),Ignorado,0,0,0,18
Santa Rosa,Ignorado(a),Todas las edades,3,2,1,18
Santa Rosa,Ignorado(a),Menos de 15 años,0,0,0,18
Santa Rosa,Ignorado(a),15 - 24,1,1,0,18
Santa Rosa,Ignorado(a),25 - 44,1,1,0,18
Santa Rosa,Ignorado(a),45 - 64,0,0,0,18
Santa Rosa,Ignorado(a),65 y más,0,0,0,18
Santa Rosa,Ignorado(a),Ignorado,1,0,1,18
Sololá,Todos los estados civiles,Todas las edades,1839,981,858,18
Sololá,Todos los estados civiles,Menos de 15 años,150,79,71,18
Sololá,Todos los estados civiles,15 - 24,69,55,14,18
Sololá,Todos los estados civiles,25 - 44,265,169,96,18
Sololá,Todos los estados civiles,45 - 64,411,224,187,18
Sololá,Todos los estados civiles,65 y más,939,451,488,18
Sololá,Todos los estados civiles,Ignorado,5,3,2,18
Sololá,Soltero(a),Todas las edades,1106,572,534,18
Sololá,Soltero(a),Menos de 15 años,150,79,71,18
Sololá,Soltero(a),15 - 24,62,53,9,18
Sololá,Soltero(a),25 - 44,173,114,59,18
Sololá,Soltero(a),45 - 64,166,93,73,18
Sololá,Soltero(a),65 y más,552,230,322,18
Sololá,Soltero(a),Ignorado,3,3,0,18
Sololá,Casado(a),Todas las edades,617,339,278,18
Sololá,Casado(a),Menos de 15 años,0,0,0,18
Sololá,Casado(a),15 - 24,7,2,5,18
Sololá,Casado(a),25 - 44,89,54,35,18
Sololá,Casado(a),45 - 64,220,114,106,18
Sololá,Casado(a),65 y más,300,169,131,18
Sololá,Casado(a),Ignorado,1,0,1,18
Sololá,Unido(a),Todas las edades,115,70,45,18
Sololá,Unido(a),Menos de 15 años,0,0,0,18
Sololá,Unido(a),15 - 24,0,0,0,18
Sololá,Unido(a),25 - 44,3,1,2,18
Sololá,Unido(a),45 - 64,25,17,8,18
Sololá,Unido(a),65 y más,87,52,35,18
Sololá,Unido(a),Ignorado,0,0,0,18
Sololá,Ignorado(a),Todas las edades,1,0,1,18
Sololá,Ignorado(a),Menos de 15 años,0,0,0,18
Sololá,Ignorado(a),15 - 24,0,0,0,18
Sololá,Ignorado(a),25 - 44,0,0,0,18
Sololá,Ignorado(a),45 - 64,0,0,0,18
Sololá,Ignorado(a),65 y más,0,0,0,18
Sololá,Ignorado(a),Ignorado,1,0,1,18
Totonicapán,Todos los estados civiles,Todas las edades,2524,1397,1127,18
Totonicapán,Todos los estados civiles,Menos de 15 años,377,218,159,18
Totonicapán,Todos los estados civiles,15 - 24,88,44,44,18
Totonicapán,Todos los estados civiles,25 - 44,402,265,137,18
Totonicapán,Todos los estados civiles,45 - 64,509,308,201,18
Totonicapán,Todos los estados civiles,65 y más,1136,558,578,18
Totonicapán,Todos los estados civiles,Ignorado,12,4,8,18
Totonicapán,Soltero(a),Todas las edades,1471,722,749,18
Totonicapán,Soltero(a),Menos de 15 años,377,218,159,18
Totonicapán,Soltero(a),15 - 24,80,40,40,18
Totonicapán,Soltero(a),25 - 44,195,127,68,18
Totonicapán,Soltero(a),45 - 64,173,90,83,18
Totonicapán,Soltero(a),65 y más,640,246,394,18
Totonicapán,Soltero(a),Ignorado,6,1,5,18
Totonicapán,Casado(a),Todas las edades,985,638,347,18
Totonicapán,Casado(a),Menos de 15 años,0,0,0,18
Totonicapán,Casado(a),15 - 24,8,4,4,18
Totonicapán,Casado(a),25 - 44,207,138,69,18
Totonicapán,Casado(a),45 - 64,328,214,114,18
Totonicapán,Casado(a),65 y más,440,282,158,18
Totonicapán,Casado(a),Ignorado,2,0,2,18
Totonicapán,Unido(a),Todas las edades,64,34,30,18
Totonicapán,Unido(a),Menos de 15 años,0,0,0,18
Totonicapán,Unido(a),15 - 24,0,0,0,18
Totonicapán,Unido(a),25 - 44,0,0,0,18
Totonicapán,Unido(a),45 - 64,8,4,4,18
Totonicapán,Unido(a),65 y más,56,30,26,18
Totonicapán,Unido(a),Ignorado,0,0,0,18
Totonicapán,Ignorado(a),Todas las edades,4,3,1,18
Totonicapán,Ignorado(a),Menos de 15 años,0,0,0,18
Totonicapán,Ignorado(a),15 - 24,0,0,0,18
Totonicapán,Ignorado(a),25 - 44,0,0,0,18
Totonicapán,Ignorado(a),45 - 64,0,0,0,18
Totonicapán,Ignorado(a),65 y más,0,0,0,18
Totonicapán,Ignorado(a),Ignorado,4,3,1,18
Quetzaltenango,Todos los estados civiles,Todas las edades,4516,2458,2058,18
Quetzaltenango,Todos los estados civiles,Menos de 15 años,477,256,221,18
Quetzaltenango,Todos los estados civiles,15 - 24,233,185,48,18
Quetzaltenango,Todos los estados civiles,25 - 44,617,433,184,18
Quetzaltenango,Todos los estados civiles,45 - 64,969,542,427,18
Quetzaltenango,Todos los estados civiles,65 y más,2204,1033,1171,18
Quetzaltenango,Todos los estados civiles,Ignorado,16,9,7,18
Quetzaltenango,Soltero(a),Todas las edades,2589,1372,1217,18
Quetzaltenango,Soltero(a),Menos de 15 años,476,256,220,18
Quetzaltenango,Soltero(a),15 - 24,216,176,40,18
Quetzaltenango,Soltero(a),25 - 44,384,277,107,18
Quetzaltenango,Soltero(a),45 - 64,348,186,162,18
Quetzaltenango,Soltero(a),65 y más,1157,473,684,18
Quetzaltenango,Soltero(a),Ignorado,8,4,4,18
Quetzaltenango,Casado(a),Todas las edades,1835,1032,803,18
Quetzaltenango,Casado(a),Menos de 15 años,0,0,0,18
Quetzaltenango,Casado(a),15 - 24,16,8,8,18
Quetzaltenango,Casado(a),25 - 44,232,155,77,18
Quetzaltenango,Casado(a),45 - 64,595,343,252,18
Quetzaltenango,Casado(a),65 y más,991,525,466,18
Quetzaltenango,Casado(a),Ignorado,1,1,0,18
Quetzaltenango,Unido(a),Todas las edades,79,45,34,18
Quetzaltenango,Unido(a),Menos de 15 años,0,0,0,18
Quetzaltenango,Unido(a),15 - 24,0,0,0,18
Quetzaltenango,Unido(a),25 - 44,0,0,0,18
Quetzaltenango,Unido(a),45 - 64,25,12,13,18
Quetzaltenango,Unido(a),65 y más,54,33,21,18
Quetzaltenango,Unido(a),Ignorado,0,0,0,18
Quetzaltenango,Ignorado(a),Todas las edades,13,9,4,18
Quetzaltenango,Ignorado(a),Menos de 15 años,1,0,1,18
Quetzaltenango,Ignorado(a),15 - 24,1,1,0,18
Quetzaltenango,Ignorado(a),25 - 44,1,1,0,18
Quetzaltenango,Ignorado(a),45 - 64,1,1,0,18
Quetzaltenango,Ignorado(a),65 y más,2,2,0,18
Quetzaltenango,Ignorado(a),Ignorado,7,4,3,18
Suchitepéquez,Todos los estados civiles,Todas las edades,2989,1641,1348,18
Suchitepéquez,Todos los estados civiles,Menos de 15 años,189,109,80,18
Suchitepéquez,Todos los estados civiles,15 - 24,139,105,34,18
Suchitepéquez,Todos los estados civiles,25 - 44,432,290,142,18
Suchitepéquez,Todos los estados civiles,45 - 64,714,389,325,18
Suchitepéquez,Todos los estados civiles,65 y más,1502,740,762,18
Suchitepéquez,Todos los estados civiles,Ignorado,13,8,5,18
Suchitepéquez,Soltero(a),Todas las edades,1714,911,803,18
Suchitepéquez,Soltero(a),Menos de 15 años,189,109,80,18
Suchitepéquez,Soltero(a),15 - 24,119,92,27,18
Suchitepéquez,Soltero(a),25 - 44,251,178,73,18
Suchitepéquez,Soltero(a),45 - 64,284,158,126,18
Suchitepéquez,Soltero(a),65 y más,862,368,494,18
Suchitepéquez,Soltero(a),Ignorado,9,6,3,18
Suchitepéquez,Casado(a),Todas las edades,1262,723,539,18
Suchitepéquez,Casado(a),Menos de 15 años,0,0,0,18
Suchitepéquez,Casado(a),15 - 24,20,13,7,18
Suchitepéquez,Casado(a),25 - 44,181,112,69,18
Suchitepéquez,Casado(a),45 - 64,430,231,199,18
Suchitepéquez,Casado(a),65 y más,630,367,263,18
Suchitepéquez,Casado(a),Ignorado,1,0,1,18
Suchitepéquez,Unido(a),Todas las edades,10,5,5,18
Suchitepéquez,Unido(a),Menos de 15 años,0,0,0,18
Suchitepéquez,Unido(a),15 - 24,0,0,0,18
Suchitepéquez,Unido(a),25 - 44,0,0,0,18
Suchitepéquez,Unido(a),45 - 64,0,0,0,18
Suchitepéquez,Unido(a),65 y más,10,5,5,18
Suchitepéquez,Unido(a),Ignorado,0,0,0,18
Suchitepéquez,Ignorado(a),Todas las edades,3,2,1,18
Suchitepéquez,Ignorado(a),Menos de 15 años,0,0,0,18
Suchitepéquez,Ignorado(a),15 - 24,0,0,0,18
Suchitepéquez,Ignorado(a),25 - 44,0,0,0,18
Suchitepéquez,Ignorado(a),45 - 64,0,0,0,18
Suchitepéquez,Ignorado(a),65 y más,0,0,0,18
Suchitepéquez,Ignorado(a),Ignorado,3,2,1,18
Retalhuleu,Todos los estados civiles,Todas las edades,1901,1087,814,18
Retalhuleu,Todos los estados civiles,Menos de 15 años,138,79,59,18
Retalhuleu,Todos los estados civiles,15 - 24,99,71,28,18
Retalhuleu,Todos los estados civiles,25 - 44,258,203,55,18
Retalhuleu,Todos los estados civiles,45 - 64,444,255,189,18
Retalhuleu,Todos los estados civiles,65 y más,959,477,482,18
Retalhuleu,Todos los estados civiles,Ignorado,3,2,1,18
Retalhuleu,Soltero(a),Todas las edades,1085,589,496,18
Retalhuleu,Soltero(a),Menos de 15 años,138,79,59,18
Retalhuleu,Soltero(a),15 - 24,92,66,26,18
Retalhuleu,Soltero(a),25 - 44,149,118,31,18
Retalhuleu,Soltero(a),45 - 64,161,97,64,18
Retalhuleu,Soltero(a),65 y más,543,228,315,18
Retalhuleu,Soltero(a),Ignorado,2,1,1,18
Retalhuleu,Casado(a),Todas las edades,764,469,295,18
Retalhuleu,Casado(a),Menos de 15 años,0,0,0,18
Retalhuleu,Casado(a),15 - 24,7,5,2,18
Retalhuleu,Casado(a),25 - 44,108,84,24,18
Retalhuleu,Casado(a),45 - 64,268,151,117,18
Retalhuleu,Casado(a),65 y más,381,229,152,18
Retalhuleu,Casado(a),Ignorado,0,0,0,18
Retalhuleu,Unido(a),Todas las edades,51,28,23,18
Retalhuleu,Unido(a),Menos de 15 años,0,0,0,18
Retalhuleu,Unido(a),15 - 24,0,0,0,18
Retalhuleu,Unido(a),25 - 44,1,1,0,18
Retalhuleu,Unido(a),45 - 64,15,7,8,18
Retalhuleu,Unido(a),65 y más,35,20,15,18
Retalhuleu,Unido(a),Ignorado,0,0,0,18
Retalhuleu,Ignorado(a),Todas las edades,1,1,0,18
Retalhuleu,Ignorado(a),Menos de 15 años,0,0,0,18
Retalhuleu,Ignorado(a),15 - 24,0,0,0,18
Retalhuleu,Ignorado(a),25 - 44,0,0,0,18
Retalhuleu,Ignorado(a),45 - 64,0,0,0,18
Retalhuleu,Ignorado(a),65 y más,0,0,0,18
Retalhuleu,Ignorado(a),Ignorado,1,1,0,18
San Marcos,Todos los estados civiles,Todas las edades,4920,2800,2120,18
San Marcos,Todos los estados civiles,Menos de 15 años,433,266,167,18
San Marcos,Todos los estados civiles,15 - 24,226,147,79,18
San Marcos,Todos los estados civiles,25 - 44,688,454,234,18
San Marcos,Todos los estados civiles,45 - 64,1090,599,491,18
San Marcos,Todos los estados civiles,65 y más,2477,1332,1145,18
San Marcos,Todos los estados civiles,Ignorado,6,2,4,18
San Marcos,Soltero(a),Todas las edades,2993,1650,1343,18
San Marcos,Soltero(a),Menos de 15 años,433,266,167,18
San Marcos,Soltero(a),15 - 24,208,138,70,18
San Marcos,Soltero(a),25 - 44,454,304,150,18
San Marcos,Soltero(a),45 - 64,515,273,242,18
San Marcos,Soltero(a),65 y más,1380,669,711,18
San Marcos,Soltero(a),Ignorado,3,0,3,18
San Marcos,Casado(a),Todas las edades,1849,1113,736,18
San Marcos,Casado(a),Menos de 15 años,0,0,0,18
San Marcos,Casado(a),15 - 24,17,9,8,18
San Marcos,Casado(a),25 - 44,231,149,82,18
San Marcos,Casado(a),45 - 64,553,317,236,18
San Marcos,Casado(a),65 y más,1047,637,410,18
San Marcos,Casado(a),Ignorado,1,1,0,18
San Marcos,Unido(a),Todas las edades,74,35,39,18
San Marcos,Unido(a),Menos de 15 años,0,0,0,18
San Marcos,Unido(a),15 - 24,0,0,0,18
San Marcos,Unido(a),25 - 44,3,1,2,18
San Marcos,Unido(a),45 - 64,21,8,13,18
San Marcos,Unido(a),65 y más,50,26,24,18
San Marcos,Unido(a),Ignorado,0,0,0,18
San Marcos,Ignorado(a),Todas las edades,4,2,2,18
San Marcos,Ignorado(a),Menos de 15 años,0,0,0,18
San Marcos,Ignorado(a),15 - 24,1,0,1,18
San Marcos,Ignorado(a),25 - 44,0,0,0,18
San Marcos,Ignorado(a),45 - 64,1,1,0,18
San Marcos,Ignorado(a),65 y más,0,0,0,18
San Marcos,Ignorado(a),Ignorado,2,1,1,18
Huehuetenango,Todos los estados civiles,Todas las edades,4511,2391,2120,18
Huehuetenango,Todos los estados civiles,Menos de 15 años,546,291,255,18
Huehuetenango,Todos los estados civiles,15 - 24,228,146,82,18
Huehuetenango,Todos los estados civiles,25 - 44,598,348,250,18
Huehuetenango,Todos los estados civiles,45 - 64,891,468,423,18
Huehuetenango,Todos los estados civiles,65 y más,2248,1138,1110,18
Huehuetenango,Todos los estados civiles,Ignorado,0,0,0,18
Huehuetenango,Soltero(a),Todas las edades,2990,1521,1469,18
Huehuetenango,Soltero(a),Menos de 15 años,546,291,255,18
Huehuetenango,Soltero(a),15 - 24,214,138,76,18
Huehuetenango,Soltero(a),25 - 44,387,227,160,18
Huehuetenango,Soltero(a),45 - 64,393,192,201,18
Huehuetenango,Soltero(a),65 y más,1450,673,777,18
Huehuetenango,Soltero(a),Ignorado,0,0,0,18
Huehuetenango,Casado(a),Todas las edades,1514,870,644,18
Huehuetenango,Casado(a),Menos de 15 años,0,0,0,18
Huehuetenango,Casado(a),15 - 24,14,8,6,18
Huehuetenango,Casado(a),25 - 44,211,121,90,18
Huehuetenango,Casado(a),45 - 64,497,276,221,18
Huehuetenango,Casado(a),65 y más,792,465,327,18
Huehuetenango,Casado(a),Ignorado,0,0,0,18
Huehuetenango,Unido(a),Todas las edades,7,0,7,18
Huehuetenango,Unido(a),Menos de 15 años,0,0,0,18
Huehuetenango,Unido(a),15 - 24,0,0,0,18
Huehuetenango,Unido(a),25 - 44,0,0,0,18
Huehuetenango,Unido(a),45 - 64,1,0,1,18
Huehuetenango,Unido(a),65 y más,6,0,6,18
Huehuetenango,Unido(a),Ignorado,0,0,0,18
Huehuetenango,Ignorado(a),Todas las edades,0,0,0,18
Huehuetenango,Ignorado(a),Menos de 15 años,0,0,0,18
Huehuetenango,Ignorado(a),15 - 24,0,0,0,18
Huehuetenango,Ignorado(a),25 - 44,0,0,0,18
Huehuetenango,Ignorado(a),45 - 64,0,0,0,18
Huehuetenango,Ignorado(a),65 y más,0,0,0,18
Huehuetenango,Ignorado(a),Ignorado,0,0,0,18
Quiché,Todos los estados civiles,Todas las edades,4050,2179,1871,18
Quiché,Todos los estados civiles,Menos de 15 años,559,306,253,18
Quiché,Todos los estados civiles,15 - 24,193,134,59,18
Quiché,Todos los estados civiles,25 - 44,591,390,201,18
Quiché,Todos los estados civiles,45 - 64,892,459,433,18
Quiché,Todos los estados civiles,65 y más,1795,879,916,18
Quiché,Todos los estados civiles,Ignorado,20,11,9,18
Quiché,Soltero(a),Todas las edades,2643,1382,1261,18
Quiché,Soltero(a),Menos de 15 años,559,306,253,18
Quiché,Soltero(a),15 - 24,176,127,49,18
Quiché,Soltero(a),25 - 44,345,248,97,18
Quiché,Soltero(a),45 - 64,408,202,206,18
Quiché,Soltero(a),65 y más,1139,489,650,18
Quiché,Soltero(a),Ignorado,16,10,6,18
Quiché,Casado(a),Todas las edades,1376,778,598,18
Quiché,Casado(a),Menos de 15 años,0,0,0,18
Quiché,Casado(a),15 - 24,17,7,10,18
Quiché,Casado(a),25 - 44,246,142,104,18
Quiché,Casado(a),45 - 64,482,256,226,18
Quiché,Casado(a),65 y más,631,373,258,18
Quiché,Casado(a),Ignorado,0,0,0,18
Quiché,Unido(a),Todas las edades,27,18,9,18
Quiché,Unido(a),Menos de 15 años,0,0,0,18
Quiché,Unido(a),15 - 24,0,0,0,18
Quiché,Unido(a),25 - 44,0,0,0,18
Quiché,Unido(a),45 - 64,2,1,1,18
Quiché,Unido(a),65 y más,24,16,8,18
Quiché,Unido(a),Ignorado,1,1,0,18
Quiché,Ignorado(a),Todas las edades,4,1,3,18
Quiché,Ignorado(a),Menos de 15 años,0,0,0,18
Quiché,Ignorado(a),15 - 24,0,0,0,18
Quiché,Ignorado(a),25 - 44,0,0,0,18
Quiché,Ignorado(a),45 - 64,0,0,0,18
Quiché,Ignorado(a),65 y más,1,1,0,18
Quiché,Ignorado(a),Ignorado,3,0,3,18
Baja Verapaz,Todos los estados civiles,Todas las edades,1401,734,667,18
Baja Verapaz,Todos los estados civiles,Menos de 15 años,179,89,90,18
Baja Verapaz,Todos los estados civiles,15 - 24,83,59,24,18
Baja Verapaz,Todos los estados civiles,25 - 44,161,110,51,18
Baja Verapaz,Todos los estados civiles,45 - 64,276,128,148,18
Baja Verapaz,Todos los estados civiles,65 y más,699,348,351,18
Baja Verapaz,Todos los estados civiles,Ignorado,3,0,3,18
Baja Verapaz,Soltero(a),Todas las edades,813,395,418,18
Baja Verapaz,Soltero(a),Menos de 15 años,179,89,90,18
Baja Verapaz,Soltero(a),15 - 24,78,58,20,18
Baja Verapaz,Soltero(a),25 - 44,80,58,22,18
Baja Verapaz,Soltero(a),45 - 64,88,37,51,18
Baja Verapaz,Soltero(a),65 y más,387,153,234,18
Baja Verapaz,Soltero(a),Ignorado,1,0,1,18
Baja Verapaz,Casado(a),Todas las edades,569,329,240,18
Baja Verapaz,Casado(a),Menos de 15 años,0,0,0,18
Baja Verapaz,Casado(a),15 - 24,5,1,4,18
Baja Verapaz,Casado(a),25 - 44,81,52,29,18
Baja Verapaz,Casado(a),45 - 64,184,89,95,18
Baja Verapaz,Casado(a),65 y más,297,187,110,18
Baja Verapaz,Casado(a),Ignorado,2,0,2,18
Baja Verapaz,Unido(a),Todas las edades,19,10,9,18
Baja Verapaz,Unido(a),Menos de 15 años,0,0,0,18
Baja Verapaz,Unido(a),15 - 24,0,0,0,18
Baja Verapaz,Unido(a),25 - 44,0,0,0,18
Baja Verapaz,Unido(a),45 - 64,4,2,2,18
Baja Verapaz,Unido(a),65 y más,15,8,7,18
Baja Verapaz,Unido(a),Ignorado,0,0,0,18
Baja Verapaz,Ignorado(a),Todas las edades,0,0,0,18
Baja Verapaz,Ignorado(a),Menos de 15 años,0,0,0,18
Baja Verapaz,Ignorado(a),15 - 24,0,0,0,18
Baja Verapaz,Ignorado(a),25 - 44,0,0,0,18
Baja Verapaz,Ignorado(a),45 - 64,0,0,0,18
Baja Verapaz,Ignorado(a),65 y más,0,0,0,18
Baja Verapaz,Ignorado(a),Ignorado,0,0,0,18
Alta Verapaz,Todos los estados civiles,Todas las edades,4957,2527,2430,18
Alta Verapaz,Todos los estados civiles,Menos de 15 años,1051,568,483,18
Alta Verapaz,Todos los estados civiles,15 - 24,242,139,103,18
Alta Verapaz,Todos los estados civiles,25 - 44,626,353,273,18
Alta Verapaz,Todos los estados civiles,45 - 64,944,450,494,18
Alta Verapaz,Todos los estados civiles,65 y más,2082,1012,1070,18
Alta Verapaz,Todos los estados civiles,Ignorado,12,5,7,18
Alta Verapaz,Soltero(a),Todas las edades,2806,1351,1455,18
Alta Verapaz,Soltero(a),Menos de 15 años,1051,568,483,18
Alta Verapaz,Soltero(a),15 - 24,212,126,86,18
Alta Verapaz,Soltero(a),25 - 44,309,175,134,18
Alta Verapaz,Soltero(a),45 - 64,274,125,149,18
Alta Verapaz,Soltero(a),65 y más,954,356,598,18
Alta Verapaz,Soltero(a),Ignorado,6,1,5,18
Alta Verapaz,Casado(a),Todas las edades,2077,1132,945,18
Alta Verapaz,Casado(a),Menos de 15 años,0,0,0,18
Alta Verapaz,Casado(a),15 - 24,30,13,17,18
Alta Verapaz,Casado(a),25 - 44,315,176,139,18
Alta Verapaz,Casado(a),45 - 64,649,313,336,18
Alta Verapaz,Casado(a),65 y más,1079,627,452,18
Alta Verapaz,Casado(a),Ignorado,4,3,1,18
Alta Verapaz,Unido(a),Todas las edades,71,42,29,18
Alta Verapaz,Unido(a),Menos de 15 años,0,0,0,18
Alta Verapaz,Unido(a),15 - 24,0,0,0,18
Alta Verapaz,Unido(a),25 - 44,1,1,0,18
Alta Verapaz,Unido(a),45 - 64,21,12,9,18
Alta Verapaz,Unido(a),65 y más,49,29,20,18
Alta Verapaz,Unido(a),Ignorado,0,0,0,18
Alta Verapaz,Ignorado(a),Todas las edades,3,2,1,18
Alta Verapaz,Ignorado(a),Menos de 15 años,0,0,0,18
Alta Verapaz,Ignorado(a),15 - 24,0,0,0,18
Alta Verapaz,Ignorado(a),25 - 44,1,1,0,18
Alta Verapaz,Ignorado(a),45 - 64,0,0,0,18
Alta Verapaz,Ignorado(a),65 y más,0,0,0,18
Alta Verapaz,Ignorado(a),Ignorado,2,1,1,18
Petén,Todos los estados civiles,Todas las edades,2202,1321,881,18
Petén,Todos los estados civiles,Menos de 15 años,197,114,83,18
Petén,Todos los estados civiles,15 - 24,194,136,58,18
Petén,Todos los estados civiles,25 - 44,372,259,113,18
Petén,Todos los estados civiles,45 - 64,484,259,225,18
Petén,Todos los estados civiles,65 y más,944,543,401,18
Petén,Todos los estados civiles,Ignorado,11,10,1,18
Petén,Soltero(a),Todas las edades,1410,842,568,18
Petén,Soltero(a),Menos de 15 años,197,114,83,18
Petén,Soltero(a),15 - 24,182,130,52,18
Petén,Soltero(a),25 - 44,238,173,65,18
Petén,Soltero(a),45 - 64,238,123,115,18
Petén,Soltero(a),65 y más,554,302,252,18
Petén,Soltero(a),Ignorado,1,0,1,18
Petén,Casado(a),Todas las edades,666,399,267,18
Petén,Casado(a),Menos de 15 años,0,0,0,18
Petén,Casado(a),15 - 24,12,6,6,18
Petén,Casado(a),25 - 44,115,78,37,18
Petén,Casado(a),45 - 64,210,117,93,18
Petén,Casado(a),65 y más,328,197,131,18
Petén,Casado(a),Ignorado,1,1,0,18
Petén,Unido(a),Todas las edades,116,70,46,18
Petén,Unido(a),Menos de 15 años,0,0,0,18
Petén,Unido(a),15 - 24,0,0,0,18
Petén,Unido(a),25 - 44,19,8,11,18
Petén,Unido(a),45 - 64,36,19,17,18
Petén,Unido(a),65 y más,61,43,18,18
Petén,Unido(a),Ignorado,0,0,0,18
Petén,Ignorado(a),Todas las edades,10,10,0,18
Petén,Ignorado(a),Menos de 15 años,0,0,0,18
Petén,Ignorado(a),15 - 24,0,0,0,18
Petén,Ignorado(a),25 - 44,0,0,0,18
Petén,Ignorado(a),45 - 64,0,0,0,18
Petén,Ignorado(a),65 y más,1,1,0,18
Petén,Ignorado(a),Ignorado,9,9,0,18
Izabal,Todos los estados civiles,Todas las edades,2193,1203,990,18
Izabal,Todos los estados civiles,Menos de 15 años,177,97,80,18
Izabal,Todos los estados civiles,15 - 24,159,115,44,18
Izabal,Todos los estados civiles,25 - 44,354,247,107,18
Izabal,Todos los estados civiles,45 - 64,463,231,232,18
Izabal,Todos los estados civiles,65 y más,1034,513,521,18
Izabal,Todos los estados civiles,Ignorado,6,0,6,18
Izabal,Soltero(a),Todas las edades,1487,783,704,18
Izabal,Soltero(a),Menos de 15 años,177,97,80,18
Izabal,Soltero(a),15 - 24,155,113,42,18
Izabal,Soltero(a),25 - 44,249,172,77,18
Izabal,Soltero(a),45 - 64,240,117,123,18
Izabal,Soltero(a),65 y más,662,284,378,18
Izabal,Soltero(a),Ignorado,4,0,4,18
Izabal,Casado(a),Todas las edades,675,407,268,18
Izabal,Casado(a),Menos de 15 años,0,0,0,18
Izabal,Casado(a),15 - 24,4,2,2,18
Izabal,Casado(a),25 - 44,105,75,30,18
Izabal,Casado(a),45 - 64,214,112,102,18
Izabal,Casado(a),65 y más,351,218,133,18
Izabal,Casado(a),Ignorado,1,0,1,18
Izabal,Unido(a),Todas las edades,29,12,17,18
Izabal,Unido(a),Menos de 15 años,0,0,0,18
Izabal,Unido(a),15 - 24,0,0,0,18
Izabal,Unido(a),25 - 44,0,0,0,18
Izabal,Unido(a),45 - 64,9,2,7,18
Izabal,Unido(a),65 y más,20,10,10,18
Izabal,Unido(a),Ignorado,0,0,0,18
Izabal,Ignorado(a),Todas las edades,2,1,1,18
Izabal,Ignorado(a),Menos de 15 años,0,0,0,18
Izabal,Ignorado(a),15 - 24,0,0,0,18
Izabal,Ignorado(a),25 - 44,0,0,0,18
Izabal,Ignorado(a),45 - 64,0,0,0,18
Izabal,Ignorado(a),65 y más,1,1,0,18
Izabal,Ignorado(a),Ignorado,1,0,1,18
Zacapa,Todos los estados civiles,Todas las edades,1490,838,652,18
Zacapa,Todos los estados civiles,Menos de 15 años,62,32,30,18
Zacapa,Todos los estados civiles,15 - 24,92,74,18,18
Zacapa,Todos los estados civiles,25 - 44,227,169,58,18
Zacapa,Todos los estados civiles,45 - 64,294,152,142,18
Zacapa,Todos los estados civiles,65 y más,815,411,404,18
Zacapa,Todos los estados civiles,Ignorado,0,0,0,18
Zacapa,Soltero(a),Todas las edades,924,508,416,18
Zacapa,Soltero(a),Menos de 15 años,62,32,30,18
Zacapa,Soltero(a),15 - 24,85,68,17,18
Zacapa,Soltero(a),25 - 44,156,117,39,18
Zacapa,Soltero(a),45 - 64,131,68,63,18
Zacapa,Soltero(a),65 y más,490,223,267,18
Zacapa,Soltero(a),Ignorado,0,0,0,18
Zacapa,Casado(a),Todas las edades,563,329,234,18
Zacapa,Casado(a),Menos de 15 años,0,0,0,18
Zacapa,Casado(a),15 - 24,7,6,1,18
Zacapa,Casado(a),25 - 44,71,52,19,18
Zacapa,Casado(a),45 - 64,163,84,79,18
Zacapa,Casado(a),65 y más,322,187,135,18
Zacapa,Casado(a),Ignorado,0,0,0,18
Zacapa,Unido(a),Todas las edades,3,1,2,18
Zacapa,Unido(a),Menos de 15 años,0,0,0,18
Zacapa,Unido(a),15 - 24,0,0,0,18
Zacapa,Unido(a),25 - 44,0,0,0,18
Zacapa,Unido(a),45 - 64,0,0,0,18
Zacapa,Unido(a),65 y más,3,1,2,18
Zacapa,Unido(a),Ignorado,0,0,0,18
Zacapa,Ignorado(a),Todas las edades,0,0,0,18
Zacapa,Ignorado(a),Menos de 15 años,0,0,0,18
Zacapa,Ignorado(a),15 - 24,0,0,0,18
Zacapa,Ignorado(a),25 - 44,0,0,0,18
Zacapa,Ignorado(a),45 - 64,0,0,0,18
Zacapa,Ignorado(a),65 y más,0,0,0,18
Zacapa,Ignorado(a),Ignorado,0,0,0,18
Chiquimula,Todos los estados civiles,Todas las edades,2029,1136,893,18
Chiquimula,Todos los estados civiles,Menos de 15 años,162,79,83,18
Chiquimula,Todos los estados civiles,15 - 24,118,94,24,18
Chiquimula,Todos los estados civiles,25 - 44,277,189,88,18
Chiquimula,Todos los estados civiles,45 - 64,449,251,198,18
Chiquimula,Todos los estados civiles,65 y más,1012,520,492,18
Chiquimula,Todos los estados civiles,Ignorado,11,3,8,18
Chiquimula,Soltero(a),Todas las edades,1323,713,610,18
Chiquimula,Soltero(a),Menos de 15 años,162,79,83,18
Chiquimula,Soltero(a),15 - 24,114,90,24,18
Chiquimula,Soltero(a),25 - 44,191,137,54,18
Chiquimula,Soltero(a),45 - 64,231,130,101,18
Chiquimula,Soltero(a),65 y más,617,276,341,18
Chiquimula,Soltero(a),Ignorado,8,1,7,18
Chiquimula,Casado(a),Todas las edades,692,415,277,18
Chiquimula,Casado(a),Menos de 15 años,0,0,0,18
Chiquimula,Casado(a),15 - 24,3,3,0,18
Chiquimula,Casado(a),25 - 44,83,49,34,18
Chiquimula,Casado(a),45 - 64,217,121,96,18
Chiquimula,Casado(a),65 y más,388,241,147,18
Chiquimula,Casado(a),Ignorado,1,1,0,18
Chiquimula,Unido(a),Todas las edades,8,3,5,18
Chiquimula,Unido(a),Menos de 15 años,0,0,0,18
Chiquimula,Unido(a),15 - 24,0,0,0,18
Chiquimula,Unido(a),25 - 44,0,0,0,18
Chiquimula,Unido(a),45 - 64,1,0,1,18
Chiquimula,Unido(a),65 y más,7,3,4,18
Chiquimula,Unido(a),Ignorado,0,0,0,18
Chiquimula,Ignorado(a),Todas las edades,6,5,1,18
Chiquimula,Ignorado(a),Menos de 15 años,0,0,0,18
Chiquimula,Ignorado(a),15 - 24,1,1,0,18
Chiquimula,Ignorado(a),25 - 44,3,3,0,18
Chiquimula,Ignorado(a),45 - 64,0,0,0,18
Chiquimula,Ignorado(a),65 y más,0,0,0,18
Chiquimula,Ignorado(a),Ignorado,2,1,1,18
Jalapa,Todos los estados civiles,Todas las edades,1747,975,772,18
Jalapa,Todos los estados civiles,Menos de 15 años,175,89,86,18
Jalapa,Todos los estados civiles,15 - 24,119,86,33,18
Jalapa,Todos los estados civiles,25 - 44,260,176,84,18
Jalapa,Todos los estados civiles,45 - 64,379,206,173,18
Jalapa,Todos los estados civiles,65 y más,813,417,396,18
Jalapa,Todos los estados civiles,Ignorado,1,1,0,18
Jalapa,Soltero(a),Todas las edades,980,506,474,18
Jalapa,Soltero(a),Menos de 15 años,174,89,85,18
Jalapa,Soltero(a),15 - 24,113,82,31,18
Jalapa,Soltero(a),25 - 44,158,105,53,18
Jalapa,Soltero(a),45 - 64,150,70,80,18
Jalapa,Soltero(a),65 y más,385,160,225,18
Jalapa,Soltero(a),Ignorado,0,0,0,18
Jalapa,Casado(a),Todas las edades,759,464,295,18
Jalapa,Casado(a),Menos de 15 años,0,0,0,18
Jalapa,Casado(a),15 - 24,6,4,2,18
Jalapa,Casado(a),25 - 44,101,70,31,18
Jalapa,Casado(a),45 - 64,229,136,93,18
Jalapa,Casado(a),65 y más,423,254,169,18
Jalapa,Casado(a),Ignorado,0,0,0,18
Jalapa,Unido(a),Todas las edades,6,4,2,18
Jalapa,Unido(a),Menos de 15 años,0,0,0,18
Jalapa,Unido(a),15 - 24,0,0,0,18
Jalapa,Unido(a),25 - 44,1,1,0,18
Jalapa,Unido(a),45 - 64,0,0,0,18
Jalapa,Unido(a),65 y más,5,3,2,18
Jalapa,Unido(a),Ignorado,0,0,0,18
Jalapa,Ignorado(a),Todas las edades,2,1,1,18
Jalapa,Ignorado(a),Menos de 15 años,1,0,1,18
Jalapa,Ignorado(a),15 - 24,0,0,0,18
Jalapa,Ignorado(a),25 - 44,0,0,0,18
Jalapa,Ignorado(a),45 - 64,0,0,0,18
Jalapa,Ignorado(a),65 y más,0,0,0,18
Jalapa,Ignorado(a),Ignorado,1,1,0,18
Jutiapa,Todos los estados civiles,Todas las edades,2688,1517,1171,18
Jutiapa,Todos los estados civiles,Menos de 15 años,105,61,44,18
Jutiapa,Todos los estados civiles,15 - 24,129,91,38,18
Jutiapa,Todos los estados civiles,25 - 44,344,234,110,18
Jutiapa,Todos los estados civiles,45 - 64,660,381,279,18
Jutiapa,Todos los estados civiles,65 y más,1450,750,700,18
Jutiapa,Todos los estados civiles,Ignorado,0,0,0,18
Jutiapa,Soltero(a),Todas las edades,1660,879,781,18
Jutiapa,Soltero(a),Menos de 15 años,105,61,44,18
Jutiapa,Soltero(a),15 - 24,121,86,35,18
Jutiapa,Soltero(a),25 - 44,231,163,68,18
Jutiapa,Soltero(a),45 - 64,317,178,139,18
Jutiapa,Soltero(a),65 y más,886,391,495,18
Jutiapa,Soltero(a),Ignorado,0,0,0,18
Jutiapa,Casado(a),Todas las edades,991,615,376,18
Jutiapa,Casado(a),Menos de 15 años,0,0,0,18
Jutiapa,Casado(a),15 - 24,8,5,3,18
Jutiapa,Casado(a),25 - 44,112,70,42,18
Jutiapa,Casado(a),45 - 64,337,198,139,18
Jutiapa,Casado(a),65 y más,534,342,192,18
Jutiapa,Casado(a),Ignorado,0,0,0,18
Jutiapa,Unido(a),Todas las edades,35,23,12,18
Jutiapa,Unido(a),Menos de 15 años,0,0,0,18
Jutiapa,Unido(a),15 - 24,0,0,0,18
Jutiapa,Unido(a),25 - 44,1,1,0,18
Jutiapa,Unido(a),45 - 64,6,5,1,18
Jutiapa,Unido(a),65 y más,28,17,11,18
Jutiapa,Unido(a),Ignorado,0,0,0,18
Jutiapa,Ignorado(a),Todas las edades,2,0,2,18
Jutiapa,Ignorado(a),Menos de 15 años,0,0,0,18
Jutiapa,Ignorado(a),15 - 24,0,0,0,18
Jutiapa,Ignorado(a),25 - 44,0,0,0,18
Jutiapa,Ignorado(a),45 - 64,0,0,0,18
Jutiapa,Ignorado(a),65 y más,2,0,2,18
Jutiapa,Ignorado(a),Ignorado,0,0,0,18
Extranjero,Todos los estados civiles,Todas las edades,121,81,40,18
Extranjero,Todos los estados civiles,Menos de 15 años,6,3,3,18
Extranjero,Todos los estados civiles,15 - 24,5,3,2,18
Extranjero,Todos los estados civiles,25 - 44,55,44,11,18
Extranjero,Todos los estados civiles,45 - 64,31,21,10,18
Extranjero,Todos los estados civiles,65 y más,21,8,13,18
Extranjero,Todos los estados civiles,Ignorado,3,2,1,18
Extranjero,Soltero(a),Todas las edades,84,58,26,18
Extranjero,Soltero(a),Menos de 15 años,6,3,3,18
Extranjero,Soltero(a),15 - 24,4,3,1,18
Extranjero,Soltero(a),25 - 44,40,34,6,18
Extranjero,Soltero(a),45 - 64,18,11,7,18
Extranjero,Soltero(a),65 y más,14,5,9,18
Extranjero,Soltero(a),Ignorado,2,2,0,18
Extranjero,Casado(a),Todas las edades,26,15,11,18
Extranjero,Casado(a),Menos de 15 años,0,0,0,18
Extranjero,Casado(a),15 - 24,1,0,1,18
Extranjero,Casado(a),25 - 44,10,6,4,18
Extranjero,Casado(a),45 - 64,10,7,3,18
Extranjero,Casado(a),65 y más,5,2,3,18
Extranjero,Casado(a),Ignorado,0,0,0,18
Extranjero,Unido(a),Todas las edades,0,0,0,18
Extranjero,Unido(a),Menos de 15 años,0,0,0,18
Extranjero,Unido(a),15 - 24,0,0,0,18
Extranjero,Unido(a),25 - 44,0,0,0,18
Extranjero,Unido(a),45 - 64,0,0,0,18
Extranjero,Unido(a),65 y más,0,0,0,18
Extranjero,Unido(a),Ignorado,0,0,0,18
Extranjero,Ignorado(a),Todas las edades,11,8,3,18
Extranjero,Ignorado(a),Menos de 15 años,0,0,0,18
Extranjero,Ignorado(a),15 - 24,0,0,0,18
Extranjero,Ignorado(a),25 - 44,5,4,1,18
Extranjero,Ignorado(a),45 - 64,3,3,0,18
Extranjero,Ignorado(a),65 y más,2,1,1,18
Extranjero,Ignorado(a),Ignorado,1,0,1,18
Ignorado,Todos los estados civiles,Todas las edades,6566,3885,2681,18
Ignorado,Todos los estados civiles,Menos de 15 años,4949,2789,2160,18
Ignorado,Todos los estados civiles,15 - 24,764,559,205,18
Ignorado,Todos los estados civiles,25 - 44,183,149,34,18
Ignorado,Todos los estados civiles,45 - 64,173,115,58,18
Ignorado,Todos los estados civiles,65 y más,335,155,180,18
Ignorado,Todos los estados civiles,Ignorado,162,118,44,18
Ignorado,Todos los estados civiles,Todas las edades,6195,3614,2581,18
Ignorado,Soltero(a),Menos de 15 años,4949,2789,2160,18
Ignorado,Soltero(a),15 - 24,736,541,195,18
Ignorado,Soltero(a),25 - 44,118,97,21,18
Ignorado,Soltero(a),45 - 64,103,62,41,18
Ignorado,Soltero(a),65 y más,274,117,157,18
Ignorado,Soltero(a),Ignorado,15,8,7,18
Ignorado,Casado(a),Todas las edades,39,23,16,18
Ignorado,Casado(a),Menos de 15 años,0,0,0,18
Ignorado,Casado(a),15 - 24,1,1,0,18
Ignorado,Casado(a),25 - 44,3,3,0,18
Ignorado,Casado(a),45 - 64,15,7,8,18
Ignorado,Casado(a),65 y más,19,11,8,18
Ignorado,Casado(a),Ignorado,1,1,0,18
Ignorado,Unido(a),Todas las edades,3,2,1,18
Ignorado,Unido(a),Menos de 15 años,0,0,0,18
Ignorado,Unido(a),15 - 24,0,0,0,18
Ignorado,Unido(a),25 - 44,0,0,0,18
Ignorado,Unido(a),45 - 64,1,1,0,18
Ignorado,Unido(a),65 y más,2,1,1,18
Ignorado,Unido(a),Ignorado,0,0,0,18
Ignorado,Ignorado(a),Todas las edades,329,246,83,18
Ignorado,Ignorado(a),Menos de 15 años,0,0,0,18
Ignorado,Ignorado(a),15 - 24,27,17,10,18
Ignorado,Ignorado(a),25 - 44,62,49,13,18
Ignorado,Ignorado(a),45 - 64,54,45,9,18
Ignorado,Ignorado(a),65 y más,40,26,14,18
Ignorado,Ignorado(a),Ignorado,146,109,37,18
Todos los departamentos,Todos los estados civiles,Todas las edades,85600,47002,38598,19
Todos los departamentos,Todos los estados civiles,Menos de 15 años,10921,5979,4942,19
Todos los departamentos,Todos los estados civiles,15 - 24,4981,3582,1399,19
Todos los departamentos,Todos los estados civiles,25 - 44,11653,7920,3733,19
Todos los departamentos,Todos los estados civiles,45 - 64,17816,9674,8142,19
Todos los departamentos,Todos los estados civiles,65 y más,39857,19591,20266,19
Todos los departamentos,Todos los estados civiles,Ignorado,372,256,116,19
Todos los departamentos,Soltero(a),Todas las edades,52886,28014,24872,19
Todos los departamentos,Soltero(a),Menos de 15 años,10921,5979,4942,19
Todos los departamentos,Soltero(a),15 - 24,4681,3409,1272,19
Todos los departamentos,Soltero(a),25 - 44,7303,5128,2175,19
Todos los departamentos,Soltero(a),45 - 64,7782,4144,3638,19
Todos los departamentos,Soltero(a),65 y más,22102,9310,12792,19
Todos los departamentos,Soltero(a),Ignorado,97,44,53,19
Todos los departamentos,Casado(a),Todas las edades,31258,18115,13143,19
Todos los departamentos,Casado(a),Menos de 15 años,0,0,0,19
Todos los departamentos,Casado(a),15 - 24,271,152,119,19
Todos los departamentos,Casado(a),25 - 44,4216,2706,1510,19
Todos los departamentos,Casado(a),45 - 64,9729,5377,4352,19
Todos los departamentos,Casado(a),65 y más,17011,9860,7151,19
Todos los departamentos,Casado(a),Ignorado,31,20,11,19
Todos los departamentos,Unido(a),Todas las edades,862,450,412,19
Todos los departamentos,Unido(a),Menos de 15 años,0,0,0,19
Todos los departamentos,Unido(a),15 - 24,0,0,0,19
Todos los departamentos,Unido(a),25 - 44,36,18,18,19
Todos los departamentos,Unido(a),45 - 64,198,81,117,19
Todos los departamentos,Unido(a),65 y más,626,351,275,19
Todos los departamentos,Unido(a),Ignorado,2,0,2,19
Todos los departamentos,Ignorado(a),Todas las edades,594,423,171,19
Todos los departamentos,Ignorado(a),Menos de 15 años,0,0,0,19
Todos los departamentos,Ignorado(a),15 - 24,29,21,8,19
Todos los departamentos,Ignorado(a),25 - 44,98,68,30,19
Todos los departamentos,Ignorado(a),45 - 64,107,72,35,19
Todos los departamentos,Ignorado(a),65 y más,118,70,48,19
Todos los departamentos,Ignorado(a),Ignorado,242,192,50,19
Guatemala,Todos los estados civiles,Todas las edades,18820,10132,8688,19
Guatemala,Todos los estados civiles,Menos de 15 años,371,202,169,19
Guatemala,Todos los estados civiles,15 - 24,1202,889,313,19
Guatemala,Todos los estados civiles,25 - 44,2742,1946,796,19
Guatemala,Todos los estados civiles,45 - 64,4534,2533,2001,19
Guatemala,Todos los estados civiles,65 y más,9952,4549,5403,19
Guatemala,Todos los estados civiles,Ignorado,19,13,6,19
Guatemala,Soltero(a),Todas las edades,10755,5483,5272,19
Guatemala,Soltero(a),Menos de 15 años,371,202,169,19
Guatemala,Soltero(a),15 - 24,1139,854,285,19
Guatemala,Soltero(a),25 - 44,1824,1318,506,19
Guatemala,Soltero(a),45 - 64,2145,1142,1003,19
Guatemala,Soltero(a),65 y más,5270,1965,3305,19
Guatemala,Soltero(a),Ignorado,6,2,4,19
Guatemala,Casado(a),Todas las edades,7890,4543,3347,19
Guatemala,Casado(a),Menos de 15 años,0,0,0,19
Guatemala,Casado(a),15 - 24,59,33,26,19
Guatemala,Casado(a),25 - 44,883,607,276,19
Guatemala,Casado(a),45 - 64,2343,1358,985,19
Guatemala,Casado(a),65 y más,4599,2541,2058,19
Guatemala,Casado(a),Ignorado,6,4,2,19
Guatemala,Unido(a),Todas las edades,48,26,22,19
Guatemala,Unido(a),Menos de 15 años,0,0,0,19
Guatemala,Unido(a),15 - 24,0,0,0,19
Guatemala,Unido(a),25 - 44,1,1,0,19
Guatemala,Unido(a),45 - 64,11,6,5,19
Guatemala,Unido(a),65 y más,36,19,17,19
Guatemala,Unido(a),Ignorado,0,0,0,19
Guatemala,Ignorado(a),Todas las edades,127,80,47,19
Guatemala,Ignorado(a),Menos de 15 años,0,0,0,19
Guatemala,Ignorado(a),15 - 24,4,2,2,19
Guatemala,Ignorado(a),25 - 44,34,20,14,19
Guatemala,Ignorado(a),45 - 64,35,27,8,19
Guatemala,Ignorado(a),65 y más,47,24,23,19
Guatemala,Ignorado(a),Ignorado,7,7,0,19
El Progreso,Todos los estados civiles,Todas las edades,1126,627,499,19
El Progreso,Todos los estados civiles,Menos de 15 años,48,27,21,19
El Progreso,Todos los estados civiles,15 - 24,46,32,14,19
El Progreso,Todos los estados civiles,25 - 44,142,96,46,19
El Progreso,Todos los estados civiles,45 - 64,245,131,114,19
El Progreso,Todos los estados civiles,65 y más,645,341,304,19
El Progreso,Todos los estados civiles,Ignorado,0,0,0,19
El Progreso,Soltero(a),Todas las edades,678,368,310,19
El Progreso,Soltero(a),Menos de 15 años,48,27,21,19
El Progreso,Soltero(a),15 - 24,45,32,13,19
El Progreso,Soltero(a),25 - 44,99,72,27,19
El Progreso,Soltero(a),45 - 64,128,71,57,19
El Progreso,Soltero(a),65 y más,358,166,192,19
El Progreso,Soltero(a),Ignorado,0,0,0,19
El Progreso,Casado(a),Todas las edades,438,256,182,19
El Progreso,Casado(a),Menos de 15 años,0,0,0,19
El Progreso,Casado(a),15 - 24,1,0,1,19
El Progreso,Casado(a),25 - 44,43,24,19,19
El Progreso,Casado(a),45 - 64,117,60,57,19
El Progreso,Casado(a),65 y más,277,172,105,19
El Progreso,Casado(a),Ignorado,0,0,0,19
El Progreso,Unido(a),Todas las edades,10,3,7,19
El Progreso,Unido(a),Menos de 15 años,0,0,0,19
El Progreso,Unido(a),15 - 24,0,0,0,19
El Progreso,Unido(a),25 - 44,0,0,0,19
El Progreso,Unido(a),45 - 64,0,0,0,19
El Progreso,Unido(a),65 y más,10,3,7,19
El Progreso,Unido(a),Ignorado,0,0,0,19
El Progreso,Ignorado(a),Todas las edades,0,0,0,19
El Progreso,Ignorado(a),Menos de 15 años,0,0,0,19
El Progreso,Ignorado(a),15 - 24,0,0,0,19
El Progreso,Ignorado(a),25 - 44,0,0,0,19
El Progreso,Ignorado(a),45 - 64,0,0,0,19
El Progreso,Ignorado(a),65 y más,0,0,0,19
El Progreso,Ignorado(a),Ignorado,0,0,0,19
Sacatepéquez,Todos los estados civiles,Todas las edades,1783,959,824,19
Sacatepéquez,Todos los estados civiles,Menos de 15 años,17,12,5,19
Sacatepéquez,Todos los estados civiles,15 - 24,63,46,17,19
Sacatepéquez,Todos los estados civiles,25 - 44,252,171,81,19
Sacatepéquez,Todos los estados civiles,45 - 64,428,234,194,19
Sacatepéquez,Todos los estados civiles,65 y más,1021,494,527,19
Sacatepéquez,Todos los estados civiles,Ignorado,2,2,0,19
Sacatepéquez,Soltero(a),Todas las edades,822,403,419,19
Sacatepéquez,Soltero(a),Menos de 15 años,17,12,5,19
Sacatepéquez,Soltero(a),15 - 24,59,43,16,19
Sacatepéquez,Soltero(a),25 - 44,135,96,39,19
Sacatepéquez,Soltero(a),45 - 64,137,71,66,19
Sacatepéquez,Soltero(a),65 y más,473,180,293,19
Sacatepéquez,Soltero(a),Ignorado,1,1,0,19
Sacatepéquez,Casado(a),Todas las edades,952,552,400,19
Sacatepéquez,Casado(a),Menos de 15 años,0,0,0,19
Sacatepéquez,Casado(a),15 - 24,4,3,1,19
Sacatepéquez,Casado(a),25 - 44,117,75,42,19
Sacatepéquez,Casado(a),45 - 64,289,162,127,19
Sacatepéquez,Casado(a),65 y más,542,312,230,19
Sacatepéquez,Casado(a),Ignorado,0,0,0,19
Sacatepéquez,Unido(a),Todas las edades,4,1,3,19
Sacatepéquez,Unido(a),Menos de 15 años,0,0,0,19
Sacatepéquez,Unido(a),15 - 24,0,0,0,19
Sacatepéquez,Unido(a),25 - 44,0,0,0,19
Sacatepéquez,Unido(a),45 - 64,0,0,0,19
Sacatepéquez,Unido(a),65 y más,4,1,3,19
Sacatepéquez,Unido(a),Ignorado,0,0,0,19
Sacatepéquez,Ignorado(a),Todas las edades,5,3,2,19
Sacatepéquez,Ignorado(a),Menos de 15 años,0,0,0,19
Sacatepéquez,Ignorado(a),15 - 24,0,0,0,19
Sacatepéquez,Ignorado(a),25 - 44,0,0,0,19
Sacatepéquez,Ignorado(a),45 - 64,2,1,1,19
Sacatepéquez,Ignorado(a),65 y más,2,1,1,19
Sacatepéquez,Ignorado(a),Ignorado,1,1,0,19
Chimaltenango,Todos los estados civiles,Todas las edades,2984,1593,1391,19
Chimaltenango,Todos los estados civiles,Menos de 15 años,217,112,105,19
Chimaltenango,Todos los estados civiles,15 - 24,142,112,30,19
Chimaltenango,Todos los estados civiles,25 - 44,463,327,136,19
Chimaltenango,Todos los estados civiles,45 - 64,650,325,325,19
Chimaltenango,Todos los estados civiles,65 y más,1510,716,794,19
Chimaltenango,Todos los estados civiles,Ignorado,2,1,1,19
Chimaltenango,Soltero(a),Todas las edades,1415,717,698,19
Chimaltenango,Soltero(a),Menos de 15 años,217,112,105,19
Chimaltenango,Soltero(a),15 - 24,128,100,28,19
Chimaltenango,Soltero(a),25 - 44,217,156,61,19
Chimaltenango,Soltero(a),45 - 64,176,90,86,19
Chimaltenango,Soltero(a),65 y más,676,259,417,19
Chimaltenango,Soltero(a),Ignorado,1,0,1,19
Chimaltenango,Casado(a),Todas las edades,1561,872,689,19
Chimaltenango,Casado(a),Menos de 15 años,0,0,0,19
Chimaltenango,Casado(a),15 - 24,14,12,2,19
Chimaltenango,Casado(a),25 - 44,246,171,75,19
Chimaltenango,Casado(a),45 - 64,473,234,239,19
Chimaltenango,Casado(a),65 y más,828,455,373,19
Chimaltenango,Casado(a),Ignorado,0,0,0,19
Chimaltenango,Unido(a),Todas las edades,3,2,1,19
Chimaltenango,Unido(a),Menos de 15 años,0,0,0,19
Chimaltenango,Unido(a),15 - 24,0,0,0,19
Chimaltenango,Unido(a),25 - 44,0,0,0,19
Chimaltenango,Unido(a),45 - 64,1,1,0,19
Chimaltenango,Unido(a),65 y más,2,1,1,19
Chimaltenango,Unido(a),Ignorado,0,0,0,19
Chimaltenango,Ignorado(a),Todas las edades,5,2,3,19
Chimaltenango,Ignorado(a),Menos de 15 años,0,0,0,19
Chimaltenango,Ignorado(a),15 - 24,0,0,0,19
Chimaltenango,Ignorado(a),25 - 44,0,0,0,19
Chimaltenango,Ignorado(a),45 - 64,0,0,0,19
Chimaltenango,Ignorado(a),65 y más,4,1,3,19
Chimaltenango,Ignorado(a),Ignorado,1,1,0,19
Escuintla,Todos los estados civiles,Todas las edades,4540,2579,1961,19
Escuintla,Todos los estados civiles,Menos de 15 años,49,32,17,19
Escuintla,Todos los estados civiles,15 - 24,278,222,56,19
Escuintla,Todos los estados civiles,25 - 44,837,579,258,19
Escuintla,Todos los estados civiles,45 - 64,1214,649,565,19
Escuintla,Todos los estados civiles,65 y más,2157,1093,1064,19
Escuintla,Todos los estados civiles,Ignorado,5,4,1,19
Escuintla,Soltero(a),Todas las edades,2766,1551,1215,19
Escuintla,Soltero(a),Menos de 15 años,49,32,17,19
Escuintla,Soltero(a),15 - 24,258,209,49,19
Escuintla,Soltero(a),25 - 44,548,399,149,19
Escuintla,Soltero(a),45 - 64,639,325,314,19
Escuintla,Soltero(a),65 y más,1271,585,686,19
Escuintla,Soltero(a),Ignorado,1,1,0,19
Escuintla,Casado(a),Todas las edades,1745,1009,736,19
Escuintla,Casado(a),Menos de 15 años,0,0,0,19
Escuintla,Casado(a),15 - 24,20,13,7,19
Escuintla,Casado(a),25 - 44,286,178,108,19
Escuintla,Casado(a),45 - 64,569,321,248,19
Escuintla,Casado(a),65 y más,868,496,372,19
Escuintla,Casado(a),Ignorado,2,1,1,19
Escuintla,Unido(a),Todas las edades,20,12,8,19
Escuintla,Unido(a),Menos de 15 años,0,0,0,19
Escuintla,Unido(a),15 - 24,0,0,0,19
Escuintla,Unido(a),25 - 44,1,0,1,19
Escuintla,Unido(a),45 - 64,4,3,1,19
Escuintla,Unido(a),65 y más,15,9,6,19
Escuintla,Unido(a),Ignorado,0,0,0,19
Escuintla,Ignorado(a),Todas las edades,9,7,2,19
Escuintla,Ignorado(a),Menos de 15 años,0,0,0,19
Escuintla,Ignorado(a),15 - 24,0,0,0,19
Escuintla,Ignorado(a),25 - 44,2,2,0,19
Escuintla,Ignorado(a),45 - 64,2,0,2,19
Escuintla,Ignorado(a),65 y más,3,3,0,19
Escuintla,Ignorado(a),Ignorado,2,2,0,19
Santa Rosa,Todos los estados civiles,Todas las edades,2121,1191,930,19
Santa Rosa,Todos los estados civiles,Menos de 15 años,16,11,5,19
Santa Rosa,Todos los estados civiles,15 - 24,127,92,35,19
Santa Rosa,Todos los estados civiles,25 - 44,303,202,101,19
Santa Rosa,Todos los estados civiles,45 - 64,514,291,223,19
Santa Rosa,Todos los estados civiles,65 y más,1157,593,564,19
Santa Rosa,Todos los estados civiles,Ignorado,4,2,2,19
Santa Rosa,Soltero(a),Todas las edades,1331,730,601,19
Santa Rosa,Soltero(a),Menos de 15 años,16,11,5,19
Santa Rosa,Soltero(a),15 - 24,120,90,30,19
Santa Rosa,Soltero(a),25 - 44,214,143,71,19
Santa Rosa,Soltero(a),45 - 64,251,143,108,19
Santa Rosa,Soltero(a),65 y más,730,343,387,19
Santa Rosa,Soltero(a),Ignorado,0,0,0,19
Santa Rosa,Casado(a),Todas las edades,771,451,320,19
Santa Rosa,Casado(a),Menos de 15 años,0,0,0,19
Santa Rosa,Casado(a),15 - 24,7,2,5,19
Santa Rosa,Casado(a),25 - 44,89,59,30,19
Santa Rosa,Casado(a),45 - 64,260,147,113,19
Santa Rosa,Casado(a),65 y más,413,242,171,19
Santa Rosa,Casado(a),Ignorado,2,1,1,19
Santa Rosa,Unido(a),Todas las edades,17,9,8,19
Santa Rosa,Unido(a),Menos de 15 años,0,0,0,19
Santa Rosa,Unido(a),15 - 24,0,0,0,19
Santa Rosa,Unido(a),25 - 44,0,0,0,19
Santa Rosa,Unido(a),45 - 64,3,1,2,19
Santa Rosa,Unido(a),65 y más,14,8,6,19
Santa Rosa,Unido(a),Ignorado,0,0,0,19
Santa Rosa,Ignorado(a),Todas las edades,2,1,1,19
Santa Rosa,Ignorado(a),Menos de 15 años,0,0,0,19
Santa Rosa,Ignorado(a),15 - 24,0,0,0,19
Santa Rosa,Ignorado(a),25 - 44,0,0,0,19
Santa Rosa,Ignorado(a),45 - 64,0,0,0,19
Santa Rosa,Ignorado(a),65 y más,0,0,0,19
Santa Rosa,Ignorado(a),Ignorado,2,1,1,19
Sololá,Todos los estados civiles,Todas las edades,1780,964,816,19
Sololá,Todos los estados civiles,Menos de 15 años,57,25,32,19
Sololá,Todos los estados civiles,15 - 24,59,44,15,19
Sololá,Todos los estados civiles,25 - 44,299,182,117,19
Sololá,Todos los estados civiles,45 - 64,412,221,191,19
Sololá,Todos los estados civiles,65 y más,944,489,455,19
Sololá,Todos los estados civiles,Ignorado,9,3,6,19
Sololá,Soltero(a),Todas las edades,1012,531,481,19
Sololá,Soltero(a),Menos de 15 años,57,25,32,19
Sololá,Soltero(a),15 - 24,55,42,13,19
Sololá,Soltero(a),25 - 44,170,111,59,19
Sololá,Soltero(a),45 - 64,169,100,69,19
Sololá,Soltero(a),65 y más,556,252,304,19
Sololá,Soltero(a),Ignorado,5,1,4,19
Sololá,Casado(a),Todas las edades,685,389,296,19
Sololá,Casado(a),Menos de 15 años,0,0,0,19
Sololá,Casado(a),15 - 24,4,2,2,19
Sololá,Casado(a),25 - 44,129,71,58,19
Sololá,Casado(a),45 - 64,226,112,114,19
Sololá,Casado(a),65 y más,325,203,122,19
Sololá,Casado(a),Ignorado,1,1,0,19
Sololá,Unido(a),Todas las edades,78,41,37,19
Sololá,Unido(a),Menos de 15 años,0,0,0,19
Sololá,Unido(a),15 - 24,0,0,0,19
Sololá,Unido(a),25 - 44,0,0,0,19
Sololá,Unido(a),45 - 64,17,9,8,19
Sololá,Unido(a),65 y más,61,32,29,19
Sololá,Unido(a),Ignorado,0,0,0,19
Sololá,Ignorado(a),Todas las edades,5,3,2,19
Sololá,Ignorado(a),Menos de 15 años,0,0,0,19
Sololá,Ignorado(a),15 - 24,0,0,0,19
Sololá,Ignorado(a),25 - 44,0,0,0,19
Sololá,Ignorado(a),45 - 64,0,0,0,19
Sololá,Ignorado(a),65 y más,2,2,0,19
Sololá,Ignorado(a),Ignorado,3,1,2,19
Totonicapán,Todos los estados civiles,Todas las edades,2446,1343,1103,19
Totonicapán,Todos los estados civiles,Menos de 15 años,214,111,103,19
Totonicapán,Todos los estados civiles,15 - 24,83,60,23,19
Totonicapán,Todos los estados civiles,25 - 44,391,254,137,19
Totonicapán,Todos los estados civiles,45 - 64,548,329,219,19
Totonicapán,Todos los estados civiles,65 y más,1200,584,616,19
Totonicapán,Todos los estados civiles,Ignorado,10,5,5,19
Totonicapán,Soltero(a),Todas las edades,1289,614,675,19
Totonicapán,Soltero(a),Menos de 15 años,214,111,103,19
Totonicapán,Soltero(a),15 - 24,75,57,18,19
Totonicapán,Soltero(a),25 - 44,193,124,69,19
Totonicapán,Soltero(a),45 - 64,181,95,86,19
Totonicapán,Soltero(a),65 y más,620,226,394,19
Totonicapán,Soltero(a),Ignorado,6,1,5,19
Totonicapán,Casado(a),Todas las edades,1069,670,399,19
Totonicapán,Casado(a),Menos de 15 años,0,0,0,19
Totonicapán,Casado(a),15 - 24,8,3,5,19
Totonicapán,Casado(a),25 - 44,198,130,68,19
Totonicapán,Casado(a),45 - 64,359,229,130,19
Totonicapán,Casado(a),65 y más,503,307,196,19
Totonicapán,Casado(a),Ignorado,1,1,0,19
Totonicapán,Unido(a),Todas las edades,84,55,29,19
Totonicapán,Unido(a),Menos de 15 años,0,0,0,19
Totonicapán,Unido(a),15 - 24,0,0,0,19
Totonicapán,Unido(a),25 - 44,0,0,0,19
Totonicapán,Unido(a),45 - 64,8,5,3,19
Totonicapán,Unido(a),65 y más,76,50,26,19
Totonicapán,Unido(a),Ignorado,0,0,0,19
Totonicapán,Ignorado(a),Todas las edades,4,4,0,19
Totonicapán,Ignorado(a),Menos de 15 años,0,0,0,19
Totonicapán,Ignorado(a),15 - 24,0,0,0,19
Totonicapán,Ignorado(a),25 - 44,0,0,0,19
Totonicapán,Ignorado(a),45 - 64,0,0,0,19
Totonicapán,Ignorado(a),65 y más,1,1,0,19
Totonicapán,Ignorado(a),Ignorado,3,3,0,19
Quetzaltenango,Todos los estados civiles,Todas las edades,4664,2547,2117,19
Quetzaltenango,Todos los estados civiles,Menos de 15 años,402,204,198,19
Quetzaltenango,Todos los estados civiles,15 - 24,210,159,51,19
Quetzaltenango,Todos los estados civiles,25 - 44,605,434,171,19
Quetzaltenango,Todos los estados civiles,45 - 64,1007,576,431,19
Quetzaltenango,Todos los estados civiles,65 y más,2422,1163,1259,19
Quetzaltenango,Todos los estados civiles,Ignorado,18,11,7,19
Quetzaltenango,Soltero(a),Todas las edades,2659,1377,1282,19
Quetzaltenango,Soltero(a),Menos de 15 años,402,204,198,19
Quetzaltenango,Soltero(a),15 - 24,190,146,44,19
Quetzaltenango,Soltero(a),25 - 44,367,266,101,19
Quetzaltenango,Soltero(a),45 - 64,422,238,184,19
Quetzaltenango,Soltero(a),65 y más,1267,517,750,19
Quetzaltenango,Soltero(a),Ignorado,11,6,5,19
Quetzaltenango,Casado(a),Todas las edades,1892,1110,782,19
Quetzaltenango,Casado(a),Menos de 15 años,0,0,0,19
Quetzaltenango,Casado(a),15 - 24,20,13,7,19
Quetzaltenango,Casado(a),25 - 44,229,162,67,19
Quetzaltenango,Casado(a),45 - 64,561,333,228,19
Quetzaltenango,Casado(a),65 y más,1080,602,478,19
Quetzaltenango,Casado(a),Ignorado,2,0,2,19
Quetzaltenango,Unido(a),Todas las edades,106,53,53,19
Quetzaltenango,Unido(a),Menos de 15 años,0,0,0,19
Quetzaltenango,Unido(a),15 - 24,0,0,0,19
Quetzaltenango,Unido(a),25 - 44,9,6,3,19
Quetzaltenango,Unido(a),45 - 64,22,3,19,19
Quetzaltenango,Unido(a),65 y más,75,44,31,19
Quetzaltenango,Unido(a),Ignorado,0,0,0,19
Quetzaltenango,Ignorado(a),Todas las edades,7,7,0,19
Quetzaltenango,Ignorado(a),Menos de 15 años,0,0,0,19
Quetzaltenango,Ignorado(a),15 - 24,0,0,0,19
Quetzaltenango,Ignorado(a),25 - 44,0,0,0,19
Quetzaltenango,Ignorado(a),45 - 64,2,2,0,19
Quetzaltenango,Ignorado(a),65 y más,0,0,0,19
Quetzaltenango,Ignorado(a),Ignorado,5,5,0,19
Suchitepéquez,Todos los estados civiles,Todas las edades,3205,1783,1422,19
Suchitepéquez,Todos los estados civiles,Menos de 15 años,137,84,53,19
Suchitepéquez,Todos los estados civiles,15 - 24,142,103,39,19
Suchitepéquez,Todos los estados civiles,25 - 44,464,327,137,19
Suchitepéquez,Todos los estados civiles,45 - 64,788,430,358,19
Suchitepéquez,Todos los estados civiles,65 y más,1667,837,830,19
Suchitepéquez,Todos los estados civiles,Ignorado,7,2,5,19
Suchitepéquez,Soltero(a),Todas las edades,1810,954,856,19
Suchitepéquez,Soltero(a),Menos de 15 años,137,84,53,19
Suchitepéquez,Soltero(a),15 - 24,130,96,34,19
Suchitepéquez,Soltero(a),25 - 44,266,190,76,19
Suchitepéquez,Soltero(a),45 - 64,307,169,138,19
Suchitepéquez,Soltero(a),65 y más,966,413,553,19
Suchitepéquez,Soltero(a),Ignorado,4,2,2,19
Suchitepéquez,Casado(a),Todas las edades,1378,824,554,19
Suchitepéquez,Casado(a),Menos de 15 años,0,0,0,19
Suchitepéquez,Casado(a),15 - 24,12,7,5,19
Suchitepéquez,Casado(a),25 - 44,198,137,61,19
Suchitepéquez,Casado(a),45 - 64,476,260,216,19
Suchitepéquez,Casado(a),65 y más,690,420,270,19
Suchitepéquez,Casado(a),Ignorado,2,0,2,19
Suchitepéquez,Unido(a),Todas las edades,15,5,10,19
Suchitepéquez,Unido(a),Menos de 15 años,0,0,0,19
Suchitepéquez,Unido(a),15 - 24,0,0,0,19
Suchitepéquez,Unido(a),25 - 44,0,0,0,19
Suchitepéquez,Unido(a),45 - 64,4,1,3,19
Suchitepéquez,Unido(a),65 y más,11,4,7,19
Suchitepéquez,Unido(a),Ignorado,0,0,0,19
Suchitepéquez,Ignorado(a),Todas las edades,2,0,2,19
Suchitepéquez,Ignorado(a),Menos de 15 años,0,0,0,19
Suchitepéquez,Ignorado(a),15 - 24,0,0,0,19
Suchitepéquez,Ignorado(a),25 - 44,0,0,0,19
Suchitepéquez,Ignorado(a),45 - 64,1,0,1,19
Suchitepéquez,Ignorado(a),65 y más,0,0,0,19
Suchitepéquez,Ignorado(a),Ignorado,1,0,1,19
Retalhuleu,Todos los estados civiles,Todas las edades,1871,1084,787,19
Retalhuleu,Todos los estados civiles,Menos de 15 años,108,65,43,19
Retalhuleu,Todos los estados civiles,15 - 24,83,63,20,19
Retalhuleu,Todos los estados civiles,25 - 44,281,208,73,19
Retalhuleu,Todos los estados civiles,45 - 64,417,239,178,19
Retalhuleu,Todos los estados civiles,65 y más,981,508,473,19
Retalhuleu,Todos los estados civiles,Ignorado,1,1,0,19
Retalhuleu,Soltero(a),Todas las edades,1032,563,469,19
Retalhuleu,Soltero(a),Menos de 15 años,108,65,43,19
Retalhuleu,Soltero(a),15 - 24,74,59,15,19
Retalhuleu,Soltero(a),25 - 44,146,112,34,19
Retalhuleu,Soltero(a),45 - 64,167,94,73,19
Retalhuleu,Soltero(a),65 y más,537,233,304,19
Retalhuleu,Soltero(a),Ignorado,0,0,0,19
Retalhuleu,Casado(a),Todas las edades,787,496,291,19
Retalhuleu,Casado(a),Menos de 15 años,0,0,0,19
Retalhuleu,Casado(a),15 - 24,9,4,5,19
Retalhuleu,Casado(a),25 - 44,133,94,39,19
Retalhuleu,Casado(a),45 - 64,241,143,98,19
Retalhuleu,Casado(a),65 y más,404,255,149,19
Retalhuleu,Casado(a),Ignorado,0,0,0,19
Retalhuleu,Unido(a),Todas las edades,50,24,26,19
Retalhuleu,Unido(a),Menos de 15 años,0,0,0,19
Retalhuleu,Unido(a),15 - 24,0,0,0,19
Retalhuleu,Unido(a),25 - 44,2,2,0,19
Retalhuleu,Unido(a),45 - 64,9,2,7,19
Retalhuleu,Unido(a),65 y más,39,20,19,19
Retalhuleu,Unido(a),Ignorado,0,0,0,19
Retalhuleu,Ignorado(a),Todas las edades,2,1,1,19
Retalhuleu,Ignorado(a),Menos de 15 años,0,0,0,19
Retalhuleu,Ignorado(a),15 - 24,0,0,0,19
Retalhuleu,Ignorado(a),25 - 44,0,0,0,19
Retalhuleu,Ignorado(a),45 - 64,0,0,0,19
Retalhuleu,Ignorado(a),65 y más,1,0,1,19
Retalhuleu,Ignorado(a),Ignorado,1,1,0,19
San Marcos,Todos los estados civiles,Todas las edades,4850,2729,2121,19
San Marcos,Todos los estados civiles,Menos de 15 años,283,161,122,19
San Marcos,Todos los estados civiles,15 - 24,211,138,73,19
San Marcos,Todos los estados civiles,25 - 44,707,476,231,19
San Marcos,Todos los estados civiles,45 - 64,1050,592,458,19
San Marcos,Todos los estados civiles,65 y más,2592,1357,1235,19
San Marcos,Todos los estados civiles,Ignorado,7,5,2,19
San Marcos,Soltero(a),Todas las edades,2784,1540,1244,19
San Marcos,Soltero(a),Menos de 15 años,283,161,122,19
San Marcos,Soltero(a),15 - 24,201,132,69,19
San Marcos,Soltero(a),25 - 44,464,322,142,19
San Marcos,Soltero(a),45 - 64,445,254,191,19
San Marcos,Soltero(a),65 y más,1387,669,718,19
San Marcos,Soltero(a),Ignorado,4,2,2,19
San Marcos,Casado(a),Todas las edades,1971,1140,831,19
San Marcos,Casado(a),Menos de 15 años,0,0,0,19
San Marcos,Casado(a),15 - 24,10,6,4,19
San Marcos,Casado(a),25 - 44,241,153,88,19
San Marcos,Casado(a),45 - 64,576,326,250,19
San Marcos,Casado(a),65 y más,1144,655,489,19
San Marcos,Casado(a),Ignorado,0,0,0,19
San Marcos,Unido(a),Todas las edades,91,46,45,19
San Marcos,Unido(a),Menos de 15 años,0,0,0,19
San Marcos,Unido(a),15 - 24,0,0,0,19
San Marcos,Unido(a),25 - 44,2,1,1,19
San Marcos,Unido(a),45 - 64,29,12,17,19
San Marcos,Unido(a),65 y más,60,33,27,19
San Marcos,Unido(a),Ignorado,0,0,0,19
San Marcos,Ignorado(a),Todas las edades,4,3,1,19
San Marcos,Ignorado(a),Menos de 15 años,0,0,0,19
San Marcos,Ignorado(a),15 - 24,0,0,0,19
San Marcos,Ignorado(a),25 - 44,0,0,0,19
San Marcos,Ignorado(a),45 - 64,0,0,0,19
San Marcos,Ignorado(a),65 y más,1,0,1,19
San Marcos,Ignorado(a),Ignorado,3,3,0,19
Huehuetenango,Todos los estados civiles,Todas las edades,4225,2250,1975,19
Huehuetenango,Todos los estados civiles,Menos de 15 años,291,150,141,19
Huehuetenango,Todos los estados civiles,15 - 24,233,149,84,19
Huehuetenango,Todos los estados civiles,25 - 44,600,369,231,19
Huehuetenango,Todos los estados civiles,45 - 64,900,438,462,19
Huehuetenango,Todos los estados civiles,65 y más,2199,1143,1056,19
Huehuetenango,Todos los estados civiles,Ignorado,2,1,1,19
Huehuetenango,Soltero(a),Todas las edades,2716,1428,1288,19
Huehuetenango,Soltero(a),Menos de 15 años,291,150,141,19
Huehuetenango,Soltero(a),15 - 24,214,139,75,19
Huehuetenango,Soltero(a),25 - 44,393,256,137,19
Huehuetenango,Soltero(a),45 - 64,406,198,208,19
Huehuetenango,Soltero(a),65 y más,1410,684,726,19
Huehuetenango,Soltero(a),Ignorado,2,1,1,19
Huehuetenango,Casado(a),Todas las edades,1503,818,685,19
Huehuetenango,Casado(a),Menos de 15 años,0,0,0,19
Huehuetenango,Casado(a),15 - 24,19,10,9,19
Huehuetenango,Casado(a),25 - 44,207,113,94,19
Huehuetenango,Casado(a),45 - 64,494,240,254,19
Huehuetenango,Casado(a),65 y más,783,455,328,19
Huehuetenango,Casado(a),Ignorado,0,0,0,19
Huehuetenango,Unido(a),Todas las edades,6,4,2,19
Huehuetenango,Unido(a),Menos de 15 años,0,0,0,19
Huehuetenango,Unido(a),15 - 24,0,0,0,19
Huehuetenango,Unido(a),25 - 44,0,0,0,19
Huehuetenango,Unido(a),45 - 64,0,0,0,19
Huehuetenango,Unido(a),65 y más,6,4,2,19
Huehuetenango,Unido(a),Ignorado,0,0,0,19
Huehuetenango,Ignorado(a),Todas las edades,0,0,0,19
Huehuetenango,Ignorado(a),Menos de 15 años,0,0,0,19
Huehuetenango,Ignorado(a),15 - 24,0,0,0,19
Huehuetenango,Ignorado(a),25 - 44,0,0,0,19
Huehuetenango,Ignorado(a),45 - 64,0,0,0,19
Huehuetenango,Ignorado(a),65 y más,0,0,0,19
Huehuetenango,Ignorado(a),Ignorado,0,0,0,19
Quiché,Todos los estados civiles,Todas las edades,3859,2054,1805,19
Quiché,Todos los estados civiles,Menos de 15 años,240,138,102,19
Quiché,Todos los estados civiles,15 - 24,197,124,73,19
Quiché,Todos los estados civiles,25 - 44,617,393,224,19
Quiché,Todos los estados civiles,45 - 64,894,501,393,19
Quiché,Todos los estados civiles,65 y más,1901,893,1008,19
Quiché,Todos los estados civiles,Ignorado,10,5,5,19
Quiché,Soltero(a),Todas las edades,2403,1210,1193,19
Quiché,Soltero(a),Menos de 15 años,240,138,102,19
Quiché,Soltero(a),15 - 24,175,112,63,19
Quiché,Soltero(a),25 - 44,356,236,120,19
Quiché,Soltero(a),45 - 64,436,234,202,19
Quiché,Soltero(a),65 y más,1192,488,704,19
Quiché,Soltero(a),Ignorado,4,2,2,19
Quiché,Casado(a),Todas las edades,1421,828,593,19
Quiché,Casado(a),Menos de 15 años,0,0,0,19
Quiché,Casado(a),15 - 24,22,12,10,19
Quiché,Casado(a),25 - 44,260,156,104,19
Quiché,Casado(a),45 - 64,452,263,189,19
Quiché,Casado(a),65 y más,684,394,290,19
Quiché,Casado(a),Ignorado,3,3,0,19
Quiché,Unido(a),Todas las edades,33,16,17,19
Quiché,Unido(a),Menos de 15 años,0,0,0,19
Quiché,Unido(a),15 - 24,0,0,0,19
Quiché,Unido(a),25 - 44,1,1,0,19
Quiché,Unido(a),45 - 64,5,4,1,19
Quiché,Unido(a),65 y más,25,11,14,19
Quiché,Unido(a),Ignorado,2,0,2,19
Quiché,Ignorado(a),Todas las edades,2,0,2,19
Quiché,Ignorado(a),Menos de 15 años,0,0,0,19
Quiché,Ignorado(a),15 - 24,0,0,0,19
Quiché,Ignorado(a),25 - 44,0,0,0,19
Quiché,Ignorado(a),45 - 64,1,0,1,19
Quiché,Ignorado(a),65 y más,0,0,0,19
Quiché,Ignorado(a),Ignorado,1,0,1,19
Baja Verapaz,Todos los estados civiles,Todas las edades,1413,752,661,19
Baja Verapaz,Todos los estados civiles,Menos de 15 años,150,77,73,19
Baja Verapaz,Todos los estados civiles,15 - 24,71,51,20,19
Baja Verapaz,Todos los estados civiles,25 - 44,164,98,66,19
Baja Verapaz,Todos los estados civiles,45 - 64,266,144,122,19
Baja Verapaz,Todos los estados civiles,65 y más,758,379,379,19
Baja Verapaz,Todos los estados civiles,Ignorado,4,3,1,19
Baja Verapaz,Soltero(a),Todas las edades,804,391,413,19
Baja Verapaz,Soltero(a),Menos de 15 años,150,77,73,19
Baja Verapaz,Soltero(a),15 - 24,64,48,16,19
Baja Verapaz,Soltero(a),25 - 44,83,50,33,19
Baja Verapaz,Soltero(a),45 - 64,81,35,46,19
Baja Verapaz,Soltero(a),65 y más,425,180,245,19
Baja Verapaz,Soltero(a),Ignorado,1,1,0,19
Baja Verapaz,Casado(a),Todas las edades,591,349,242,19
Baja Verapaz,Casado(a),Menos de 15 años,0,0,0,19
Baja Verapaz,Casado(a),15 - 24,7,3,4,19
Baja Verapaz,Casado(a),25 - 44,81,48,33,19
Baja Verapaz,Casado(a),45 - 64,183,108,75,19
Baja Verapaz,Casado(a),65 y más,318,189,129,19
Baja Verapaz,Casado(a),Ignorado,2,1,1,19
Baja Verapaz,Unido(a),Todas las edades,17,11,6,19
Baja Verapaz,Unido(a),Menos de 15 años,0,0,0,19
Baja Verapaz,Unido(a),15 - 24,0,0,0,19
Baja Verapaz,Unido(a),25 - 44,0,0,0,19
Baja Verapaz,Unido(a),45 - 64,2,1,1,19
Baja Verapaz,Unido(a),65 y más,15,10,5,19
Baja Verapaz,Unido(a),Ignorado,0,0,0,19
Baja Verapaz,Ignorado(a),Todas las edades,1,1,0,19
Baja Verapaz,Ignorado(a),Menos de 15 años,0,0,0,19
Baja Verapaz,Ignorado(a),15 - 24,0,0,0,19
Baja Verapaz,Ignorado(a),25 - 44,0,0,0,19
Baja Verapaz,Ignorado(a),45 - 64,0,0,0,19
Baja Verapaz,Ignorado(a),65 y más,0,0,0,19
Baja Verapaz,Ignorado(a),Ignorado,1,1,0,19
Alta Verapaz,Todos los estados civiles,Todas las edades,4917,2494,2423,19
Alta Verapaz,Todos los estados civiles,Menos de 15 años,897,501,396,19
Alta Verapaz,Todos los estados civiles,15 - 24,261,174,87,19
Alta Verapaz,Todos los estados civiles,25 - 44,646,383,263,19
Alta Verapaz,Todos los estados civiles,45 - 64,974,428,546,19
Alta Verapaz,Todos los estados civiles,65 y más,2120,999,1121,19
Alta Verapaz,Todos los estados civiles,Ignorado,19,9,10,19
Alta Verapaz,Soltero(a),Todas las edades,2721,1320,1401,19
Alta Verapaz,Soltero(a),Menos de 15 años,897,501,396,19
Alta Verapaz,Soltero(a),15 - 24,242,164,78,19
Alta Verapaz,Soltero(a),25 - 44,347,212,135,19
Alta Verapaz,Soltero(a),45 - 64,276,119,157,19
Alta Verapaz,Soltero(a),65 y más,949,322,627,19
Alta Verapaz,Soltero(a),Ignorado,10,2,8,19
Alta Verapaz,Casado(a),Todas las edades,2112,1130,982,19
Alta Verapaz,Casado(a),Menos de 15 años,0,0,0,19
Alta Verapaz,Casado(a),15 - 24,19,10,9,19
Alta Verapaz,Casado(a),25 - 44,296,170,126,19
Alta Verapaz,Casado(a),45 - 64,674,301,373,19
Alta Verapaz,Casado(a),65 y más,1116,643,473,19
Alta Verapaz,Casado(a),Ignorado,7,6,1,19
Alta Verapaz,Unido(a),Todas las edades,82,43,39,19
Alta Verapaz,Unido(a),Menos de 15 años,0,0,0,19
Alta Verapaz,Unido(a),15 - 24,0,0,0,19
Alta Verapaz,Unido(a),25 - 44,3,1,2,19
Alta Verapaz,Unido(a),45 - 64,24,8,16,19
Alta Verapaz,Unido(a),65 y más,55,34,21,19
Alta Verapaz,Unido(a),Ignorado,0,0,0,19
Alta Verapaz,Ignorado(a),Todas las edades,2,1,1,19
Alta Verapaz,Ignorado(a),Menos de 15 años,0,0,0,19
Alta Verapaz,Ignorado(a),15 - 24,0,0,0,19
Alta Verapaz,Ignorado(a),25 - 44,0,0,0,19
Alta Verapaz,Ignorado(a),45 - 64,0,0,0,19
Alta Verapaz,Ignorado(a),65 y más,0,0,0,19
Alta Verapaz,Ignorado(a),Ignorado,2,1,1,19
Petén,Todos los estados civiles,Todas las edades,2189,1263,926,19
Petén,Todos los estados civiles,Menos de 15 años,178,99,79,19
Petén,Todos los estados civiles,15 - 24,164,120,44,19
Petén,Todos los estados civiles,25 - 44,410,271,139,19
Petén,Todos los estados civiles,45 - 64,511,265,246,19
Petén,Todos los estados civiles,65 y más,917,500,417,19
Petén,Todos los estados civiles,Ignorado,9,8,1,19
Petén,Soltero(a),Todas las edades,1417,817,600,19
Petén,Soltero(a),Menos de 15 años,178,99,79,19
Petén,Soltero(a),15 - 24,157,117,40,19
Petén,Soltero(a),25 - 44,277,191,86,19
Petén,Soltero(a),45 - 64,219,119,100,19
Petén,Soltero(a),65 y más,583,288,295,19
Petén,Soltero(a),Ignorado,3,3,0,19
Petén,Casado(a),Todas las edades,646,388,258,19
Petén,Casado(a),Menos de 15 años,0,0,0,19
Petén,Casado(a),15 - 24,7,3,4,19
Petén,Casado(a),25 - 44,118,76,42,19
Petén,Casado(a),45 - 64,244,126,118,19
Petén,Casado(a),65 y más,277,183,94,19
Petén,Casado(a),Ignorado,0,0,0,19
Petén,Unido(a),Todas las edades,117,52,65,19
Petén,Unido(a),Menos de 15 años,0,0,0,19
Petén,Unido(a),15 - 24,0,0,0,19
Petén,Unido(a),25 - 44,15,4,11,19
Petén,Unido(a),45 - 64,47,20,27,19
Petén,Unido(a),65 y más,55,28,27,19
Petén,Unido(a),Ignorado,0,0,0,19
Petén,Ignorado(a),Todas las edades,9,6,3,19
Petén,Ignorado(a),Menos de 15 años,0,0,0,19
Petén,Ignorado(a),15 - 24,0,0,0,19
Petén,Ignorado(a),25 - 44,0,0,0,19
Petén,Ignorado(a),45 - 64,1,0,1,19
Petén,Ignorado(a),65 y más,2,1,1,19
Petén,Ignorado(a),Ignorado,6,5,1,19
Izabal,Todos los estados civiles,Todas las edades,2152,1258,894,19
Izabal,Todos los estados civiles,Menos de 15 años,186,106,80,19
Izabal,Todos los estados civiles,15 - 24,152,111,41,19
Izabal,Todos los estados civiles,25 - 44,312,219,93,19
Izabal,Todos los estados civiles,45 - 64,515,271,244,19
Izabal,Todos los estados civiles,65 y más,983,549,434,19
Izabal,Todos los estados civiles,Ignorado,4,2,2,19
Izabal,Soltero(a),Todas las edades,1436,814,622,19
Izabal,Soltero(a),Menos de 15 años,186,106,80,19
Izabal,Soltero(a),15 - 24,149,109,40,19
Izabal,Soltero(a),25 - 44,218,158,60,19
Izabal,Soltero(a),45 - 64,273,141,132,19
Izabal,Soltero(a),65 y más,606,298,308,19
Izabal,Soltero(a),Ignorado,4,2,2,19
Izabal,Casado(a),Todas las edades,677,422,255,19
Izabal,Casado(a),Menos de 15 años,0,0,0,19
Izabal,Casado(a),15 - 24,3,2,1,19
Izabal,Casado(a),25 - 44,92,60,32,19
Izabal,Casado(a),45 - 64,235,126,109,19
Izabal,Casado(a),65 y más,347,234,113,19
Izabal,Casado(a),Ignorado,0,0,0,19
Izabal,Unido(a),Todas las edades,36,21,15,19
Izabal,Unido(a),Menos de 15 años,0,0,0,19
Izabal,Unido(a),15 - 24,0,0,0,19
Izabal,Unido(a),25 - 44,0,0,0,19
Izabal,Unido(a),45 - 64,7,4,3,19
Izabal,Unido(a),65 y más,29,17,12,19
Izabal,Unido(a),Ignorado,0,0,0,19
Izabal,Ignorado(a),Todas las edades,3,1,2,19
Izabal,Ignorado(a),Menos de 15 años,0,0,0,19
Izabal,Ignorado(a),15 - 24,0,0,0,19
Izabal,Ignorado(a),25 - 44,2,1,1,19
Izabal,Ignorado(a),45 - 64,0,0,0,19
Izabal,Ignorado(a),65 y más,1,0,1,19
Izabal,Ignorado(a),Ignorado,0,0,0,19
Zacapa,Todos los estados civiles,Todas las edades,1520,839,681,19
Zacapa,Todos los estados civiles,Menos de 15 años,75,40,35,19
Zacapa,Todos los estados civiles,15 - 24,85,69,16,19
Zacapa,Todos los estados civiles,25 - 44,235,166,69,19
Zacapa,Todos los estados civiles,45 - 64,312,170,142,19
Zacapa,Todos los estados civiles,65 y más,810,392,418,19
Zacapa,Todos los estados civiles,Ignorado,3,2,1,19
Zacapa,Soltero(a),Todas las edades,961,528,433,19
Zacapa,Soltero(a),Menos de 15 años,75,40,35,19
Zacapa,Soltero(a),15 - 24,81,66,15,19
Zacapa,Soltero(a),25 - 44,162,125,37,19
Zacapa,Soltero(a),45 - 64,152,82,70,19
Zacapa,Soltero(a),65 y más,490,215,275,19
Zacapa,Soltero(a),Ignorado,1,0,1,19
Zacapa,Casado(a),Todas las edades,553,307,246,19
Zacapa,Casado(a),Menos de 15 años,0,0,0,19
Zacapa,Casado(a),15 - 24,4,3,1,19
Zacapa,Casado(a),25 - 44,71,39,32,19
Zacapa,Casado(a),45 - 64,159,87,72,19
Zacapa,Casado(a),65 y más,317,176,141,19
Zacapa,Casado(a),Ignorado,2,2,0,19
Zacapa,Unido(a),Todas las edades,4,2,2,19
Zacapa,Unido(a),Menos de 15 años,0,0,0,19
Zacapa,Unido(a),15 - 24,0,0,0,19
Zacapa,Unido(a),25 - 44,0,0,0,19
Zacapa,Unido(a),45 - 64,1,1,0,19
Zacapa,Unido(a),65 y más,3,1,2,19
Zacapa,Unido(a),Ignorado,0,0,0,19
Zacapa,Ignorado(a),Todas las edades,2,2,0,19
Zacapa,Ignorado(a),Menos de 15 años,0,0,0,19
Zacapa,Ignorado(a),15 - 24,0,0,0,19
Zacapa,Ignorado(a),25 - 44,2,2,0,19
Zacapa,Ignorado(a),45 - 64,0,0,0,19
Zacapa,Ignorado(a),65 y más,0,0,0,19
Zacapa,Ignorado(a),Ignorado,0,0,0,19
Chiquimula,Todos los estados civiles,Todas las edades,2070,1159,911,19
Chiquimula,Todos los estados civiles,Menos de 15 años,122,57,65,19
Chiquimula,Todos los estados civiles,15 - 24,109,77,32,19
Chiquimula,Todos los estados civiles,25 - 44,294,191,103,19
Chiquimula,Todos los estados civiles,45 - 64,438,244,194,19
Chiquimula,Todos los estados civiles,65 y más,1103,589,514,19
Chiquimula,Todos los estados civiles,Ignorado,4,1,3,19
Chiquimula,Soltero(a),Todas las edades,1325,704,621,19
Chiquimula,Soltero(a),Menos de 15 años,122,57,65,19
Chiquimula,Soltero(a),15 - 24,101,74,27,19
Chiquimula,Soltero(a),25 - 44,215,147,68,19
Chiquimula,Soltero(a),45 - 64,213,115,98,19
Chiquimula,Soltero(a),65 y más,672,311,361,19
Chiquimula,Soltero(a),Ignorado,2,0,2,19
Chiquimula,Casado(a),Todas las edades,725,445,280,19
Chiquimula,Casado(a),Menos de 15 años,0,0,0,19
Chiquimula,Casado(a),15 - 24,8,3,5,19
Chiquimula,Casado(a),25 - 44,79,44,35,19
Chiquimula,Casado(a),45 - 64,222,129,93,19
Chiquimula,Casado(a),65 y más,416,269,147,19
Chiquimula,Casado(a),Ignorado,0,0,0,19
Chiquimula,Unido(a),Todas las edades,12,7,5,19
Chiquimula,Unido(a),Menos de 15 años,0,0,0,19
Chiquimula,Unido(a),15 - 24,0,0,0,19
Chiquimula,Unido(a),25 - 44,0,0,0,19
Chiquimula,Unido(a),45 - 64,0,0,0,19
Chiquimula,Unido(a),65 y más,12,7,5,19
Chiquimula,Unido(a),Ignorado,0,0,0,19
Chiquimula,Ignorado(a),Todas las edades,8,3,5,19
Chiquimula,Ignorado(a),Menos de 15 años,0,0,0,19
Chiquimula,Ignorado(a),15 - 24,0,0,0,19
Chiquimula,Ignorado(a),25 - 44,0,0,0,19
Chiquimula,Ignorado(a),45 - 64,3,0,3,19
Chiquimula,Ignorado(a),65 y más,3,2,1,19
Chiquimula,Ignorado(a),Ignorado,2,1,1,19
Jalapa,Todos los estados civiles,Todas las edades,1739,958,781,19
Jalapa,Todos los estados civiles,Menos de 15 años,145,76,69,19
Jalapa,Todos los estados civiles,15 - 24,114,88,26,19
Jalapa,Todos los estados civiles,25 - 44,298,205,93,19
Jalapa,Todos los estados civiles,45 - 64,341,174,167,19
Jalapa,Todos los estados civiles,65 y más,838,414,424,19
Jalapa,Todos los estados civiles,Ignorado,3,1,2,19
Jalapa,Soltero(a),Todas las edades,966,519,447,19
Jalapa,Soltero(a),Menos de 15 años,145,76,69,19
Jalapa,Soltero(a),15 - 24,110,85,25,19
Jalapa,Soltero(a),25 - 44,196,145,51,19
Jalapa,Soltero(a),45 - 64,111,48,63,19
Jalapa,Soltero(a),65 y más,401,164,237,19
Jalapa,Soltero(a),Ignorado,3,1,2,19
Jalapa,Casado(a),Todas las edades,765,435,330,19
Jalapa,Casado(a),Menos de 15 años,0,0,0,19
Jalapa,Casado(a),15 - 24,4,3,1,19
Jalapa,Casado(a),25 - 44,101,59,42,19
Jalapa,Casado(a),45 - 64,230,126,104,19
Jalapa,Casado(a),65 y más,430,247,183,19
Jalapa,Casado(a),Ignorado,0,0,0,19
Jalapa,Unido(a),Todas las edades,8,4,4,19
Jalapa,Unido(a),Menos de 15 años,0,0,0,19
Jalapa,Unido(a),15 - 24,0,0,0,19
Jalapa,Unido(a),25 - 44,1,1,0,19
Jalapa,Unido(a),45 - 64,0,0,0,19
Jalapa,Unido(a),65 y más,7,3,4,19
Jalapa,Unido(a),Ignorado,0,0,0,19
Jalapa,Ignorado(a),Todas las edades,0,0,0,19
Jalapa,Ignorado(a),Menos de 15 años,0,0,0,19
Jalapa,Ignorado(a),15 - 24,0,0,0,19
Jalapa,Ignorado(a),25 - 44,0,0,0,19
Jalapa,Ignorado(a),45 - 64,0,0,0,19
Jalapa,Ignorado(a),65 y más,0,0,0,19
Jalapa,Ignorado(a),Ignorado,0,0,0,19
Jutiapa,Todos los estados civiles,Todas las edades,2738,1492,1246,19
Jutiapa,Todos los estados civiles,Menos de 15 años,66,35,31,19
Jutiapa,Todos los estados civiles,15 - 24,143,91,52,19
Jutiapa,Todos los estados civiles,25 - 44,371,253,118,19
Jutiapa,Todos los estados civiles,45 - 64,606,302,304,19
Jutiapa,Todos los estados civiles,65 y más,1552,811,741,19
Jutiapa,Todos los estados civiles,Ignorado,0,0,0,19
Jutiapa,Soltero(a),Todas las edades,1641,838,803,19
Jutiapa,Soltero(a),Menos de 15 años,66,35,31,19
Jutiapa,Soltero(a),15 - 24,133,86,47,19
Jutiapa,Soltero(a),25 - 44,256,177,79,19
Jutiapa,Soltero(a),45 - 64,280,138,142,19
Jutiapa,Soltero(a),65 y más,906,402,504,19
Jutiapa,Soltero(a),Ignorado,0,0,0,19
Jutiapa,Casado(a),Todas las edades,1075,640,435,19
Jutiapa,Casado(a),Menos de 15 años,0,0,0,19
Jutiapa,Casado(a),15 - 24,10,5,5,19
Jutiapa,Casado(a),25 - 44,113,74,39,19
Jutiapa,Casado(a),45 - 64,322,164,158,19
Jutiapa,Casado(a),65 y más,630,397,233,19
Jutiapa,Casado(a),Ignorado,0,0,0,19
Jutiapa,Unido(a),Todas las edades,21,13,8,19
Jutiapa,Unido(a),Menos de 15 años,0,0,0,19
Jutiapa,Unido(a),15 - 24,0,0,0,19
Jutiapa,Unido(a),25 - 44,1,1,0,19
Jutiapa,Unido(a),45 - 64,4,0,4,19
Jutiapa,Unido(a),65 y más,16,12,4,19
Jutiapa,Unido(a),Ignorado,0,0,0,19
Jutiapa,Ignorado(a),Todas las edades,1,1,0,19
Jutiapa,Ignorado(a),Menos de 15 años,0,0,0,19
Jutiapa,Ignorado(a),15 - 24,0,0,0,19
Jutiapa,Ignorado(a),25 - 44,1,1,0,19
Jutiapa,Ignorado(a),45 - 64,0,0,0,19
Jutiapa,Ignorado(a),65 y más,0,0,0,19
Jutiapa,Ignorado(a),Ignorado,0,0,0,19
Extranjero,Todos los estados civiles,Todas las edades,133,91,42,19
Extranjero,Todos los estados civiles,Menos de 15 años,3,2,1,19
Extranjero,Todos los estados civiles,15 - 24,9,4,5,19
Extranjero,Todos los estados civiles,25 - 44,40,33,7,19
Extranjero,Todos los estados civiles,45 - 64,47,38,9,19
Extranjero,Todos los estados civiles,65 y más,30,11,19,19
Extranjero,Todos los estados civiles,Ignorado,4,3,1,19
Extranjero,Soltero(a),Todas las edades,91,62,29,19
Extranjero,Soltero(a),Menos de 15 años,3,2,1,19
Extranjero,Soltero(a),15 - 24,7,3,4,19
Extranjero,Soltero(a),25 - 44,31,26,5,19
Extranjero,Soltero(a),45 - 64,29,24,5,19
Extranjero,Soltero(a),65 y más,20,6,14,19
Extranjero,Soltero(a),Ignorado,1,1,0,19
Extranjero,Casado(a),Todas las edades,25,21,4,19
Extranjero,Casado(a),Menos de 15 años,0,0,0,19
Extranjero,Casado(a),15 - 24,0,0,0,19
Extranjero,Casado(a),25 - 44,5,5,0,19
Extranjero,Casado(a),45 - 64,11,11,0,19
Extranjero,Casado(a),65 y más,8,5,3,19
Extranjero,Casado(a),Ignorado,1,0,1,19
Extranjero,Unido(a),Todas las edades,0,0,0,19
Extranjero,Unido(a),Menos de 15 años,0,0,0,19
Extranjero,Unido(a),15 - 24,0,0,0,19
Extranjero,Unido(a),25 - 44,0,0,0,19
Extranjero,Unido(a),45 - 64,0,0,0,19
Extranjero,Unido(a),65 y más,0,0,0,19
Extranjero,Unido(a),Ignorado,0,0,0,19
Extranjero,Ignorado(a),Todas las edades,17,8,9,19
Extranjero,Ignorado(a),Menos de 15 años,0,0,0,19
Extranjero,Ignorado(a),15 - 24,2,1,1,19
Extranjero,Ignorado(a),25 - 44,4,2,2,19
Extranjero,Ignorado(a),45 - 64,7,3,4,19
Extranjero,Ignorado(a),65 y más,2,0,2,19
Extranjero,Ignorado(a),Ignorado,2,2,0,19
Ignorado,Todos los estados civiles,Todas las edades,8455,4861,3594,19
Ignorado,Todos los estados civiles,Menos de 15 años,6649,3652,2997,19
Ignorado,Todos los estados civiles,15 - 24,797,564,233,19
Ignorado,Todos los estados civiles,25 - 44,180,137,43,19
Ignorado,Todos los estados civiles,45 - 64,205,149,56,19
Ignorado,Todos los estados civiles,65 y más,398,187,211,19
Ignorado,Todos los estados civiles,Ignorado,226,172,54,19
Ignorado,Todos los estados civiles,Todas las edades,8052,4552,3500,19
Ignorado,Soltero(a),Menos de 15 años,6649,3652,2997,19
Ignorado,Soltero(a),15 - 24,774,546,228,19
Ignorado,Soltero(a),25 - 44,126,96,30,19
Ignorado,Soltero(a),45 - 64,139,99,40,19
Ignorado,Soltero(a),65 y más,337,144,193,19
Ignorado,Soltero(a),Ignorado,27,15,12,19
Ignorado,Casado(a),Todas las edades,26,20,6,19
Ignorado,Casado(a),Menos de 15 años,0,0,0,19
Ignorado,Casado(a),15 - 24,0,0,0,19
Ignorado,Casado(a),25 - 44,1,1,0,19
Ignorado,Casado(a),45 - 64,13,11,2,19
Ignorado,Casado(a),65 y más,12,8,4,19
Ignorado,Casado(a),Ignorado,0,0,0,19
Ignorado,Unido(a),Todas las edades,0,0,0,19
Ignorado,Unido(a),Menos de 15 años,0,0,0,19
Ignorado,Unido(a),15 - 24,0,0,0,19
Ignorado,Unido(a),25 - 44,0,0,0,19
Ignorado,Unido(a),45 - 64,0,0,0,19
Ignorado,Unido(a),65 y más,0,0,0,19
Ignorado,Unido(a),Ignorado,0,0,0,19
Ignorado,Ignorado(a),Todas las edades,377,289,88,19
Ignorado,Ignorado(a),Menos de 15 años,0,0,0,19
Ignorado,Ignorado(a),15 - 24,23,18,5,19
Ignorado,Ignorado(a),25 - 44,53,40,13,19
Ignorado,Ignorado(a),45 - 64,53,39,14,19
Ignorado,Ignorado(a),65 y más,49,35,14,19
Ignorado,Ignorado(a),Ignorado,199,157,42,19
Todos los departamentos,Todos los estados civiles,Todas las edades,96001,55184,40817,20
Todos los departamentos,Todos los estados civiles,Menos de 15 años,7859,4383,3476,20
Todos los departamentos,Todos los estados civiles,15 - 24,4315,3030,1285,20
Todos los departamentos,Todos los estados civiles,25 - 44,12011,8213,3798,20
Todos los departamentos,Todos los estados civiles,45 - 64,23125,13370,9755,20
Todos los departamentos,Todos los estados civiles,65 y más,48350,25959,22391,20
Todos los departamentos,Todos los estados civiles,Ignorado,341,229,112,20
Todos los departamentos,Soltero(a),Todas las edades,53243,28523,24720,20
Todos los departamentos,Soltero(a),Menos de 15 años,7858,4382,3476,20
Todos los departamentos,Soltero(a),15 - 24,4049,2876,1173,20
Todos los departamentos,Soltero(a),25 - 44,7193,5049,2144,20
Todos los departamentos,Soltero(a),45 - 64,9246,5042,4204,20
Todos los departamentos,Soltero(a),65 y más,24797,11119,13678,20
Todos los departamentos,Soltero(a),Ignorado,100,55,45,20
Todos los departamentos,Casado(a),Todas las edades,41132,25636,15496,20
Todos los departamentos,Casado(a),Menos de 15 años,0,0,0,20
Todos los departamentos,Casado(a),15 - 24,226,125,101,20
Todos los departamentos,Casado(a),25 - 44,4702,3091,1611,20
Todos los departamentos,Casado(a),45 - 64,13493,8098,5395,20
Todos los departamentos,Casado(a),65 y más,22676,14299,8377,20
Todos los departamentos,Casado(a),Ignorado,35,23,12,20
Todos los departamentos,Unido(a),Todas las edades,1060,630,430,20
Todos los departamentos,Unido(a),Menos de 15 años,0,0,0,20
Todos los departamentos,Unido(a),15 - 24,0,0,0,20
Todos los departamentos,Unido(a),25 - 44,25,11,14,20
Todos los departamentos,Unido(a),45 - 64,264,145,119,20
Todos los departamentos,Unido(a),65 y más,770,474,296,20
Todos los departamentos,Unido(a),Ignorado,1,0,1,20
Todos los departamentos,Ignorado(a),Todas las edades,566,395,171,20
Todos los departamentos,Ignorado(a),Menos de 15 años,1,1,0,20
Todos los departamentos,Ignorado(a),15 - 24,40,29,11,20
Todos los departamentos,Ignorado(a),25 - 44,91,62,29,20
Todos los departamentos,Ignorado(a),45 - 64,122,85,37,20
Todos los departamentos,Ignorado(a),65 y más,107,67,40,20
Todos los departamentos,Ignorado(a),Ignorado,205,151,54,20
Guatemala,Todos los estados civiles,Todas las edades,23719,13625,10094,20
Guatemala,Todos los estados civiles,Menos de 15 años,178,94,84,20
Guatemala,Todos los estados civiles,15 - 24,882,658,224,20
Guatemala,Todos los estados civiles,25 - 44,2964,2120,844,20
Guatemala,Todos los estados civiles,45 - 64,6784,4113,2671,20
Guatemala,Todos los estados civiles,65 y más,12883,6622,6261,20
Guatemala,Todos los estados civiles,Ignorado,28,18,10,20
Guatemala,Soltero(a),Todas las edades,12386,6428,5958,20
Guatemala,Soltero(a),Menos de 15 años,178,94,84,20
Guatemala,Soltero(a),15 - 24,836,628,208,20
Guatemala,Soltero(a),25 - 44,1862,1349,513,20
Guatemala,Soltero(a),45 - 64,2960,1684,1276,20
Guatemala,Soltero(a),65 y más,6540,2666,3874,20
Guatemala,Soltero(a),Ignorado,10,7,3,20
Guatemala,Casado(a),Todas las edades,11111,7073,4038,20
Guatemala,Casado(a),Menos de 15 años,0,0,0,20
Guatemala,Casado(a),15 - 24,38,24,14,20
Guatemala,Casado(a),25 - 44,1064,748,316,20
Guatemala,Casado(a),45 - 64,3766,2398,1368,20
Guatemala,Casado(a),65 y más,6241,3902,2339,20
Guatemala,Casado(a),Ignorado,2,1,1,20
Guatemala,Unido(a),Todas las edades,53,30,23,20
Guatemala,Unido(a),Menos de 15 años,0,0,0,20
Guatemala,Unido(a),15 - 24,0,0,0,20
Guatemala,Unido(a),25 - 44,1,0,1,20
Guatemala,Unido(a),45 - 64,8,7,1,20
Guatemala,Unido(a),65 y más,44,23,21,20
Guatemala,Unido(a),Ignorado,0,0,0,20
Guatemala,Ignorado(a),Todas las edades,169,94,75,20
Guatemala,Ignorado(a),Menos de 15 años,0,0,0,20
Guatemala,Ignorado(a),15 - 24,8,6,2,20
Guatemala,Ignorado(a),25 - 44,37,23,14,20
Guatemala,Ignorado(a),45 - 64,50,24,26,20
Guatemala,Ignorado(a),65 y más,58,31,27,20
Guatemala,Ignorado(a),Ignorado,16,10,6,20
El Progreso,Todos los estados civiles,Todas las edades,1214,695,519,20
El Progreso,Todos los estados civiles,Menos de 15 años,40,23,17,20
El Progreso,Todos los estados civiles,15 - 24,38,29,9,20
El Progreso,Todos los estados civiles,25 - 44,129,83,46,20
El Progreso,Todos los estados civiles,45 - 64,284,161,123,20
El Progreso,Todos los estados civiles,65 y más,723,399,324,20
El Progreso,Todos los estados civiles,Ignorado,0,0,0,20
El Progreso,Soltero(a),Todas las edades,645,353,292,20
El Progreso,Soltero(a),Menos de 15 años,40,23,17,20
El Progreso,Soltero(a),15 - 24,36,27,9,20
El Progreso,Soltero(a),25 - 44,82,52,30,20
El Progreso,Soltero(a),45 - 64,131,72,59,20
El Progreso,Soltero(a),65 y más,356,179,177,20
El Progreso,Soltero(a),Ignorado,0,0,0,20
El Progreso,Casado(a),Todas las edades,560,338,222,20
El Progreso,Casado(a),Menos de 15 años,0,0,0,20
El Progreso,Casado(a),15 - 24,2,2,0,20
El Progreso,Casado(a),25 - 44,47,31,16,20
El Progreso,Casado(a),45 - 64,153,89,64,20
El Progreso,Casado(a),65 y más,358,216,142,20
El Progreso,Casado(a),Ignorado,0,0,0,20
El Progreso,Unido(a),Todas las edades,8,3,5,20
El Progreso,Unido(a),Menos de 15 años,0,0,0,20
El Progreso,Unido(a),15 - 24,0,0,0,20
El Progreso,Unido(a),25 - 44,0,0,0,20
El Progreso,Unido(a),45 - 64,0,0,0,20
El Progreso,Unido(a),65 y más,8,3,5,20
El Progreso,Unido(a),Ignorado,0,0,0,20
El Progreso,Ignorado(a),Todas las edades,1,1,0,20
El Progreso,Ignorado(a),Menos de 15 años,0,0,0,20
El Progreso,Ignorado(a),15 - 24,0,0,0,20
El Progreso,Ignorado(a),25 - 44,0,0,0,20
El Progreso,Ignorado(a),45 - 64,0,0,0,20
El Progreso,Ignorado(a),65 y más,1,1,0,20
El Progreso,Ignorado(a),Ignorado,0,0,0,20
Sacatepéquez,Todos los estados civiles,Todas las edades,2061,1181,880,20
Sacatepéquez,Todos los estados civiles,Menos de 15 años,6,2,4,20
Sacatepéquez,Todos los estados civiles,15 - 24,51,34,17,20
Sacatepéquez,Todos los estados civiles,25 - 44,262,184,78,20
Sacatepéquez,Todos los estados civiles,45 - 64,562,316,246,20
Sacatepéquez,Todos los estados civiles,65 y más,1169,637,532,20
Sacatepéquez,Todos los estados civiles,Ignorado,11,8,3,20
Sacatepéquez,Soltero(a),Todas las edades,820,426,394,20
Sacatepéquez,Soltero(a),Menos de 15 años,6,2,4,20
Sacatepéquez,Soltero(a),15 - 24,47,32,15,20
Sacatepéquez,Soltero(a),25 - 44,135,95,40,20
Sacatepéquez,Soltero(a),45 - 64,144,76,68,20
Sacatepéquez,Soltero(a),65 y más,485,218,267,20
Sacatepéquez,Soltero(a),Ignorado,3,3,0,20
Sacatepéquez,Casado(a),Todas las edades,1225,742,483,20
Sacatepéquez,Casado(a),Menos de 15 años,0,0,0,20
Sacatepéquez,Casado(a),15 - 24,4,2,2,20
Sacatepéquez,Casado(a),25 - 44,127,89,38,20
Sacatepéquez,Casado(a),45 - 64,416,238,178,20
Sacatepéquez,Casado(a),65 y más,678,413,265,20
Sacatepéquez,Casado(a),Ignorado,0,0,0,20
Sacatepéquez,Unido(a),Todas las edades,3,3,0,20
Sacatepéquez,Unido(a),Menos de 15 años,0,0,0,20
Sacatepéquez,Unido(a),15 - 24,0,0,0,20
Sacatepéquez,Unido(a),25 - 44,0,0,0,20
Sacatepéquez,Unido(a),45 - 64,0,0,0,20
Sacatepéquez,Unido(a),65 y más,3,3,0,20
Sacatepéquez,Unido(a),Ignorado,0,0,0,20
Sacatepéquez,Ignorado(a),Todas las edades,13,10,3,20
Sacatepéquez,Ignorado(a),Menos de 15 años,0,0,0,20
Sacatepéquez,Ignorado(a),15 - 24,0,0,0,20
Sacatepéquez,Ignorado(a),25 - 44,0,0,0,20
Sacatepéquez,Ignorado(a),45 - 64,2,2,0,20
Sacatepéquez,Ignorado(a),65 y más,3,3,0,20
Sacatepéquez,Ignorado(a),Ignorado,8,5,3,20
Chimaltenango,Todos los estados civiles,Todas las edades,3113,1709,1404,20
Chimaltenango,Todos los estados civiles,Menos de 15 años,83,51,32,20
Chimaltenango,Todos los estados civiles,15 - 24,121,90,31,20
Chimaltenango,Todos los estados civiles,25 - 44,461,316,145,20
Chimaltenango,Todos los estados civiles,45 - 64,811,451,360,20
Chimaltenango,Todos los estados civiles,65 y más,1634,799,835,20
Chimaltenango,Todos los estados civiles,Ignorado,3,2,1,20
Chimaltenango,Soltero(a),Todas las edades,1291,655,636,20
Chimaltenango,Soltero(a),Menos de 15 años,83,51,32,20
Chimaltenango,Soltero(a),15 - 24,108,82,26,20
Chimaltenango,Soltero(a),25 - 44,225,163,62,20
Chimaltenango,Soltero(a),45 - 64,194,97,97,20
Chimaltenango,Soltero(a),65 y más,680,262,418,20
Chimaltenango,Soltero(a),Ignorado,1,0,1,20
Chimaltenango,Casado(a),Todas las edades,1816,1050,766,20
Chimaltenango,Casado(a),Menos de 15 años,0,0,0,20
Chimaltenango,Casado(a),15 - 24,13,8,5,20
Chimaltenango,Casado(a),25 - 44,236,153,83,20
Chimaltenango,Casado(a),45 - 64,617,354,263,20
Chimaltenango,Casado(a),65 y más,949,534,415,20
Chimaltenango,Casado(a),Ignorado,1,1,0,20
Chimaltenango,Unido(a),Todas las edades,5,3,2,20
Chimaltenango,Unido(a),Menos de 15 años,0,0,0,20
Chimaltenango,Unido(a),15 - 24,0,0,0,20
Chimaltenango,Unido(a),25 - 44,0,0,0,20
Chimaltenango,Unido(a),45 - 64,0,0,0,20
Chimaltenango,Unido(a),65 y más,5,3,2,20
Chimaltenango,Unido(a),Ignorado,0,0,0,20
Chimaltenango,Ignorado(a),Todas las edades,1,1,0,20
Chimaltenango,Ignorado(a),Menos de 15 años,0,0,0,20
Chimaltenango,Ignorado(a),15 - 24,0,0,0,20
Chimaltenango,Ignorado(a),25 - 44,0,0,0,20
Chimaltenango,Ignorado(a),45 - 64,0,0,0,20
Chimaltenango,Ignorado(a),65 y más,0,0,0,20
Chimaltenango,Ignorado(a),Ignorado,1,1,0,20
Escuintla,Todos los estados civiles,Todas las edades,5333,3237,2096,20
Escuintla,Todos los estados civiles,Menos de 15 años,29,16,13,20
Escuintla,Todos los estados civiles,15 - 24,244,190,54,20
Escuintla,Todos los estados civiles,25 - 44,784,576,208,20
Escuintla,Todos los estados civiles,45 - 64,1567,894,673,20
Escuintla,Todos los estados civiles,65 y más,2701,1557,1144,20
Escuintla,Todos los estados civiles,Ignorado,8,4,4,20
Escuintla,Soltero(a),Todas las edades,3014,1764,1250,20
Escuintla,Soltero(a),Menos de 15 años,29,16,13,20
Escuintla,Soltero(a),15 - 24,237,187,50,20
Escuintla,Soltero(a),25 - 44,533,401,132,20
Escuintla,Soltero(a),45 - 64,691,380,311,20
Escuintla,Soltero(a),65 y más,1522,780,742,20
Escuintla,Soltero(a),Ignorado,2,0,2,20
Escuintla,Casado(a),Todas las edades,2294,1454,840,20
Escuintla,Casado(a),Menos de 15 años,0,0,0,20
Escuintla,Casado(a),15 - 24,7,3,4,20
Escuintla,Casado(a),25 - 44,249,173,76,20
Escuintla,Casado(a),45 - 64,871,511,360,20
Escuintla,Casado(a),65 y más,1166,767,399,20
Escuintla,Casado(a),Ignorado,1,0,1,20
Escuintla,Unido(a),Todas las edades,16,11,5,20
Escuintla,Unido(a),Menos de 15 años,0,0,0,20
Escuintla,Unido(a),15 - 24,0,0,0,20
Escuintla,Unido(a),25 - 44,0,0,0,20
Escuintla,Unido(a),45 - 64,5,3,2,20
Escuintla,Unido(a),65 y más,11,8,3,20
Escuintla,Unido(a),Ignorado,0,0,0,20
Escuintla,Ignorado(a),Todas las edades,9,8,1,20
Escuintla,Ignorado(a),Menos de 15 años,0,0,0,20
Escuintla,Ignorado(a),15 - 24,0,0,0,20
Escuintla,Ignorado(a),25 - 44,2,2,0,20
Escuintla,Ignorado(a),45 - 64,0,0,0,20
Escuintla,Ignorado(a),65 y más,2,2,0,20
Escuintla,Ignorado(a),Ignorado,5,4,1,20
Santa Rosa,Todos los estados civiles,Todas las edades,2386,1408,978,20
Santa Rosa,Todos los estados civiles,Menos de 15 años,11,8,3,20
Santa Rosa,Todos los estados civiles,15 - 24,121,91,30,20
Santa Rosa,Todos los estados civiles,25 - 44,313,206,107,20
Santa Rosa,Todos los estados civiles,45 - 64,563,319,244,20
Santa Rosa,Todos los estados civiles,65 y más,1373,781,592,20
Santa Rosa,Todos los estados civiles,Ignorado,5,3,2,20
Santa Rosa,Soltero(a),Todas las edades,1335,764,571,20
Santa Rosa,Soltero(a),Menos de 15 años,11,8,3,20
Santa Rosa,Soltero(a),15 - 24,116,88,28,20
Santa Rosa,Soltero(a),25 - 44,206,139,67,20
Santa Rosa,Soltero(a),45 - 64,250,142,108,20
Santa Rosa,Soltero(a),65 y más,749,386,363,20
Santa Rosa,Soltero(a),Ignorado,3,1,2,20
Santa Rosa,Casado(a),Todas las edades,1031,634,397,20
Santa Rosa,Casado(a),Menos de 15 años,0,0,0,20
Santa Rosa,Casado(a),15 - 24,5,3,2,20
Santa Rosa,Casado(a),25 - 44,107,67,40,20
Santa Rosa,Casado(a),45 - 64,308,175,133,20
Santa Rosa,Casado(a),65 y más,610,388,222,20
Santa Rosa,Casado(a),Ignorado,1,1,0,20
Santa Rosa,Unido(a),Todas las edades,17,7,10,20
Santa Rosa,Unido(a),Menos de 15 años,0,0,0,20
Santa Rosa,Unido(a),15 - 24,0,0,0,20
Santa Rosa,Unido(a),25 - 44,0,0,0,20
Santa Rosa,Unido(a),45 - 64,5,2,3,20
Santa Rosa,Unido(a),65 y más,12,5,7,20
Santa Rosa,Unido(a),Ignorado,0,0,0,20
Santa Rosa,Ignorado(a),Todas las edades,3,3,0,20
Santa Rosa,Ignorado(a),Menos de 15 años,0,0,0,20
Santa Rosa,Ignorado(a),15 - 24,0,0,0,20
Santa Rosa,Ignorado(a),25 - 44,0,0,0,20
Santa Rosa,Ignorado(a),45 - 64,0,0,0,20
Santa Rosa,Ignorado(a),65 y más,2,2,0,20
Santa Rosa,Ignorado(a),Ignorado,1,1,0,20
Sololá,Todos los estados civiles,Todas las edades,2219,1259,960,20
Sololá,Todos los estados civiles,Menos de 15 años,37,19,18,20
Sololá,Todos los estados civiles,15 - 24,73,52,21,20
Sololá,Todos los estados civiles,25 - 44,300,192,108,20
Sololá,Todos los estados civiles,45 - 64,560,329,231,20
Sololá,Todos los estados civiles,65 y más,1240,661,579,20
Sololá,Todos los estados civiles,Ignorado,9,6,3,20
Sololá,Soltero(a),Todas las edades,1137,606,531,20
Sololá,Soltero(a),Menos de 15 años,37,19,18,20
Sololá,Soltero(a),15 - 24,70,51,19,20
Sololá,Soltero(a),25 - 44,166,112,54,20
Sololá,Soltero(a),45 - 64,200,105,95,20
Sololá,Soltero(a),65 y más,656,314,342,20
Sololá,Soltero(a),Ignorado,8,5,3,20
Sololá,Casado(a),Todas las edades,908,552,356,20
Sololá,Casado(a),Menos de 15 años,0,0,0,20
Sololá,Casado(a),15 - 24,3,1,2,20
Sololá,Casado(a),25 - 44,129,76,53,20
Sololá,Casado(a),45 - 64,317,200,117,20
Sololá,Casado(a),65 y más,459,275,184,20
Sololá,Casado(a),Ignorado,0,0,0,20
Sololá,Unido(a),Todas las edades,172,99,73,20
Sololá,Unido(a),Menos de 15 años,0,0,0,20
Sololá,Unido(a),15 - 24,0,0,0,20
Sololá,Unido(a),25 - 44,5,4,1,20
Sololá,Unido(a),45 - 64,42,23,19,20
Sololá,Unido(a),65 y más,125,72,53,20
Sololá,Unido(a),Ignorado,0,0,0,20
Sololá,Ignorado(a),Todas las edades,2,2,0,20
Sololá,Ignorado(a),Menos de 15 años,0,0,0,20
Sololá,Ignorado(a),15 - 24,0,0,0,20
Sololá,Ignorado(a),25 - 44,0,0,0,20
Sololá,Ignorado(a),45 - 64,1,1,0,20
Sololá,Ignorado(a),65 y más,0,0,0,20
Sololá,Ignorado(a),Ignorado,1,1,0,20
Totonicapán,Todos los estados civiles,Todas las edades,2921,1716,1205,20
Totonicapán,Todos los estados civiles,Menos de 15 años,47,26,21,20
Totonicapán,Todos los estados civiles,15 - 24,66,50,16,20
Totonicapán,Todos los estados civiles,25 - 44,379,260,119,20
Totonicapán,Todos los estados civiles,45 - 64,778,466,312,20
Totonicapán,Todos los estados civiles,65 y más,1642,907,735,20
Totonicapán,Todos los estados civiles,Ignorado,9,7,2,20
Totonicapán,Soltero(a),Todas las edades,1247,612,635,20
Totonicapán,Soltero(a),Menos de 15 años,47,26,21,20
Totonicapán,Soltero(a),15 - 24,60,45,15,20
Totonicapán,Soltero(a),25 - 44,177,121,56,20
Totonicapán,Soltero(a),45 - 64,219,106,113,20
Totonicapán,Soltero(a),65 y más,739,311,428,20
Totonicapán,Soltero(a),Ignorado,5,3,2,20
Totonicapán,Casado(a),Todas las edades,1564,1039,525,20
Totonicapán,Casado(a),Menos de 15 años,0,0,0,20
Totonicapán,Casado(a),15 - 24,6,5,1,20
Totonicapán,Casado(a),25 - 44,202,139,63,20
Totonicapán,Casado(a),45 - 64,543,354,189,20
Totonicapán,Casado(a),65 y más,810,538,272,20
Totonicapán,Casado(a),Ignorado,3,3,0,20
Totonicapán,Unido(a),Todas las edades,109,64,45,20
Totonicapán,Unido(a),Menos de 15 años,0,0,0,20
Totonicapán,Unido(a),15 - 24,0,0,0,20
Totonicapán,Unido(a),25 - 44,0,0,0,20
Totonicapán,Unido(a),45 - 64,16,6,10,20
Totonicapán,Unido(a),65 y más,93,58,35,20
Totonicapán,Unido(a),Ignorado,0,0,0,20
Totonicapán,Ignorado(a),Todas las edades,1,1,0,20
Totonicapán,Ignorado(a),Menos de 15 años,0,0,0,20
Totonicapán,Ignorado(a),15 - 24,0,0,0,20
Totonicapán,Ignorado(a),25 - 44,0,0,0,20
Totonicapán,Ignorado(a),45 - 64,0,0,0,20
Totonicapán,Ignorado(a),65 y más,0,0,0,20
Totonicapán,Ignorado(a),Ignorado,1,1,0,20
Quetzaltenango,Todos los estados civiles,Todas las edades,5616,3184,2432,20
Quetzaltenango,Todos los estados civiles,Menos de 15 años,170,83,87,20
Quetzaltenango,Todos los estados civiles,15 - 24,162,116,46,20
Quetzaltenango,Todos los estados civiles,25 - 44,705,465,240,20
Quetzaltenango,Todos los estados civiles,45 - 64,1349,786,563,20
Quetzaltenango,Todos los estados civiles,65 y más,3206,1717,1489,20
Quetzaltenango,Todos los estados civiles,Ignorado,24,17,7,20
Quetzaltenango,Soltero(a),Todas las edades,2672,1343,1329,20
Quetzaltenango,Soltero(a),Menos de 15 años,170,83,87,20
Quetzaltenango,Soltero(a),15 - 24,143,103,40,20
Quetzaltenango,Soltero(a),25 - 44,387,253,134,20
Quetzaltenango,Soltero(a),45 - 64,474,250,224,20
Quetzaltenango,Soltero(a),65 y más,1491,649,842,20
Quetzaltenango,Soltero(a),Ignorado,7,5,2,20
Quetzaltenango,Casado(a),Todas las edades,2798,1751,1047,20
Quetzaltenango,Casado(a),Menos de 15 años,0,0,0,20
Quetzaltenango,Casado(a),15 - 24,19,13,6,20
Quetzaltenango,Casado(a),25 - 44,312,208,104,20
Quetzaltenango,Casado(a),45 - 64,832,513,319,20
Quetzaltenango,Casado(a),65 y más,1633,1016,617,20
Quetzaltenango,Casado(a),Ignorado,2,1,1,20
Quetzaltenango,Unido(a),Todas las edades,129,78,51,20
Quetzaltenango,Unido(a),Menos de 15 años,0,0,0,20
Quetzaltenango,Unido(a),15 - 24,0,0,0,20
Quetzaltenango,Unido(a),25 - 44,6,4,2,20
Quetzaltenango,Unido(a),45 - 64,41,22,19,20
Quetzaltenango,Unido(a),65 y más,81,52,29,20
Quetzaltenango,Unido(a),Ignorado,1,0,1,20
Quetzaltenango,Ignorado(a),Todas las edades,17,12,5,20
Quetzaltenango,Ignorado(a),Menos de 15 años,0,0,0,20
Quetzaltenango,Ignorado(a),15 - 24,0,0,0,20
Quetzaltenango,Ignorado(a),25 - 44,0,0,0,20
Quetzaltenango,Ignorado(a),45 - 64,2,1,1,20
Quetzaltenango,Ignorado(a),65 y más,1,0,1,20
Quetzaltenango,Ignorado(a),Ignorado,14,11,3,20
Suchitepéquez,Todos los estados civiles,Todas las edades,3725,2193,1532,20
Suchitepéquez,Todos los estados civiles,Menos de 15 años,86,50,36,20
Suchitepéquez,Todos los estados civiles,15 - 24,121,90,31,20
Suchitepéquez,Todos los estados civiles,25 - 44,479,345,134,20
Suchitepéquez,Todos los estados civiles,45 - 64,988,589,399,20
Suchitepéquez,Todos los estados civiles,65 y más,2029,1106,923,20
Suchitepéquez,Todos los estados civiles,Ignorado,22,13,9,20
Suchitepéquez,Soltero(a),Todas las edades,1832,1001,831,20
Suchitepéquez,Soltero(a),Menos de 15 años,86,50,36,20
Suchitepéquez,Soltero(a),15 - 24,107,81,26,20
Suchitepéquez,Soltero(a),25 - 44,259,191,68,20
Suchitepéquez,Soltero(a),45 - 64,368,222,146,20
Suchitepéquez,Soltero(a),65 y más,1004,454,550,20
Suchitepéquez,Soltero(a),Ignorado,8,3,5,20
Suchitepéquez,Casado(a),Todas las edades,1880,1182,698,20
Suchitepéquez,Casado(a),Menos de 15 años,0,0,0,20
Suchitepéquez,Casado(a),15 - 24,14,9,5,20
Suchitepéquez,Casado(a),25 - 44,220,154,66,20
Suchitepéquez,Casado(a),45 - 64,618,365,253,20
Suchitepéquez,Casado(a),65 y más,1015,645,370,20
Suchitepéquez,Casado(a),Ignorado,13,9,4,20
Suchitepéquez,Unido(a),Todas las edades,12,9,3,20
Suchitepéquez,Unido(a),Menos de 15 años,0,0,0,20
Suchitepéquez,Unido(a),15 - 24,0,0,0,20
Suchitepéquez,Unido(a),25 - 44,0,0,0,20
Suchitepéquez,Unido(a),45 - 64,2,2,0,20
Suchitepéquez,Unido(a),65 y más,10,7,3,20
Suchitepéquez,Unido(a),Ignorado,0,0,0,20
Suchitepéquez,Ignorado(a),Todas las edades,1,1,0,20
Suchitepéquez,Ignorado(a),Menos de 15 años,0,0,0,20
Suchitepéquez,Ignorado(a),15 - 24,0,0,0,20
Suchitepéquez,Ignorado(a),25 - 44,0,0,0,20
Suchitepéquez,Ignorado(a),45 - 64,0,0,0,20
Suchitepéquez,Ignorado(a),65 y más,0,0,0,20
Suchitepéquez,Ignorado(a),Ignorado,1,1,0,20
Retalhuleu,Todos los estados civiles,Todas las edades,2255,1345,910,20
Retalhuleu,Todos los estados civiles,Menos de 15 años,73,42,31,20
Retalhuleu,Todos los estados civiles,15 - 24,88,68,20,20
Retalhuleu,Todos los estados civiles,25 - 44,291,204,87,20
Retalhuleu,Todos los estados civiles,45 - 64,546,337,209,20
Retalhuleu,Todos los estados civiles,65 y más,1252,691,561,20
Retalhuleu,Todos los estados civiles,Ignorado,5,3,2,20
Retalhuleu,Soltero(a),Todas las edades,1124,614,510,20
Retalhuleu,Soltero(a),Menos de 15 años,73,42,31,20
Retalhuleu,Soltero(a),15 - 24,74,59,15,20
Retalhuleu,Soltero(a),25 - 44,160,107,53,20
Retalhuleu,Soltero(a),45 - 64,210,127,83,20
Retalhuleu,Soltero(a),65 y más,605,278,327,20
Retalhuleu,Soltero(a),Ignorado,2,1,1,20
Retalhuleu,Casado(a),Todas las edades,1064,687,377,20
Retalhuleu,Casado(a),Menos de 15 años,0,0,0,20
Retalhuleu,Casado(a),15 - 24,14,9,5,20
Retalhuleu,Casado(a),25 - 44,130,97,33,20
Retalhuleu,Casado(a),45 - 64,325,201,124,20
Retalhuleu,Casado(a),65 y más,594,379,215,20
Retalhuleu,Casado(a),Ignorado,1,1,0,20
Retalhuleu,Unido(a),Todas las edades,65,43,22,20
Retalhuleu,Unido(a),Menos de 15 años,0,0,0,20
Retalhuleu,Unido(a),15 - 24,0,0,0,20
Retalhuleu,Unido(a),25 - 44,1,0,1,20
Retalhuleu,Unido(a),45 - 64,11,9,2,20
Retalhuleu,Unido(a),65 y más,53,34,19,20
Retalhuleu,Unido(a),Ignorado,0,0,0,20
Retalhuleu,Ignorado(a),Todas las edades,2,1,1,20
Retalhuleu,Ignorado(a),Menos de 15 años,0,0,0,20
Retalhuleu,Ignorado(a),15 - 24,0,0,0,20
Retalhuleu,Ignorado(a),25 - 44,0,0,0,20
Retalhuleu,Ignorado(a),45 - 64,0,0,0,20
Retalhuleu,Ignorado(a),65 y más,0,0,0,20
Retalhuleu,Ignorado(a),Ignorado,2,1,1,20
San Marcos,Todos los estados civiles,Todas las edades,5654,3325,2329,20
San Marcos,Todos los estados civiles,Menos de 15 años,197,110,87,20
San Marcos,Todos los estados civiles,15 - 24,192,127,65,20
San Marcos,Todos los estados civiles,25 - 44,692,465,227,20
San Marcos,Todos los estados civiles,45 - 64,1386,793,593,20
San Marcos,Todos los estados civiles,65 y más,3183,1828,1355,20
San Marcos,Todos los estados civiles,Ignorado,4,2,2,20
San Marcos,Soltero(a),Todas las edades,2957,1622,1335,20
San Marcos,Soltero(a),Menos de 15 años,197,110,87,20
San Marcos,Soltero(a),15 - 24,181,123,58,20
San Marcos,Soltero(a),25 - 44,447,299,148,20
San Marcos,Soltero(a),45 - 64,562,308,254,20
San Marcos,Soltero(a),65 y más,1567,780,787,20
San Marcos,Soltero(a),Ignorado,3,2,1,20
San Marcos,Casado(a),Todas las edades,2604,1651,953,20
San Marcos,Casado(a),Menos de 15 años,0,0,0,20
San Marcos,Casado(a),15 - 24,11,4,7,20
San Marcos,Casado(a),25 - 44,245,166,79,20
San Marcos,Casado(a),45 - 64,796,469,327,20
San Marcos,Casado(a),65 y más,1551,1012,539,20
San Marcos,Casado(a),Ignorado,1,0,1,20
San Marcos,Unido(a),Todas las edades,93,52,41,20
San Marcos,Unido(a),Menos de 15 años,0,0,0,20
San Marcos,Unido(a),15 - 24,0,0,0,20
San Marcos,Unido(a),25 - 44,0,0,0,20
San Marcos,Unido(a),45 - 64,28,16,12,20
San Marcos,Unido(a),65 y más,65,36,29,20
San Marcos,Unido(a),Ignorado,0,0,0,20
San Marcos,Ignorado(a),Todas las edades,0,0,0,20
San Marcos,Ignorado(a),Menos de 15 años,0,0,0,20
San Marcos,Ignorado(a),15 - 24,0,0,0,20
San Marcos,Ignorado(a),25 - 44,0,0,0,20
San Marcos,Ignorado(a),45 - 64,0,0,0,20
San Marcos,Ignorado(a),65 y más,0,0,0,20
San Marcos,Ignorado(a),Ignorado,0,0,0,20
Huehuetenango,Todos los estados civiles,Todas las edades,4764,2673,2091,20
Huehuetenango,Todos los estados civiles,Menos de 15 años,168,93,75,20
Huehuetenango,Todos los estados civiles,15 - 24,182,102,80,20
Huehuetenango,Todos los estados civiles,25 - 44,626,393,233,20
Huehuetenango,Todos los estados civiles,45 - 64,1127,621,506,20
Huehuetenango,Todos los estados civiles,65 y más,2660,1463,1197,20
Huehuetenango,Todos los estados civiles,Ignorado,1,1,0,20
Huehuetenango,Soltero(a),Todas las edades,2782,1467,1315,20
Huehuetenango,Soltero(a),Menos de 15 años,168,93,75,20
Huehuetenango,Soltero(a),15 - 24,164,95,69,20
Huehuetenango,Soltero(a),25 - 44,371,241,130,20
Huehuetenango,Soltero(a),45 - 64,462,231,231,20
Huehuetenango,Soltero(a),65 y más,1616,806,810,20
Huehuetenango,Soltero(a),Ignorado,1,1,0,20
Huehuetenango,Casado(a),Todas las edades,1972,1201,771,20
Huehuetenango,Casado(a),Menos de 15 años,0,0,0,20
Huehuetenango,Casado(a),15 - 24,18,7,11,20
Huehuetenango,Casado(a),25 - 44,255,152,103,20
Huehuetenango,Casado(a),45 - 64,665,390,275,20
Huehuetenango,Casado(a),65 y más,1034,652,382,20
Huehuetenango,Casado(a),Ignorado,0,0,0,20
Huehuetenango,Unido(a),Todas las edades,9,5,4,20
Huehuetenango,Unido(a),Menos de 15 años,0,0,0,20
Huehuetenango,Unido(a),15 - 24,0,0,0,20
Huehuetenango,Unido(a),25 - 44,0,0,0,20
Huehuetenango,Unido(a),45 - 64,0,0,0,20
Huehuetenango,Unido(a),65 y más,9,5,4,20
Huehuetenango,Unido(a),Ignorado,0,0,0,20
Huehuetenango,Ignorado(a),Todas las edades,1,0,1,20
Huehuetenango,Ignorado(a),Menos de 15 años,0,0,0,20
Huehuetenango,Ignorado(a),15 - 24,0,0,0,20
Huehuetenango,Ignorado(a),25 - 44,0,0,0,20
Huehuetenango,Ignorado(a),45 - 64,0,0,0,20
Huehuetenango,Ignorado(a),65 y más,1,0,1,20
Huehuetenango,Ignorado(a),Ignorado,0,0,0,20
Quiché,Todos los estados civiles,Todas las edades,4193,2350,1843,20
Quiché,Todos los estados civiles,Menos de 15 años,135,74,61,20
Quiché,Todos los estados civiles,15 - 24,190,111,79,20
Quiché,Todos los estados civiles,25 - 44,640,418,222,20
Quiché,Todos los estados civiles,45 - 64,1048,619,429,20
Quiché,Todos los estados civiles,65 y más,2173,1126,1047,20
Quiché,Todos los estados civiles,Ignorado,7,2,5,20
Quiché,Soltero(a),Todas las edades,2332,1171,1161,20
Quiché,Soltero(a),Menos de 15 años,135,74,61,20
Quiché,Soltero(a),15 - 24,175,106,69,20
Quiché,Soltero(a),25 - 44,332,222,110,20
Quiché,Soltero(a),45 - 64,440,234,206,20
Quiché,Soltero(a),65 y más,1244,534,710,20
Quiché,Soltero(a),Ignorado,6,1,5,20
Quiché,Casado(a),Todas las edades,1839,1167,672,20
Quiché,Casado(a),Menos de 15 años,0,0,0,20
Quiché,Casado(a),15 - 24,15,5,10,20
Quiché,Casado(a),25 - 44,308,196,112,20
Quiché,Casado(a),45 - 64,603,384,219,20
Quiché,Casado(a),65 y más,912,581,331,20
Quiché,Casado(a),Ignorado,1,1,0,20
Quiché,Unido(a),Todas las edades,21,12,9,20
Quiché,Unido(a),Menos de 15 años,0,0,0,20
Quiché,Unido(a),15 - 24,0,0,0,20
Quiché,Unido(a),25 - 44,0,0,0,20
Quiché,Unido(a),45 - 64,4,1,3,20
Quiché,Unido(a),65 y más,17,11,6,20
Quiché,Unido(a),Ignorado,0,0,0,20
Quiché,Ignorado(a),Todas las edades,1,0,1,20
Quiché,Ignorado(a),Menos de 15 años,0,0,0,20
Quiché,Ignorado(a),15 - 24,0,0,0,20
Quiché,Ignorado(a),25 - 44,0,0,0,20
Quiché,Ignorado(a),45 - 64,1,0,1,20
Quiché,Ignorado(a),65 y más,0,0,0,20
Quiché,Ignorado(a),Ignorado,0,0,0,20
Baja Verapaz,Todos los estados civiles,Todas las edades,1425,741,684,20
Baja Verapaz,Todos los estados civiles,Menos de 15 años,57,33,24,20
Baja Verapaz,Todos los estados civiles,15 - 24,63,40,23,20
Baja Verapaz,Todos los estados civiles,25 - 44,167,99,68,20
Baja Verapaz,Todos los estados civiles,45 - 64,281,152,129,20
Baja Verapaz,Todos los estados civiles,65 y más,854,416,438,20
Baja Verapaz,Todos los estados civiles,Ignorado,3,1,2,20
Baja Verapaz,Soltero(a),Todas las edades,732,319,413,20
Baja Verapaz,Soltero(a),Menos de 15 años,57,33,24,20
Baja Verapaz,Soltero(a),15 - 24,57,38,19,20
Baja Verapaz,Soltero(a),25 - 44,97,60,37,20
Baja Verapaz,Soltero(a),45 - 64,105,49,56,20
Baja Verapaz,Soltero(a),65 y más,414,138,276,20
Baja Verapaz,Soltero(a),Ignorado,2,1,1,20
Baja Verapaz,Casado(a),Todas las edades,671,410,261,20
Baja Verapaz,Casado(a),Menos de 15 años,0,0,0,20
Baja Verapaz,Casado(a),15 - 24,6,2,4,20
Baja Verapaz,Casado(a),25 - 44,70,39,31,20
Baja Verapaz,Casado(a),45 - 64,174,103,71,20
Baja Verapaz,Casado(a),65 y más,420,266,154,20
Baja Verapaz,Casado(a),Ignorado,1,0,1,20
Baja Verapaz,Unido(a),Todas las edades,22,12,10,20
Baja Verapaz,Unido(a),Menos de 15 años,0,0,0,20
Baja Verapaz,Unido(a),15 - 24,0,0,0,20
Baja Verapaz,Unido(a),25 - 44,0,0,0,20
Baja Verapaz,Unido(a),45 - 64,2,0,2,20
Baja Verapaz,Unido(a),65 y más,20,12,8,20
Baja Verapaz,Unido(a),Ignorado,0,0,0,20
Baja Verapaz,Ignorado(a),Todas las edades,0,0,0,20
Baja Verapaz,Ignorado(a),Menos de 15 años,0,0,0,20
Baja Verapaz,Ignorado(a),15 - 24,0,0,0,20
Baja Verapaz,Ignorado(a),25 - 44,0,0,0,20
Baja Verapaz,Ignorado(a),45 - 64,0,0,0,20
Baja Verapaz,Ignorado(a),65 y más,0,0,0,20
Baja Verapaz,Ignorado(a),Ignorado,0,0,0,20
Alta Verapaz,Todos los estados civiles,Todas las edades,4651,2458,2193,20
Alta Verapaz,Todos los estados civiles,Menos de 15 años,465,251,214,20
Alta Verapaz,Todos los estados civiles,15 - 24,228,142,86,20
Alta Verapaz,Todos los estados civiles,25 - 44,682,427,255,20
Alta Verapaz,Todos los estados civiles,45 - 64,1078,519,559,20
Alta Verapaz,Todos los estados civiles,65 y más,2187,1114,1073,20
Alta Verapaz,Todos los estados civiles,Ignorado,11,5,6,20
Alta Verapaz,Soltero(a),Todas las edades,2235,1102,1133,20
Alta Verapaz,Soltero(a),Menos de 15 años,465,251,214,20
Alta Verapaz,Soltero(a),15 - 24,219,139,80,20
Alta Verapaz,Soltero(a),25 - 44,324,219,105,20
Alta Verapaz,Soltero(a),45 - 64,307,143,164,20
Alta Verapaz,Soltero(a),65 y más,915,349,566,20
Alta Verapaz,Soltero(a),Ignorado,5,1,4,20
Alta Verapaz,Casado(a),Todas las edades,2342,1315,1027,20
Alta Verapaz,Casado(a),Menos de 15 años,0,0,0,20
Alta Verapaz,Casado(a),15 - 24,9,3,6,20
Alta Verapaz,Casado(a),25 - 44,357,208,149,20
Alta Verapaz,Casado(a),45 - 64,747,364,383,20
Alta Verapaz,Casado(a),65 y más,1224,737,487,20
Alta Verapaz,Casado(a),Ignorado,5,3,2,20
Alta Verapaz,Unido(a),Todas las edades,72,39,33,20
Alta Verapaz,Unido(a),Menos de 15 años,0,0,0,20
Alta Verapaz,Unido(a),15 - 24,0,0,0,20
Alta Verapaz,Unido(a),25 - 44,1,0,1,20
Alta Verapaz,Unido(a),45 - 64,24,12,12,20
Alta Verapaz,Unido(a),65 y más,47,27,20,20
Alta Verapaz,Unido(a),Ignorado,0,0,0,20
Alta Verapaz,Ignorado(a),Todas las edades,2,2,0,20
Alta Verapaz,Ignorado(a),Menos de 15 años,0,0,0,20
Alta Verapaz,Ignorado(a),15 - 24,0,0,0,20
Alta Verapaz,Ignorado(a),25 - 44,0,0,0,20
Alta Verapaz,Ignorado(a),45 - 64,0,0,0,20
Alta Verapaz,Ignorado(a),65 y más,1,1,0,20
Alta Verapaz,Ignorado(a),Ignorado,1,1,0,20
Petén,Todos los estados civiles,Todas las edades,2306,1370,936,20
Petén,Todos los estados civiles,Menos de 15 años,46,21,25,20
Petén,Todos los estados civiles,15 - 24,125,82,43,20
Petén,Todos los estados civiles,25 - 44,357,238,119,20
Petén,Todos los estados civiles,45 - 64,610,334,276,20
Petén,Todos los estados civiles,65 y más,1164,692,472,20
Petén,Todos los estados civiles,Ignorado,4,3,1,20
Petén,Soltero(a),Todas las edades,1330,767,563,20
Petén,Soltero(a),Menos de 15 años,46,21,25,20
Petén,Soltero(a),15 - 24,117,78,39,20
Petén,Soltero(a),25 - 44,233,168,65,20
Petén,Soltero(a),45 - 64,275,151,124,20
Petén,Soltero(a),65 y más,656,346,310,20
Petén,Soltero(a),Ignorado,3,3,0,20
Petén,Casado(a),Todas las edades,831,510,321,20
Petén,Casado(a),Menos de 15 años,0,0,0,20
Petén,Casado(a),15 - 24,8,4,4,20
Petén,Casado(a),25 - 44,113,67,46,20
Petén,Casado(a),45 - 64,277,152,125,20
Petén,Casado(a),65 y más,433,287,146,20
Petén,Casado(a),Ignorado,0,0,0,20
Petén,Unido(a),Todas las edades,142,93,49,20
Petén,Unido(a),Menos de 15 años,0,0,0,20
Petén,Unido(a),15 - 24,0,0,0,20
Petén,Unido(a),25 - 44,10,3,7,20
Petén,Unido(a),45 - 64,58,31,27,20
Petén,Unido(a),65 y más,74,59,15,20
Petén,Unido(a),Ignorado,0,0,0,20
Petén,Ignorado(a),Todas las edades,3,0,3,20
Petén,Ignorado(a),Menos de 15 años,0,0,0,20
Petén,Ignorado(a),15 - 24,0,0,0,20
Petén,Ignorado(a),25 - 44,1,0,1,20
Petén,Ignorado(a),45 - 64,0,0,0,20
Petén,Ignorado(a),65 y más,1,0,1,20
Petén,Ignorado(a),Ignorado,1,0,1,20
Izabal,Todos los estados civiles,Todas las edades,2487,1462,1025,20
Izabal,Todos los estados civiles,Menos de 15 años,124,70,54,20
Izabal,Todos los estados civiles,15 - 24,139,109,30,20
Izabal,Todos los estados civiles,25 - 44,376,252,124,20
Izabal,Todos los estados civiles,45 - 64,620,337,283,20
Izabal,Todos los estados civiles,65 y más,1226,693,533,20
Izabal,Todos los estados civiles,Ignorado,2,1,1,20
Izabal,Soltero(a),Todas las edades,1498,845,653,20
Izabal,Soltero(a),Menos de 15 años,124,70,54,20
Izabal,Soltero(a),15 - 24,136,108,28,20
Izabal,Soltero(a),25 - 44,249,173,76,20
Izabal,Soltero(a),45 - 64,276,141,135,20
Izabal,Soltero(a),65 y más,712,353,359,20
Izabal,Soltero(a),Ignorado,1,0,1,20
Izabal,Casado(a),Todas las edades,929,582,347,20
Izabal,Casado(a),Menos de 15 años,0,0,0,20
Izabal,Casado(a),15 - 24,3,1,2,20
Izabal,Casado(a),25 - 44,127,79,48,20
Izabal,Casado(a),45 - 64,333,191,142,20
Izabal,Casado(a),65 y más,465,310,155,20
Izabal,Casado(a),Ignorado,1,1,0,20
Izabal,Unido(a),Todas las edades,59,34,25,20
Izabal,Unido(a),Menos de 15 años,0,0,0,20
Izabal,Unido(a),15 - 24,0,0,0,20
Izabal,Unido(a),25 - 44,0,0,0,20
Izabal,Unido(a),45 - 64,11,5,6,20
Izabal,Unido(a),65 y más,48,29,19,20
Izabal,Unido(a),Ignorado,0,0,0,20
Izabal,Ignorado(a),Todas las edades,1,1,0,20
Izabal,Ignorado(a),Menos de 15 años,0,0,0,20
Izabal,Ignorado(a),15 - 24,0,0,0,20
Izabal,Ignorado(a),25 - 44,0,0,0,20
Izabal,Ignorado(a),45 - 64,0,0,0,20
Izabal,Ignorado(a),65 y más,1,1,0,20
Izabal,Ignorado(a),Ignorado,0,0,0,20
Zacapa,Todos los estados civiles,Todas las edades,1587,900,687,20
Zacapa,Todos los estados civiles,Menos de 15 años,43,26,17,20
Zacapa,Todos los estados civiles,15 - 24,70,47,23,20
Zacapa,Todos los estados civiles,25 - 44,208,146,62,20
Zacapa,Todos los estados civiles,45 - 64,383,216,167,20
Zacapa,Todos los estados civiles,65 y más,882,464,418,20
Zacapa,Todos los estados civiles,Ignorado,1,1,0,20
Zacapa,Soltero(a),Todas las edades,892,470,422,20
Zacapa,Soltero(a),Menos de 15 años,43,26,17,20
Zacapa,Soltero(a),15 - 24,66,43,23,20
Zacapa,Soltero(a),25 - 44,146,107,39,20
Zacapa,Soltero(a),45 - 64,165,85,80,20
Zacapa,Soltero(a),65 y más,471,208,263,20
Zacapa,Soltero(a),Ignorado,1,1,0,20
Zacapa,Casado(a),Todas las edades,689,424,265,20
Zacapa,Casado(a),Menos de 15 años,0,0,0,20
Zacapa,Casado(a),15 - 24,3,3,0,20
Zacapa,Casado(a),25 - 44,61,38,23,20
Zacapa,Casado(a),45 - 64,217,130,87,20
Zacapa,Casado(a),65 y más,408,253,155,20
Zacapa,Casado(a),Ignorado,0,0,0,20
Zacapa,Unido(a),Todas las edades,3,3,0,20
Zacapa,Unido(a),Menos de 15 años,0,0,0,20
Zacapa,Unido(a),15 - 24,0,0,0,20
Zacapa,Unido(a),25 - 44,0,0,0,20
Zacapa,Unido(a),45 - 64,1,1,0,20
Zacapa,Unido(a),65 y más,2,2,0,20
Zacapa,Unido(a),Ignorado,0,0,0,20
Zacapa,Ignorado(a),Todas las edades,3,3,0,20
Zacapa,Ignorado(a),Menos de 15 años,0,0,0,20
Zacapa,Ignorado(a),15 - 24,1,1,0,20
Zacapa,Ignorado(a),25 - 44,1,1,0,20
Zacapa,Ignorado(a),45 - 64,0,0,0,20
Zacapa,Ignorado(a),65 y más,1,1,0,20
Zacapa,Ignorado(a),Ignorado,0,0,0,20
Chiquimula,Todos los estados civiles,Todas las edades,2022,1211,811,20
Chiquimula,Todos los estados civiles,Menos de 15 años,35,20,15,20
Chiquimula,Todos los estados civiles,15 - 24,109,85,24,20
Chiquimula,Todos los estados civiles,25 - 44,306,215,91,20
Chiquimula,Todos los estados civiles,45 - 64,458,258,200,20
Chiquimula,Todos los estados civiles,65 y más,1112,632,480,20
Chiquimula,Todos los estados civiles,Ignorado,2,1,1,20
Chiquimula,Soltero(a),Todas las edades,1153,649,504,20
Chiquimula,Soltero(a),Menos de 15 años,35,20,15,20
Chiquimula,Soltero(a),15 - 24,98,79,19,20
Chiquimula,Soltero(a),25 - 44,204,150,54,20
Chiquimula,Soltero(a),45 - 64,209,113,96,20
Chiquimula,Soltero(a),65 y más,607,287,320,20
Chiquimula,Soltero(a),Ignorado,0,0,0,20
Chiquimula,Casado(a),Todas las edades,855,553,302,20
Chiquimula,Casado(a),Menos de 15 años,0,0,0,20
Chiquimula,Casado(a),15 - 24,11,6,5,20
Chiquimula,Casado(a),25 - 44,102,65,37,20
Chiquimula,Casado(a),45 - 64,248,144,104,20
Chiquimula,Casado(a),65 y más,493,338,155,20
Chiquimula,Casado(a),Ignorado,1,0,1,20
Chiquimula,Unido(a),Todas las edades,11,7,4,20
Chiquimula,Unido(a),Menos de 15 años,0,0,0,20
Chiquimula,Unido(a),15 - 24,0,0,0,20
Chiquimula,Unido(a),25 - 44,0,0,0,20
Chiquimula,Unido(a),45 - 64,1,1,0,20
Chiquimula,Unido(a),65 y más,10,6,4,20
Chiquimula,Unido(a),Ignorado,0,0,0,20
Chiquimula,Ignorado(a),Todas las edades,3,2,1,20
Chiquimula,Ignorado(a),Menos de 15 años,0,0,0,20
Chiquimula,Ignorado(a),15 - 24,0,0,0,20
Chiquimula,Ignorado(a),25 - 44,0,0,0,20
Chiquimula,Ignorado(a),45 - 64,0,0,0,20
Chiquimula,Ignorado(a),65 y más,2,1,1,20
Chiquimula,Ignorado(a),Ignorado,1,1,0,20
Jalapa,Todos los estados civiles,Todas las edades,1649,931,718,20
Jalapa,Todos los estados civiles,Menos de 15 años,16,9,7,20
Jalapa,Todos los estados civiles,15 - 24,109,78,31,20
Jalapa,Todos los estados civiles,25 - 44,253,166,87,20
Jalapa,Todos los estados civiles,45 - 64,401,211,190,20
Jalapa,Todos los estados civiles,65 y más,869,467,402,20
Jalapa,Todos los estados civiles,Ignorado,1,0,1,20
Jalapa,Soltero(a),Todas las edades,847,456,391,20
Jalapa,Soltero(a),Menos de 15 años,16,9,7,20
Jalapa,Soltero(a),15 - 24,100,70,30,20
Jalapa,Soltero(a),25 - 44,173,120,53,20
Jalapa,Soltero(a),45 - 64,151,86,65,20
Jalapa,Soltero(a),65 y más,406,171,235,20
Jalapa,Soltero(a),Ignorado,1,0,1,20
Jalapa,Casado(a),Todas las edades,792,470,322,20
Jalapa,Casado(a),Menos de 15 años,0,0,0,20
Jalapa,Casado(a),15 - 24,9,8,1,20
Jalapa,Casado(a),25 - 44,80,46,34,20
Jalapa,Casado(a),45 - 64,250,125,125,20
Jalapa,Casado(a),65 y más,453,291,162,20
Jalapa,Casado(a),Ignorado,0,0,0,20
Jalapa,Unido(a),Todas las edades,10,5,5,20
Jalapa,Unido(a),Menos de 15 años,0,0,0,20
Jalapa,Unido(a),15 - 24,0,0,0,20
Jalapa,Unido(a),25 - 44,0,0,0,20
Jalapa,Unido(a),45 - 64,0,0,0,20
Jalapa,Unido(a),65 y más,10,5,5,20
Jalapa,Unido(a),Ignorado,0,0,0,20
Jalapa,Ignorado(a),Todas las edades,0,0,0,20
Jalapa,Ignorado(a),Menos de 15 años,0,0,0,20
Jalapa,Ignorado(a),15 - 24,0,0,0,20
Jalapa,Ignorado(a),25 - 44,0,0,0,20
Jalapa,Ignorado(a),45 - 64,0,0,0,20
Jalapa,Ignorado(a),65 y más,0,0,0,20
Jalapa,Ignorado(a),Ignorado,0,0,0,20
Jutiapa,Todos los estados civiles,Todas las edades,2919,1664,1255,20
Jutiapa,Todos los estados civiles,Menos de 15 años,22,7,15,20
Jutiapa,Todos los estados civiles,15 - 24,124,83,41,20
Jutiapa,Todos los estados civiles,25 - 44,411,281,130,20
Jutiapa,Todos los estados civiles,45 - 64,689,373,316,20
Jutiapa,Todos los estados civiles,65 y más,1672,920,752,20
Jutiapa,Todos los estados civiles,Ignorado,1,0,1,20
Jutiapa,Soltero(a),Todas las edades,1614,848,766,20
Jutiapa,Soltero(a),Menos de 15 años,22,7,15,20
Jutiapa,Soltero(a),15 - 24,116,80,36,20
Jutiapa,Soltero(a),25 - 44,260,188,72,20
Jutiapa,Soltero(a),45 - 64,299,143,156,20
Jutiapa,Soltero(a),65 y más,916,430,486,20
Jutiapa,Soltero(a),Ignorado,1,0,1,20
Jutiapa,Casado(a),Todas las edades,1276,798,478,20
Jutiapa,Casado(a),Menos de 15 años,0,0,0,20
Jutiapa,Casado(a),15 - 24,8,3,5,20
Jutiapa,Casado(a),25 - 44,149,92,57,20
Jutiapa,Casado(a),45 - 64,386,227,159,20
Jutiapa,Casado(a),65 y más,733,476,257,20
Jutiapa,Casado(a),Ignorado,0,0,0,20
Jutiapa,Unido(a),Todas las edades,28,17,11,20
Jutiapa,Unido(a),Menos de 15 años,0,0,0,20
Jutiapa,Unido(a),15 - 24,0,0,0,20
Jutiapa,Unido(a),25 - 44,1,0,1,20
Jutiapa,Unido(a),45 - 64,4,3,1,20
Jutiapa,Unido(a),65 y más,23,14,9,20
Jutiapa,Unido(a),Ignorado,0,0,0,20
Jutiapa,Ignorado(a),Todas las edades,1,1,0,20
Jutiapa,Ignorado(a),Menos de 15 años,0,0,0,20
Jutiapa,Ignorado(a),15 - 24,0,0,0,20
Jutiapa,Ignorado(a),25 - 44,1,1,0,20
Jutiapa,Ignorado(a),45 - 64,0,0,0,20
Jutiapa,Ignorado(a),65 y más,0,0,0,20
Jutiapa,Ignorado(a),Ignorado,0,0,0,20
Extranjero,Todos los estados civiles,Todas las edades,108,75,33,20
Extranjero,Todos los estados civiles,Menos de 15 años,1,1,0,20
Extranjero,Todos los estados civiles,15 - 24,11,8,3,20
Extranjero,Todos los estados civiles,25 - 44,27,22,5,20
Extranjero,Todos los estados civiles,45 - 64,41,27,14,20
Extranjero,Todos los estados civiles,65 y más,28,17,11,20
Extranjero,Todos los estados civiles,Ignorado,0,0,0,20
Extranjero,Soltero(a),Todas las edades,69,48,21,20
Extranjero,Soltero(a),Menos de 15 años,1,1,0,20
Extranjero,Soltero(a),15 - 24,9,8,1,20
Extranjero,Soltero(a),25 - 44,19,14,5,20
Extranjero,Soltero(a),45 - 64,22,14,8,20
Extranjero,Soltero(a),65 y más,18,11,7,20
Extranjero,Soltero(a),Ignorado,0,0,0,20
Extranjero,Casado(a),Todas las edades,30,22,8,20
Extranjero,Casado(a),Menos de 15 años,0,0,0,20
Extranjero,Casado(a),15 - 24,0,0,0,20
Extranjero,Casado(a),25 - 44,5,5,0,20
Extranjero,Casado(a),45 - 64,18,12,6,20
Extranjero,Casado(a),65 y más,7,5,2,20
Extranjero,Casado(a),Ignorado,0,0,0,20
Extranjero,Unido(a),Todas las edades,1,1,0,20
Extranjero,Unido(a),Menos de 15 años,0,0,0,20
Extranjero,Unido(a),15 - 24,0,0,0,20
Extranjero,Unido(a),25 - 44,0,0,0,20
Extranjero,Unido(a),45 - 64,1,1,0,20
Extranjero,Unido(a),65 y más,0,0,0,20
Extranjero,Unido(a),Ignorado,0,0,0,20
Extranjero,Ignorado(a),Todas las edades,8,4,4,20
Extranjero,Ignorado(a),Menos de 15 años,0,0,0,20
Extranjero,Ignorado(a),15 - 24,2,0,2,20
Extranjero,Ignorado(a),25 - 44,3,3,0,20
Extranjero,Ignorado(a),45 - 64,0,0,0,20
Extranjero,Ignorado(a),65 y más,3,1,2,20
Extranjero,Ignorado(a),Ignorado,0,0,0,20
Ignorado,Todos los estados civiles,Todas las edades,7674,4472,3202,20
Ignorado,Todos los estados civiles,Menos de 15 años,5790,3254,2536,20
Ignorado,Todos los estados civiles,15 - 24,806,548,258,20
Ignorado,Todos los estados civiles,25 - 44,199,140,59,20
Ignorado,Todos los estados civiles,45 - 64,211,149,62,20
Ignorado,Todos los estados civiles,65 y más,488,250,238,20
Ignorado,Todos los estados civiles,Ignorado,180,131,49,20
Ignorado,Todos los estados civiles,Todas las edades,7299,4193,3106,20
Ignorado,Soltero(a),Menos de 15 años,5789,3253,2536,20
Ignorado,Soltero(a),15 - 24,777,526,251,20
Ignorado,Soltero(a),25 - 44,146,105,41,20
Ignorado,Soltero(a),45 - 64,132,83,49,20
Ignorado,Soltero(a),65 y más,428,209,219,20
Ignorado,Soltero(a),Ignorado,27,17,10,20
Ignorado,Casado(a),Todas las edades,51,31,20,20
Ignorado,Casado(a),Menos de 15 años,0,0,0,20
Ignorado,Casado(a),15 - 24,0,0,0,20
Ignorado,Casado(a),25 - 44,7,3,4,20
Ignorado,Casado(a),45 - 64,13,9,4,20
Ignorado,Casado(a),65 y más,30,18,12,20
Ignorado,Casado(a),Ignorado,1,1,0,20
Ignorado,Unido(a),Todas las edades,0,0,0,20
Ignorado,Unido(a),Menos de 15 años,0,0,0,20
Ignorado,Unido(a),15 - 24,0,0,0,20
Ignorado,Unido(a),25 - 44,0,0,0,20
Ignorado,Unido(a),45 - 64,0,0,0,20
Ignorado,Unido(a),65 y más,0,0,0,20
Ignorado,Unido(a),Ignorado,0,0,0,20
Ignorado,Ignorado(a),Todas las edades,324,248,76,20
Ignorado,Ignorado(a),Menos de 15 años,1,1,0,20
Ignorado,Ignorado(a),15 - 24,29,22,7,20
Ignorado,Ignorado(a),25 - 44,46,32,14,20
Ignorado,Ignorado(a),45 - 64,66,57,9,20
Ignorado,Ignorado(a),65 y más,30,23,7,20
Ignorado,Ignorado(a),Ignorado,152,113,39,20
Todos los departamentos,Todos los estados civiles,Todas las edades,118465,66951,51514,21
Todos los departamentos,Todos los estados civiles,Menos de 15 años,9049,4984,4065,21
Todos los departamentos,Todos los estados civiles,15 - 24,4869,3411,1458,21
Todos los departamentos,Todos los estados civiles,25 - 44,15684,10587,5097,21
Todos los departamentos,Todos los estados civiles,45 - 64,28786,16251,12535,21
Todos los departamentos,Todos los estados civiles,65 y más,59797,31529,28268,21
Todos los departamentos,Todos los estados civiles,Ignorado,280,189,91,21
Todos los departamentos,Soltero(a),Todas las edades,64789,34428,30361,21
Todos los departamentos,Soltero(a),Menos de 15 años,9048,4984,4064,21
Todos los departamentos,Soltero(a),15 - 24,4561,3227,1334,21
Todos los departamentos,Soltero(a),25 - 44,9368,6528,2840,21
Todos los departamentos,Soltero(a),45 - 64,11397,6177,5220,21
Todos los departamentos,Soltero(a),65 y más,30346,13471,16875,21
Todos los departamentos,Soltero(a),Ignorado,69,41,28,21
Todos los departamentos,Casado(a),Todas las edades,51683,31330,20353,21
Todos los departamentos,Casado(a),Menos de 15 años,0,0,0,21
Todos los departamentos,Casado(a),15 - 24,268,150,118,21
Todos los departamentos,Casado(a),25 - 44,6187,3974,2213,21
Todos los departamentos,Casado(a),45 - 64,16898,9822,7076,21
Todos los departamentos,Casado(a),65 y más,28313,17377,10936,21
Todos los departamentos,Casado(a),Ignorado,17,7,10,21
Todos los departamentos,Unido(a),Todas las edades,1430,802,628,21
Todos los departamentos,Unido(a),Menos de 15 años,0,0,0,21
Todos los departamentos,Unido(a),15 - 24,0,0,0,21
Todos los departamentos,Unido(a),25 - 44,44,20,24,21
Todos los departamentos,Unido(a),45 - 64,366,169,197,21
Todos los departamentos,Unido(a),65 y más,1019,613,406,21
Todos los departamentos,Unido(a),Ignorado,1,0,1,21
Todos los departamentos,Ignorado(a),Todas las edades,563,391,172,21
Todos los departamentos,Ignorado(a),Menos de 15 años,1,0,1,21
Todos los departamentos,Ignorado(a),15 - 24,40,34,6,21
Todos los departamentos,Ignorado(a),25 - 44,85,65,20,21
Todos los departamentos,Ignorado(a),45 - 64,125,83,42,21
Todos los departamentos,Ignorado(a),65 y más,119,68,51,21
Todos los departamentos,Ignorado(a),Ignorado,193,141,52,21
Guatemala,Todos los estados civiles,Todas las edades,27445,15413,12032,21
Guatemala,Todos los estados civiles,Menos de 15 años,104,57,47,21
Guatemala,Todos los estados civiles,15 - 24,1052,797,255,21
Guatemala,Todos los estados civiles,25 - 44,4000,2851,1149,21
Guatemala,Todos los estados civiles,45 - 64,7757,4599,3158,21
Guatemala,Todos los estados civiles,65 y más,14508,7096,7412,21
Guatemala,Todos los estados civiles,Ignorado,24,13,11,21
Guatemala,Soltero(a),Todas las edades,14304,7396,6908,21
Guatemala,Soltero(a),Menos de 15 años,104,57,47,21
Guatemala,Soltero(a),15 - 24,1004,769,235,21
Guatemala,Soltero(a),25 - 44,2530,1826,704,21
Guatemala,Soltero(a),45 - 64,3418,1915,1503,21
Guatemala,Soltero(a),65 y más,7242,2825,4417,21
Guatemala,Soltero(a),Ignorado,6,4,2,21
Guatemala,Casado(a),Todas las edades,12917,7888,5029,21
Guatemala,Casado(a),Menos de 15 años,0,0,0,21
Guatemala,Casado(a),15 - 24,43,23,20,21
Guatemala,Casado(a),25 - 44,1432,999,433,21
Guatemala,Casado(a),45 - 64,4269,2641,1628,21
Guatemala,Casado(a),65 y más,7168,4222,2946,21
Guatemala,Casado(a),Ignorado,5,3,2,21
Guatemala,Unido(a),Todas las edades,53,32,21,21
Guatemala,Unido(a),Menos de 15 años,0,0,0,21
Guatemala,Unido(a),15 - 24,0,0,0,21
Guatemala,Unido(a),25 - 44,2,2,0,21
Guatemala,Unido(a),45 - 64,13,9,4,21
Guatemala,Unido(a),65 y más,38,21,17,21
Guatemala,Unido(a),Ignorado,0,0,0,21
Guatemala,Ignorado(a),Todas las edades,171,97,74,21
Guatemala,Ignorado(a),Menos de 15 años,0,0,0,21
Guatemala,Ignorado(a),15 - 24,5,5,0,21
Guatemala,Ignorado(a),25 - 44,36,24,12,21
Guatemala,Ignorado(a),45 - 64,57,34,23,21
Guatemala,Ignorado(a),65 y más,60,28,32,21
Guatemala,Ignorado(a),Ignorado,13,6,7,21
El Progreso,Todos los estados civiles,Todas las edades,1587,928,659,21
El Progreso,Todos los estados civiles,Menos de 15 años,35,21,14,21
El Progreso,Todos los estados civiles,15 - 24,60,44,16,21
El Progreso,Todos los estados civiles,25 - 44,165,112,53,21
El Progreso,Todos los estados civiles,45 - 64,369,208,161,21
El Progreso,Todos los estados civiles,65 y más,957,543,414,21
El Progreso,Todos los estados civiles,Ignorado,1,0,1,21
El Progreso,Soltero(a),Todas las edades,851,466,385,21
El Progreso,Soltero(a),Menos de 15 años,35,21,14,21
El Progreso,Soltero(a),15 - 24,59,43,16,21
El Progreso,Soltero(a),25 - 44,99,73,26,21
El Progreso,Soltero(a),45 - 64,167,90,77,21
El Progreso,Soltero(a),65 y más,491,239,252,21
El Progreso,Soltero(a),Ignorado,0,0,0,21
El Progreso,Casado(a),Todas las edades,724,455,269,21
El Progreso,Casado(a),Menos de 15 años,0,0,0,21
El Progreso,Casado(a),15 - 24,1,1,0,21
El Progreso,Casado(a),25 - 44,66,39,27,21
El Progreso,Casado(a),45 - 64,200,117,83,21
El Progreso,Casado(a),65 y más,456,298,158,21
El Progreso,Casado(a),Ignorado,1,0,1,21
El Progreso,Unido(a),Todas las edades,12,7,5,21
El Progreso,Unido(a),Menos de 15 años,0,0,0,21
El Progreso,Unido(a),15 - 24,0,0,0,21
El Progreso,Unido(a),25 - 44,0,0,0,21
El Progreso,Unido(a),45 - 64,2,1,1,21
El Progreso,Unido(a),65 y más,10,6,4,21
El Progreso,Unido(a),Ignorado,0,0,0,21
El Progreso,Ignorado(a),Todas las edades,0,0,0,21
El Progreso,Ignorado(a),Menos de 15 años,0,0,0,21
El Progreso,Ignorado(a),15 - 24,0,0,0,21
El Progreso,Ignorado(a),25 - 44,0,0,0,21
El Progreso,Ignorado(a),45 - 64,0,0,0,21
El Progreso,Ignorado(a),65 y más,0,0,0,21
El Progreso,Ignorado(a),Ignorado,0,0,0,21
Sacatepéquez,Todos los estados civiles,Todas las edades,2709,1581,1128,21
Sacatepéquez,Todos los estados civiles,Menos de 15 años,28,18,10,21
Sacatepéquez,Todos los estados civiles,15 - 24,78,54,24,21
Sacatepéquez,Todos los estados civiles,25 - 44,388,276,112,21
Sacatepéquez,Todos los estados civiles,45 - 64,713,406,307,21
Sacatepéquez,Todos los estados civiles,65 y más,1500,826,674,21
Sacatepéquez,Todos los estados civiles,Ignorado,2,1,1,21
Sacatepéquez,Soltero(a),Todas las edades,1106,583,523,21
Sacatepéquez,Soltero(a),Menos de 15 años,28,18,10,21
Sacatepéquez,Soltero(a),15 - 24,71,51,20,21
Sacatepéquez,Soltero(a),25 - 44,196,142,54,21
Sacatepéquez,Soltero(a),45 - 64,221,116,105,21
Sacatepéquez,Soltero(a),65 y más,590,256,334,21
Sacatepéquez,Soltero(a),Ignorado,0,0,0,21
Sacatepéquez,Casado(a),Todas las edades,1588,990,598,21
Sacatepéquez,Casado(a),Menos de 15 años,0,0,0,21
Sacatepéquez,Casado(a),15 - 24,7,3,4,21
Sacatepéquez,Casado(a),25 - 44,192,134,58,21
Sacatepéquez,Casado(a),45 - 64,490,288,202,21
Sacatepéquez,Casado(a),65 y más,899,565,334,21
Sacatepéquez,Casado(a),Ignorado,0,0,0,21
Sacatepéquez,Unido(a),Todas las edades,11,5,6,21
Sacatepéquez,Unido(a),Menos de 15 años,0,0,0,21
Sacatepéquez,Unido(a),15 - 24,0,0,0,21
Sacatepéquez,Unido(a),25 - 44,0,0,0,21
Sacatepéquez,Unido(a),45 - 64,2,2,0,21
Sacatepéquez,Unido(a),65 y más,9,3,6,21
Sacatepéquez,Unido(a),Ignorado,0,0,0,21
Sacatepéquez,Ignorado(a),Todas las edades,4,3,1,21
Sacatepéquez,Ignorado(a),Menos de 15 años,0,0,0,21
Sacatepéquez,Ignorado(a),15 - 24,0,0,0,21
Sacatepéquez,Ignorado(a),25 - 44,0,0,0,21
Sacatepéquez,Ignorado(a),45 - 64,0,0,0,21
Sacatepéquez,Ignorado(a),65 y más,2,2,0,21
Sacatepéquez,Ignorado(a),Ignorado,2,1,1,21
Chimaltenango,Todos los estados civiles,Todas las edades,4354,2499,1855,21
Chimaltenango,Todos los estados civiles,Menos de 15 años,117,72,45,21
Chimaltenango,Todos los estados civiles,15 - 24,153,108,45,21
Chimaltenango,Todos los estados civiles,25 - 44,624,412,212,21
Chimaltenango,Todos los estados civiles,45 - 64,1193,689,504,21
Chimaltenango,Todos los estados civiles,65 y más,2261,1214,1047,21
Chimaltenango,Todos los estados civiles,Ignorado,6,4,2,21
Chimaltenango,Soltero(a),Todas las edades,1695,879,816,21
Chimaltenango,Soltero(a),Menos de 15 años,117,72,45,21
Chimaltenango,Soltero(a),15 - 24,136,97,39,21
Chimaltenango,Soltero(a),25 - 44,291,191,100,21
Chimaltenango,Soltero(a),45 - 64,283,141,142,21
Chimaltenango,Soltero(a),65 y más,864,375,489,21
Chimaltenango,Soltero(a),Ignorado,4,3,1,21
Chimaltenango,Casado(a),Todas las edades,2644,1613,1031,21
Chimaltenango,Casado(a),Menos de 15 años,0,0,0,21
Chimaltenango,Casado(a),15 - 24,17,11,6,21
Chimaltenango,Casado(a),25 - 44,333,221,112,21
Chimaltenango,Casado(a),45 - 64,908,547,361,21
Chimaltenango,Casado(a),65 y más,1385,834,551,21
Chimaltenango,Casado(a),Ignorado,1,0,1,21
Chimaltenango,Unido(a),Todas las edades,13,6,7,21
Chimaltenango,Unido(a),Menos de 15 años,0,0,0,21
Chimaltenango,Unido(a),15 - 24,0,0,0,21
Chimaltenango,Unido(a),25 - 44,0,0,0,21
Chimaltenango,Unido(a),45 - 64,1,1,0,21
Chimaltenango,Unido(a),65 y más,12,5,7,21
Chimaltenango,Unido(a),Ignorado,0,0,0,21
Chimaltenango,Ignorado(a),Todas las edades,2,1,1,21
Chimaltenango,Ignorado(a),Menos de 15 años,0,0,0,21
Chimaltenango,Ignorado(a),15 - 24,0,0,0,21
Chimaltenango,Ignorado(a),25 - 44,0,0,0,21
Chimaltenango,Ignorado(a),45 - 64,1,0,1,21
Chimaltenango,Ignorado(a),65 y más,0,0,0,21
Chimaltenango,Ignorado(a),Ignorado,1,1,0,21
Escuintla,Todos los estados civiles,Todas las edades,6170,3652,2518,21
Escuintla,Todos los estados civiles,Menos de 15 años,38,23,15,21
Escuintla,Todos los estados civiles,15 - 24,262,214,48,21
Escuintla,Todos los estados civiles,25 - 44,995,686,309,21
Escuintla,Todos los estados civiles,45 - 64,1753,959,794,21
Escuintla,Todos los estados civiles,65 y más,3120,1768,1352,21
Escuintla,Todos los estados civiles,Ignorado,2,2,0,21
Escuintla,Soltero(a),Todas las edades,3481,2006,1475,21
Escuintla,Soltero(a),Menos de 15 años,38,23,15,21
Escuintla,Soltero(a),15 - 24,248,203,45,21
Escuintla,Soltero(a),25 - 44,670,476,194,21
Escuintla,Soltero(a),45 - 64,801,423,378,21
Escuintla,Soltero(a),65 y más,1722,879,843,21
Escuintla,Soltero(a),Ignorado,2,2,0,21
Escuintla,Casado(a),Todas las edades,2665,1632,1033,21
Escuintla,Casado(a),Menos de 15 años,0,0,0,21
Escuintla,Casado(a),15 - 24,13,10,3,21
Escuintla,Casado(a),25 - 44,322,207,115,21
Escuintla,Casado(a),45 - 64,948,535,413,21
Escuintla,Casado(a),65 y más,1382,880,502,21
Escuintla,Casado(a),Ignorado,0,0,0,21
Escuintla,Unido(a),Todas las edades,18,8,10,21
Escuintla,Unido(a),Menos de 15 años,0,0,0,21
Escuintla,Unido(a),15 - 24,0,0,0,21
Escuintla,Unido(a),25 - 44,1,1,0,21
Escuintla,Unido(a),45 - 64,4,1,3,21
Escuintla,Unido(a),65 y más,13,6,7,21
Escuintla,Unido(a),Ignorado,0,0,0,21
Escuintla,Ignorado(a),Todas las edades,6,6,0,21
Escuintla,Ignorado(a),Menos de 15 años,0,0,0,21
Escuintla,Ignorado(a),15 - 24,1,1,0,21
Escuintla,Ignorado(a),25 - 44,2,2,0,21
Escuintla,Ignorado(a),45 - 64,0,0,0,21
Escuintla,Ignorado(a),65 y más,3,3,0,21
Escuintla,Ignorado(a),Ignorado,0,0,0,21
Santa Rosa,Todos los estados civiles,Todas las edades,2989,1728,1261,21
Santa Rosa,Todos los estados civiles,Menos de 15 años,7,5,2,21
Santa Rosa,Todos los estados civiles,15 - 24,121,95,26,21
Santa Rosa,Todos los estados civiles,25 - 44,372,265,107,21
Santa Rosa,Todos los estados civiles,45 - 64,699,363,336,21
Santa Rosa,Todos los estados civiles,65 y más,1790,1000,790,21
Santa Rosa,Todos los estados civiles,Ignorado,0,0,0,21
Santa Rosa,Soltero(a),Todas las edades,1650,926,724,21
Santa Rosa,Soltero(a),Menos de 15 años,7,5,2,21
Santa Rosa,Soltero(a),15 - 24,114,89,25,21
Santa Rosa,Soltero(a),25 - 44,236,180,56,21
Santa Rosa,Soltero(a),45 - 64,320,169,151,21
Santa Rosa,Soltero(a),65 y más,973,483,490,21
Santa Rosa,Soltero(a),Ignorado,0,0,0,21
Santa Rosa,Casado(a),Todas las edades,1304,787,517,21
Santa Rosa,Casado(a),Menos de 15 años,0,0,0,21
Santa Rosa,Casado(a),15 - 24,7,6,1,21
Santa Rosa,Casado(a),25 - 44,135,85,50,21
Santa Rosa,Casado(a),45 - 64,372,191,181,21
Santa Rosa,Casado(a),65 y más,790,505,285,21
Santa Rosa,Casado(a),Ignorado,0,0,0,21
Santa Rosa,Unido(a),Todas las edades,35,15,20,21
Santa Rosa,Unido(a),Menos de 15 años,0,0,0,21
Santa Rosa,Unido(a),15 - 24,0,0,0,21
Santa Rosa,Unido(a),25 - 44,1,0,1,21
Santa Rosa,Unido(a),45 - 64,7,3,4,21
Santa Rosa,Unido(a),65 y más,27,12,15,21
Santa Rosa,Unido(a),Ignorado,0,0,0,21
Santa Rosa,Ignorado(a),Todas las edades,0,0,0,21
Santa Rosa,Ignorado(a),Menos de 15 años,0,0,0,21
Santa Rosa,Ignorado(a),15 - 24,0,0,0,21
Santa Rosa,Ignorado(a),25 - 44,0,0,0,21
Santa Rosa,Ignorado(a),45 - 64,0,0,0,21
Santa Rosa,Ignorado(a),65 y más,0,0,0,21
Santa Rosa,Ignorado(a),Ignorado,0,0,0,21
Sololá,Todos los estados civiles,Todas las edades,3048,1768,1280,21
Sololá,Todos los estados civiles,Menos de 15 años,25,18,7,21
Sololá,Todos los estados civiles,15 - 24,93,62,31,21
Sololá,Todos los estados civiles,25 - 44,436,295,141,21
Sololá,Todos los estados civiles,45 - 64,805,470,335,21
Sololá,Todos los estados civiles,65 y más,1683,920,763,21
Sololá,Todos los estados civiles,Ignorado,6,3,3,21
Sololá,Soltero(a),Todas las edades,1528,826,702,21
Sololá,Soltero(a),Menos de 15 años,25,18,7,21
Sololá,Soltero(a),15 - 24,81,51,30,21
Sololá,Soltero(a),25 - 44,236,167,69,21
Sololá,Soltero(a),45 - 64,281,163,118,21
Sololá,Soltero(a),65 y más,901,424,477,21
Sololá,Soltero(a),Ignorado,4,3,1,21
Sololá,Casado(a),Todas las edades,1289,798,491,21
Sololá,Casado(a),Menos de 15 años,0,0,0,21
Sololá,Casado(a),15 - 24,12,11,1,21
Sololá,Casado(a),25 - 44,197,126,71,21
Sololá,Casado(a),45 - 64,461,277,184,21
Sololá,Casado(a),65 y más,619,384,235,21
Sololá,Casado(a),Ignorado,0,0,0,21
Sololá,Unido(a),Todas las edades,225,141,84,21
Sololá,Unido(a),Menos de 15 años,0,0,0,21
Sololá,Unido(a),15 - 24,0,0,0,21
Sololá,Unido(a),25 - 44,3,2,1,21
Sololá,Unido(a),45 - 64,62,30,32,21
Sololá,Unido(a),65 y más,160,109,51,21
Sololá,Unido(a),Ignorado,0,0,0,21
Sololá,Ignorado(a),Todas las edades,6,3,3,21
Sololá,Ignorado(a),Menos de 15 años,0,0,0,21
Sololá,Ignorado(a),15 - 24,0,0,0,21
Sololá,Ignorado(a),25 - 44,0,0,0,21
Sololá,Ignorado(a),45 - 64,1,0,1,21
Sololá,Ignorado(a),65 y más,3,3,0,21
Sololá,Ignorado(a),Ignorado,2,0,2,21
Totonicapán,Todos los estados civiles,Todas las edades,3920,2218,1702,21
Totonicapán,Todos los estados civiles,Menos de 15 años,55,30,25,21
Totonicapán,Todos los estados civiles,15 - 24,95,52,43,21
Totonicapán,Todos los estados civiles,25 - 44,559,361,198,21
Totonicapán,Todos los estados civiles,45 - 64,1039,599,440,21
Totonicapán,Todos los estados civiles,65 y más,2165,1174,991,21
Totonicapán,Todos los estados civiles,Ignorado,7,2,5,21
Totonicapán,Soltero(a),Todas las edades,1649,777,872,21
Totonicapán,Soltero(a),Menos de 15 años,55,30,25,21
Totonicapán,Soltero(a),15 - 24,78,45,33,21
Totonicapán,Soltero(a),25 - 44,270,168,102,21
Totonicapán,Soltero(a),45 - 64,326,173,153,21
Totonicapán,Soltero(a),65 y más,917,359,558,21
Totonicapán,Soltero(a),Ignorado,3,2,1,21
Totonicapán,Casado(a),Todas las edades,2132,1356,776,21
Totonicapán,Casado(a),Menos de 15 años,0,0,0,21
Totonicapán,Casado(a),15 - 24,17,7,10,21
Totonicapán,Casado(a),25 - 44,288,192,96,21
Totonicapán,Casado(a),45 - 64,695,420,275,21
Totonicapán,Casado(a),65 y más,1132,737,395,21
Totonicapán,Casado(a),Ignorado,0,0,0,21
Totonicapán,Unido(a),Todas las edades,135,85,50,21
Totonicapán,Unido(a),Menos de 15 años,0,0,0,21
Totonicapán,Unido(a),15 - 24,0,0,0,21
Totonicapán,Unido(a),25 - 44,1,1,0,21
Totonicapán,Unido(a),45 - 64,18,6,12,21
Totonicapán,Unido(a),65 y más,116,78,38,21
Totonicapán,Unido(a),Ignorado,0,0,0,21
Totonicapán,Ignorado(a),Todas las edades,4,0,4,21
Totonicapán,Ignorado(a),Menos de 15 años,0,0,0,21
Totonicapán,Ignorado(a),15 - 24,0,0,0,21
Totonicapán,Ignorado(a),25 - 44,0,0,0,21
Totonicapán,Ignorado(a),45 - 64,0,0,0,21
Totonicapán,Ignorado(a),65 y más,0,0,0,21
Totonicapán,Ignorado(a),Ignorado,4,0,4,21
Quetzaltenango,Todos los estados civiles,Todas las edades,6904,3861,3043,21
Quetzaltenango,Todos los estados civiles,Menos de 15 años,270,145,125,21
Quetzaltenango,Todos los estados civiles,15 - 24,209,145,64,21
Quetzaltenango,Todos los estados civiles,25 - 44,941,645,296,21
Quetzaltenango,Todos los estados civiles,45 - 64,1708,1003,705,21
Quetzaltenango,Todos los estados civiles,65 y más,3768,1917,1851,21
Quetzaltenango,Todos los estados civiles,Ignorado,8,6,2,21
Quetzaltenango,Soltero(a),Todas las edades,3404,1749,1655,21
Quetzaltenango,Soltero(a),Menos de 15 años,270,145,125,21
Quetzaltenango,Soltero(a),15 - 24,193,138,55,21
Quetzaltenango,Soltero(a),25 - 44,531,370,161,21
Quetzaltenango,Soltero(a),45 - 64,614,340,274,21
Quetzaltenango,Soltero(a),65 y más,1792,753,1039,21
Quetzaltenango,Soltero(a),Ignorado,4,3,1,21
Quetzaltenango,Casado(a),Todas las edades,3341,2019,1322,21
Quetzaltenango,Casado(a),Menos de 15 años,0,0,0,21
Quetzaltenango,Casado(a),15 - 24,16,7,9,21
Quetzaltenango,Casado(a),25 - 44,404,273,131,21
Quetzaltenango,Casado(a),45 - 64,1063,650,413,21
Quetzaltenango,Casado(a),65 y más,1857,1088,769,21
Quetzaltenango,Casado(a),Ignorado,1,1,0,21
Quetzaltenango,Unido(a),Todas las edades,153,91,62,21
Quetzaltenango,Unido(a),Menos de 15 años,0,0,0,21
Quetzaltenango,Unido(a),15 - 24,0,0,0,21
Quetzaltenango,Unido(a),25 - 44,5,2,3,21
Quetzaltenango,Unido(a),45 - 64,31,13,18,21
Quetzaltenango,Unido(a),65 y más,117,76,41,21
Quetzaltenango,Unido(a),Ignorado,0,0,0,21
Quetzaltenango,Ignorado(a),Todas las edades,6,2,4,21
Quetzaltenango,Ignorado(a),Menos de 15 años,0,0,0,21
Quetzaltenango,Ignorado(a),15 - 24,0,0,0,21
Quetzaltenango,Ignorado(a),25 - 44,1,0,1,21
Quetzaltenango,Ignorado(a),45 - 64,0,0,0,21
Quetzaltenango,Ignorado(a),65 y más,2,0,2,21
Quetzaltenango,Ignorado(a),Ignorado,3,2,1,21
Suchitepéquez,Todos los estados civiles,Todas las edades,4330,2444,1886,21
Suchitepéquez,Todos los estados civiles,Menos de 15 años,73,39,34,21
Suchitepéquez,Todos los estados civiles,15 - 24,135,97,38,21
Suchitepéquez,Todos los estados civiles,25 - 44,585,422,163,21
Suchitepéquez,Todos los estados civiles,45 - 64,1174,639,535,21
Suchitepéquez,Todos los estados civiles,65 y más,2357,1245,1112,21
Suchitepéquez,Todos los estados civiles,Ignorado,6,2,4,21
Suchitepéquez,Soltero(a),Todas las edades,2142,1138,1004,21
Suchitepéquez,Soltero(a),Menos de 15 años,73,39,34,21
Suchitepéquez,Soltero(a),15 - 24,124,92,32,21
Suchitepéquez,Soltero(a),25 - 44,332,249,83,21
Suchitepéquez,Soltero(a),45 - 64,423,225,198,21
Suchitepéquez,Soltero(a),65 y más,1185,531,654,21
Suchitepéquez,Soltero(a),Ignorado,5,2,3,21
Suchitepéquez,Casado(a),Todas las edades,2170,1298,872,21
Suchitepéquez,Casado(a),Menos de 15 años,0,0,0,21
Suchitepéquez,Casado(a),15 - 24,11,5,6,21
Suchitepéquez,Casado(a),25 - 44,253,173,80,21
Suchitepéquez,Casado(a),45 - 64,747,411,336,21
Suchitepéquez,Casado(a),65 y más,1159,709,450,21
Suchitepéquez,Casado(a),Ignorado,0,0,0,21
Suchitepéquez,Unido(a),Todas las edades,16,7,9,21
Suchitepéquez,Unido(a),Menos de 15 años,0,0,0,21
Suchitepéquez,Unido(a),15 - 24,0,0,0,21
Suchitepéquez,Unido(a),25 - 44,0,0,0,21
Suchitepéquez,Unido(a),45 - 64,4,3,1,21
Suchitepéquez,Unido(a),65 y más,12,4,8,21
Suchitepéquez,Unido(a),Ignorado,0,0,0,21
Suchitepéquez,Ignorado(a),Todas las edades,2,1,1,21
Suchitepéquez,Ignorado(a),Menos de 15 años,0,0,0,21
Suchitepéquez,Ignorado(a),15 - 24,0,0,0,21
Suchitepéquez,Ignorado(a),25 - 44,0,0,0,21
Suchitepéquez,Ignorado(a),45 - 64,0,0,0,21
Suchitepéquez,Ignorado(a),65 y más,1,1,0,21
Suchitepéquez,Ignorado(a),Ignorado,1,0,1,21
Retalhuleu,Todos los estados civiles,Todas las edades,2610,1497,1113,21
Retalhuleu,Todos los estados civiles,Menos de 15 años,56,37,19,21
Retalhuleu,Todos los estados civiles,15 - 24,83,59,24,21
Retalhuleu,Todos los estados civiles,25 - 44,362,255,107,21
Retalhuleu,Todos los estados civiles,45 - 64,681,377,304,21
Retalhuleu,Todos los estados civiles,65 y más,1427,768,659,21
Retalhuleu,Todos los estados civiles,Ignorado,1,1,0,21
Retalhuleu,Soltero(a),Todas las edades,1254,668,586,21
Retalhuleu,Soltero(a),Menos de 15 años,56,37,19,21
Retalhuleu,Soltero(a),15 - 24,71,51,20,21
Retalhuleu,Soltero(a),25 - 44,205,146,59,21
Retalhuleu,Soltero(a),45 - 64,236,120,116,21
Retalhuleu,Soltero(a),65 y más,686,314,372,21
Retalhuleu,Soltero(a),Ignorado,0,0,0,21
Retalhuleu,Casado(a),Todas las edades,1261,775,486,21
Retalhuleu,Casado(a),Menos de 15 años,0,0,0,21
Retalhuleu,Casado(a),15 - 24,12,8,4,21
Retalhuleu,Casado(a),25 - 44,156,109,47,21
Retalhuleu,Casado(a),45 - 64,426,246,180,21
Retalhuleu,Casado(a),65 y más,667,412,255,21
Retalhuleu,Casado(a),Ignorado,0,0,0,21
Retalhuleu,Unido(a),Todas las edades,94,53,41,21
Retalhuleu,Unido(a),Menos de 15 años,0,0,0,21
Retalhuleu,Unido(a),15 - 24,0,0,0,21
Retalhuleu,Unido(a),25 - 44,1,0,1,21
Retalhuleu,Unido(a),45 - 64,19,11,8,21
Retalhuleu,Unido(a),65 y más,74,42,32,21
Retalhuleu,Unido(a),Ignorado,0,0,0,21
Retalhuleu,Ignorado(a),Todas las edades,1,1,0,21
Retalhuleu,Ignorado(a),Menos de 15 años,0,0,0,21
Retalhuleu,Ignorado(a),15 - 24,0,0,0,21
Retalhuleu,Ignorado(a),25 - 44,0,0,0,21
Retalhuleu,Ignorado(a),45 - 64,0,0,0,21
Retalhuleu,Ignorado(a),65 y más,0,0,0,21
Retalhuleu,Ignorado(a),Ignorado,1,1,0,21
San Marcos,Todos los estados civiles,Todas las edades,7135,4179,2956,21
San Marcos,Todos los estados civiles,Menos de 15 años,276,163,113,21
San Marcos,Todos los estados civiles,15 - 24,207,140,67,21
San Marcos,Todos los estados civiles,25 - 44,898,616,282,21
San Marcos,Todos los estados civiles,45 - 64,1759,1037,722,21
San Marcos,Todos los estados civiles,65 y más,3989,2218,1771,21
San Marcos,Todos los estados civiles,Ignorado,6,5,1,21
San Marcos,Soltero(a),Todas las edades,3694,2092,1602,21
San Marcos,Soltero(a),Menos de 15 años,276,163,113,21
San Marcos,Soltero(a),15 - 24,193,131,62,21
San Marcos,Soltero(a),25 - 44,564,406,158,21
San Marcos,Soltero(a),45 - 64,683,405,278,21
San Marcos,Soltero(a),65 y más,1973,983,990,21
San Marcos,Soltero(a),Ignorado,5,4,1,21
San Marcos,Casado(a),Todas las edades,3305,2009,1296,21
San Marcos,Casado(a),Menos de 15 años,0,0,0,21
San Marcos,Casado(a),15 - 24,14,9,5,21
San Marcos,Casado(a),25 - 44,331,208,123,21
San Marcos,Casado(a),45 - 64,1030,613,417,21
San Marcos,Casado(a),65 y más,1930,1179,751,21
San Marcos,Casado(a),Ignorado,0,0,0,21
San Marcos,Unido(a),Todas las edades,133,75,58,21
San Marcos,Unido(a),Menos de 15 años,0,0,0,21
San Marcos,Unido(a),15 - 24,0,0,0,21
San Marcos,Unido(a),25 - 44,3,2,1,21
San Marcos,Unido(a),45 - 64,45,18,27,21
San Marcos,Unido(a),65 y más,85,55,30,21
San Marcos,Unido(a),Ignorado,0,0,0,21
San Marcos,Ignorado(a),Todas las edades,3,3,0,21
San Marcos,Ignorado(a),Menos de 15 años,0,0,0,21
San Marcos,Ignorado(a),15 - 24,0,0,0,21
San Marcos,Ignorado(a),25 - 44,0,0,0,21
San Marcos,Ignorado(a),45 - 64,1,1,0,21
San Marcos,Ignorado(a),65 y más,1,1,0,21
San Marcos,Ignorado(a),Ignorado,1,1,0,21
Huehuetenango,Todos los estados civiles,Todas las edades,6531,3694,2837,21
Huehuetenango,Todos los estados civiles,Menos de 15 años,256,129,127,21
Huehuetenango,Todos los estados civiles,15 - 24,228,141,87,21
Huehuetenango,Todos los estados civiles,25 - 44,847,526,321,21
Huehuetenango,Todos los estados civiles,45 - 64,1512,858,654,21
Huehuetenango,Todos los estados civiles,65 y más,3687,2040,1647,21
Huehuetenango,Todos los estados civiles,Ignorado,1,0,1,21
Huehuetenango,Soltero(a),Todas las edades,3764,2016,1748,21
Huehuetenango,Soltero(a),Menos de 15 años,256,129,127,21
Huehuetenango,Soltero(a),15 - 24,211,131,80,21
Huehuetenango,Soltero(a),25 - 44,496,314,182,21
Huehuetenango,Soltero(a),45 - 64,598,329,269,21
Huehuetenango,Soltero(a),65 y más,2203,1113,1090,21
Huehuetenango,Soltero(a),Ignorado,0,0,0,21
Huehuetenango,Casado(a),Todas las edades,2745,1670,1075,21
Huehuetenango,Casado(a),Menos de 15 años,0,0,0,21
Huehuetenango,Casado(a),15 - 24,17,10,7,21
Huehuetenango,Casado(a),25 - 44,350,212,138,21
Huehuetenango,Casado(a),45 - 64,914,529,385,21
Huehuetenango,Casado(a),65 y más,1463,919,544,21
Huehuetenango,Casado(a),Ignorado,1,0,1,21
Huehuetenango,Unido(a),Todas las edades,19,6,13,21
Huehuetenango,Unido(a),Menos de 15 años,0,0,0,21
Huehuetenango,Unido(a),15 - 24,0,0,0,21
Huehuetenango,Unido(a),25 - 44,0,0,0,21
Huehuetenango,Unido(a),45 - 64,0,0,0,21
Huehuetenango,Unido(a),65 y más,19,6,13,21
Huehuetenango,Unido(a),Ignorado,0,0,0,21
Huehuetenango,Ignorado(a),Todas las edades,3,2,1,21
Huehuetenango,Ignorado(a),Menos de 15 años,0,0,0,21
Huehuetenango,Ignorado(a),15 - 24,0,0,0,21
Huehuetenango,Ignorado(a),25 - 44,1,0,1,21
Huehuetenango,Ignorado(a),45 - 64,0,0,0,21
Huehuetenango,Ignorado(a),65 y más,2,2,0,21
Huehuetenango,Ignorado(a),Ignorado,0,0,0,21
Quiché,Todos los estados civiles,Todas las edades,5617,3047,2570,21
Quiché,Todos los estados civiles,Menos de 15 años,159,87,72,21
Quiché,Todos los estados civiles,15 - 24,209,119,90,21
Quiché,Todos los estados civiles,25 - 44,820,490,330,21
Quiché,Todos los estados civiles,45 - 64,1399,762,637,21
Quiché,Todos los estados civiles,65 y más,3027,1588,1439,21
Quiché,Todos los estados civiles,Ignorado,3,1,2,21
Quiché,Soltero(a),Todas las edades,3084,1517,1567,21
Quiché,Soltero(a),Menos de 15 años,159,87,72,21
Quiché,Soltero(a),15 - 24,188,111,77,21
Quiché,Soltero(a),25 - 44,446,272,174,21
Quiché,Soltero(a),45 - 64,555,281,274,21
Quiché,Soltero(a),65 y más,1735,766,969,21
Quiché,Soltero(a),Ignorado,1,0,1,21
Quiché,Casado(a),Todas las edades,2492,1505,987,21
Quiché,Casado(a),Menos de 15 años,0,0,0,21
Quiché,Casado(a),15 - 24,21,8,13,21
Quiché,Casado(a),25 - 44,372,217,155,21
Quiché,Casado(a),45 - 64,840,479,361,21
Quiché,Casado(a),65 y más,1259,801,458,21
Quiché,Casado(a),Ignorado,0,0,0,21
Quiché,Unido(a),Todas las edades,36,22,14,21
Quiché,Unido(a),Menos de 15 años,0,0,0,21
Quiché,Unido(a),15 - 24,0,0,0,21
Quiché,Unido(a),25 - 44,2,1,1,21
Quiché,Unido(a),45 - 64,4,2,2,21
Quiché,Unido(a),65 y más,30,19,11,21
Quiché,Unido(a),Ignorado,0,0,0,21
Quiché,Ignorado(a),Todas las edades,5,3,2,21
Quiché,Ignorado(a),Menos de 15 años,0,0,0,21
Quiché,Ignorado(a),15 - 24,0,0,0,21
Quiché,Ignorado(a),25 - 44,0,0,0,21
Quiché,Ignorado(a),45 - 64,0,0,0,21
Quiché,Ignorado(a),65 y más,3,2,1,21
Quiché,Ignorado(a),Ignorado,2,1,1,21
Baja Verapaz,Todos los estados civiles,Todas las edades,1814,973,841,21
Baja Verapaz,Todos los estados civiles,Menos de 15 años,72,37,35,21
Baja Verapaz,Todos los estados civiles,15 - 24,68,46,22,21
Baja Verapaz,Todos los estados civiles,25 - 44,199,126,73,21
Baja Verapaz,Todos los estados civiles,45 - 64,421,217,204,21
Baja Verapaz,Todos los estados civiles,65 y más,1050,546,504,21
Baja Verapaz,Todos los estados civiles,Ignorado,4,1,3,21
Baja Verapaz,Soltero(a),Todas las edades,891,429,462,21
Baja Verapaz,Soltero(a),Menos de 15 años,72,37,35,21
Baja Verapaz,Soltero(a),15 - 24,56,38,18,21
Baja Verapaz,Soltero(a),25 - 44,106,73,33,21
Baja Verapaz,Soltero(a),45 - 64,142,70,72,21
Baja Verapaz,Soltero(a),65 y más,514,211,303,21
Baja Verapaz,Soltero(a),Ignorado,1,0,1,21
Baja Verapaz,Casado(a),Todas las edades,897,533,364,21
Baja Verapaz,Casado(a),Menos de 15 años,0,0,0,21
Baja Verapaz,Casado(a),15 - 24,12,8,4,21
Baja Verapaz,Casado(a),25 - 44,93,53,40,21
Baja Verapaz,Casado(a),45 - 64,271,146,125,21
Baja Verapaz,Casado(a),65 y más,518,325,193,21
Baja Verapaz,Casado(a),Ignorado,3,1,2,21
Baja Verapaz,Unido(a),Todas las edades,24,11,13,21
Baja Verapaz,Unido(a),Menos de 15 años,0,0,0,21
Baja Verapaz,Unido(a),15 - 24,0,0,0,21
Baja Verapaz,Unido(a),25 - 44,0,0,0,21
Baja Verapaz,Unido(a),45 - 64,7,1,6,21
Baja Verapaz,Unido(a),65 y más,17,10,7,21
Baja Verapaz,Unido(a),Ignorado,0,0,0,21
Baja Verapaz,Ignorado(a),Todas las edades,2,0,2,21
Baja Verapaz,Ignorado(a),Menos de 15 años,0,0,0,21
Baja Verapaz,Ignorado(a),15 - 24,0,0,0,21
Baja Verapaz,Ignorado(a),25 - 44,0,0,0,21
Baja Verapaz,Ignorado(a),45 - 64,1,0,1,21
Baja Verapaz,Ignorado(a),65 y más,1,0,1,21
Baja Verapaz,Ignorado(a),Ignorado,0,0,0,21
Alta Verapaz,Todos los estados civiles,Todas las edades,5423,2830,2593,21
Alta Verapaz,Todos los estados civiles,Menos de 15 años,403,209,194,21
Alta Verapaz,Todos los estados civiles,15 - 24,232,166,66,21
Alta Verapaz,Todos los estados civiles,25 - 44,821,459,362,21
Alta Verapaz,Todos los estados civiles,45 - 64,1259,595,664,21
Alta Verapaz,Todos los estados civiles,65 y más,2703,1398,1305,21
Alta Verapaz,Todos los estados civiles,Ignorado,5,3,2,21
Alta Verapaz,Soltero(a),Todas las edades,2417,1161,1256,21
Alta Verapaz,Soltero(a),Menos de 15 años,403,209,194,21
Alta Verapaz,Soltero(a),15 - 24,215,157,58,21
Alta Verapaz,Soltero(a),25 - 44,403,242,161,21
Alta Verapaz,Soltero(a),45 - 64,332,147,185,21
Alta Verapaz,Soltero(a),65 y más,1061,405,656,21
Alta Verapaz,Soltero(a),Ignorado,3,1,2,21
Alta Verapaz,Casado(a),Todas las edades,2916,1620,1296,21
Alta Verapaz,Casado(a),Menos de 15 años,0,0,0,21
Alta Verapaz,Casado(a),15 - 24,17,9,8,21
Alta Verapaz,Casado(a),25 - 44,412,213,199,21
Alta Verapaz,Casado(a),45 - 64,906,439,467,21
Alta Verapaz,Casado(a),65 y más,1581,959,622,21
Alta Verapaz,Casado(a),Ignorado,0,0,0,21
Alta Verapaz,Unido(a),Todas las edades,84,44,40,21
Alta Verapaz,Unido(a),Menos de 15 años,0,0,0,21
Alta Verapaz,Unido(a),15 - 24,0,0,0,21
Alta Verapaz,Unido(a),25 - 44,4,2,2,21
Alta Verapaz,Unido(a),45 - 64,20,8,12,21
Alta Verapaz,Unido(a),65 y más,60,34,26,21
Alta Verapaz,Unido(a),Ignorado,0,0,0,21
Alta Verapaz,Ignorado(a),Todas las edades,6,5,1,21
Alta Verapaz,Ignorado(a),Menos de 15 años,0,0,0,21
Alta Verapaz,Ignorado(a),15 - 24,0,0,0,21
Alta Verapaz,Ignorado(a),25 - 44,2,2,0,21
Alta Verapaz,Ignorado(a),45 - 64,1,1,0,21
Alta Verapaz,Ignorado(a),65 y más,1,0,1,21
Alta Verapaz,Ignorado(a),Ignorado,2,2,0,21
Petén,Todos los estados civiles,Todas las edades,3222,1832,1390,21
Petén,Todos los estados civiles,Menos de 15 años,56,28,28,21
Petén,Todos los estados civiles,15 - 24,145,92,53,21
Petén,Todos los estados civiles,25 - 44,528,320,208,21
Petén,Todos los estados civiles,45 - 64,873,453,420,21
Petén,Todos los estados civiles,65 y más,1618,939,679,21
Petén,Todos los estados civiles,Ignorado,2,0,2,21
Petén,Soltero(a),Todas las edades,1770,996,774,21
Petén,Soltero(a),Menos de 15 años,56,28,28,21
Petén,Soltero(a),15 - 24,136,89,47,21
Petén,Soltero(a),25 - 44,316,211,105,21
Petén,Soltero(a),45 - 64,344,178,166,21
Petén,Soltero(a),65 y más,918,490,428,21
Petén,Soltero(a),Ignorado,0,0,0,21
Petén,Casado(a),Todas las edades,1212,718,494,21
Petén,Casado(a),Menos de 15 años,0,0,0,21
Petén,Casado(a),15 - 24,9,3,6,21
Petén,Casado(a),25 - 44,196,106,90,21
Petén,Casado(a),45 - 64,424,226,198,21
Petén,Casado(a),65 y más,582,383,199,21
Petén,Casado(a),Ignorado,1,0,1,21
Petén,Unido(a),Todas las edades,239,117,122,21
Petén,Unido(a),Menos de 15 años,0,0,0,21
Petén,Unido(a),15 - 24,0,0,0,21
Petén,Unido(a),25 - 44,16,3,13,21
Petén,Unido(a),45 - 64,105,49,56,21
Petén,Unido(a),65 y más,117,65,52,21
Petén,Unido(a),Ignorado,1,0,1,21
Petén,Ignorado(a),Todas las edades,1,1,0,21
Petén,Ignorado(a),Menos de 15 años,0,0,0,21
Petén,Ignorado(a),15 - 24,0,0,0,21
Petén,Ignorado(a),25 - 44,0,0,0,21
Petén,Ignorado(a),45 - 64,0,0,0,21
Petén,Ignorado(a),65 y más,1,1,0,21
Petén,Ignorado(a),Ignorado,0,0,0,21
Izabal,Todos los estados civiles,Todas las edades,2932,1663,1269,21
Izabal,Todos los estados civiles,Menos de 15 años,135,72,63,21
Izabal,Todos los estados civiles,15 - 24,149,117,32,21
Izabal,Todos los estados civiles,25 - 44,445,293,152,21
Izabal,Todos los estados civiles,45 - 64,731,366,365,21
Izabal,Todos los estados civiles,65 y más,1471,815,656,21
Izabal,Todos los estados civiles,Ignorado,1,0,1,21
Izabal,Soltero(a),Todas las edades,1776,975,801,21
Izabal,Soltero(a),Menos de 15 años,135,72,63,21
Izabal,Soltero(a),15 - 24,147,116,31,21
Izabal,Soltero(a),25 - 44,301,209,92,21
Izabal,Soltero(a),45 - 64,352,179,173,21
Izabal,Soltero(a),65 y más,841,399,442,21
Izabal,Soltero(a),Ignorado,0,0,0,21
Izabal,Casado(a),Todas las edades,1090,647,443,21
Izabal,Casado(a),Menos de 15 años,0,0,0,21
Izabal,Casado(a),15 - 24,2,1,1,21
Izabal,Casado(a),25 - 44,143,83,60,21
Izabal,Casado(a),45 - 64,365,181,184,21
Izabal,Casado(a),65 y más,579,382,197,21
Izabal,Casado(a),Ignorado,1,0,1,21
Izabal,Unido(a),Todas las edades,58,36,22,21
Izabal,Unido(a),Menos de 15 años,0,0,0,21
Izabal,Unido(a),15 - 24,0,0,0,21
Izabal,Unido(a),25 - 44,0,0,0,21
Izabal,Unido(a),45 - 64,10,4,6,21
Izabal,Unido(a),65 y más,48,32,16,21
Izabal,Unido(a),Ignorado,0,0,0,21
Izabal,Ignorado(a),Todas las edades,8,5,3,21
Izabal,Ignorado(a),Menos de 15 años,0,0,0,21
Izabal,Ignorado(a),15 - 24,0,0,0,21
Izabal,Ignorado(a),25 - 44,1,1,0,21
Izabal,Ignorado(a),45 - 64,4,2,2,21
Izabal,Ignorado(a),65 y más,3,2,1,21
Izabal,Ignorado(a),Ignorado,0,0,0,21
Zacapa,Todos los estados civiles,Todas las edades,2090,1148,942,21
Zacapa,Todos los estados civiles,Menos de 15 años,34,20,14,21
Zacapa,Todos los estados civiles,15 - 24,89,65,24,21
Zacapa,Todos los estados civiles,25 - 44,289,200,89,21
Zacapa,Todos los estados civiles,45 - 64,531,279,252,21
Zacapa,Todos los estados civiles,65 y más,1144,581,563,21
Zacapa,Todos los estados civiles,Ignorado,3,3,0,21
Zacapa,Soltero(a),Todas las edades,1152,590,562,21
Zacapa,Soltero(a),Menos de 15 años,34,20,14,21
Zacapa,Soltero(a),15 - 24,86,64,22,21
Zacapa,Soltero(a),25 - 44,187,134,53,21
Zacapa,Soltero(a),45 - 64,228,110,118,21
Zacapa,Soltero(a),65 y más,615,260,355,21
Zacapa,Soltero(a),Ignorado,2,2,0,21
Zacapa,Casado(a),Todas las edades,928,552,376,21
Zacapa,Casado(a),Menos de 15 años,0,0,0,21
Zacapa,Casado(a),15 - 24,3,1,2,21
Zacapa,Casado(a),25 - 44,102,66,36,21
Zacapa,Casado(a),45 - 64,301,169,132,21
Zacapa,Casado(a),65 y más,521,315,206,21
Zacapa,Casado(a),Ignorado,1,1,0,21
Zacapa,Unido(a),Todas las edades,9,6,3,21
Zacapa,Unido(a),Menos de 15 años,0,0,0,21
Zacapa,Unido(a),15 - 24,0,0,0,21
Zacapa,Unido(a),25 - 44,0,0,0,21
Zacapa,Unido(a),45 - 64,1,0,1,21
Zacapa,Unido(a),65 y más,8,6,2,21
Zacapa,Unido(a),Ignorado,0,0,0,21
Zacapa,Ignorado(a),Todas las edades,1,0,1,21
Zacapa,Ignorado(a),Menos de 15 años,0,0,0,21
Zacapa,Ignorado(a),15 - 24,0,0,0,21
Zacapa,Ignorado(a),25 - 44,0,0,0,21
Zacapa,Ignorado(a),45 - 64,1,0,1,21
Zacapa,Ignorado(a),65 y más,0,0,0,21
Zacapa,Ignorado(a),Ignorado,0,0,0,21
Chiquimula,Todos los estados civiles,Todas las edades,2815,1601,1214,21
Chiquimula,Todos los estados civiles,Menos de 15 años,47,24,23,21
Chiquimula,Todos los estados civiles,15 - 24,123,88,35,21
Chiquimula,Todos los estados civiles,25 - 44,388,259,129,21
Chiquimula,Todos los estados civiles,45 - 64,678,359,319,21
Chiquimula,Todos los estados civiles,65 y más,1577,870,707,21
Chiquimula,Todos los estados civiles,Ignorado,2,1,1,21
Chiquimula,Soltero(a),Todas las edades,1576,852,724,21
Chiquimula,Soltero(a),Menos de 15 años,47,24,23,21
Chiquimula,Soltero(a),15 - 24,116,83,33,21
Chiquimula,Soltero(a),25 - 44,253,172,81,21
Chiquimula,Soltero(a),45 - 64,305,153,152,21
Chiquimula,Soltero(a),65 y más,854,419,435,21
Chiquimula,Soltero(a),Ignorado,1,1,0,21
Chiquimula,Casado(a),Todas las edades,1220,742,478,21
Chiquimula,Casado(a),Menos de 15 años,0,0,0,21
Chiquimula,Casado(a),15 - 24,7,5,2,21
Chiquimula,Casado(a),25 - 44,133,86,47,21
Chiquimula,Casado(a),45 - 64,371,206,165,21
Chiquimula,Casado(a),65 y más,709,445,264,21
Chiquimula,Casado(a),Ignorado,0,0,0,21
Chiquimula,Unido(a),Todas las edades,16,7,9,21
Chiquimula,Unido(a),Menos de 15 años,0,0,0,21
Chiquimula,Unido(a),15 - 24,0,0,0,21
Chiquimula,Unido(a),25 - 44,2,1,1,21
Chiquimula,Unido(a),45 - 64,2,0,2,21
Chiquimula,Unido(a),65 y más,12,6,6,21
Chiquimula,Unido(a),Ignorado,0,0,0,21
Chiquimula,Ignorado(a),Todas las edades,3,0,3,21
Chiquimula,Ignorado(a),Menos de 15 años,0,0,0,21
Chiquimula,Ignorado(a),15 - 24,0,0,0,21
Chiquimula,Ignorado(a),25 - 44,0,0,0,21
Chiquimula,Ignorado(a),45 - 64,0,0,0,21
Chiquimula,Ignorado(a),65 y más,2,0,2,21
Chiquimula,Ignorado(a),Ignorado,1,0,1,21
Jalapa,Todos los estados civiles,Todas las edades,2187,1264,923,21
Jalapa,Todos los estados civiles,Menos de 15 años,18,12,6,21
Jalapa,Todos los estados civiles,15 - 24,104,66,38,21
Jalapa,Todos los estados civiles,25 - 44,346,227,119,21
Jalapa,Todos los estados civiles,45 - 64,501,292,209,21
Jalapa,Todos los estados civiles,65 y más,1214,663,551,21
Jalapa,Todos los estados civiles,Ignorado,4,4,0,21
Jalapa,Soltero(a),Todas las edades,1028,559,469,21
Jalapa,Soltero(a),Menos de 15 años,18,12,6,21
Jalapa,Soltero(a),15 - 24,98,62,36,21
Jalapa,Soltero(a),25 - 44,219,151,68,21
Jalapa,Soltero(a),45 - 64,154,91,63,21
Jalapa,Soltero(a),65 y más,539,243,296,21
Jalapa,Soltero(a),Ignorado,0,0,0,21
Jalapa,Casado(a),Todas las edades,1146,696,450,21
Jalapa,Casado(a),Menos de 15 años,0,0,0,21
Jalapa,Casado(a),15 - 24,5,3,2,21
Jalapa,Casado(a),25 - 44,126,75,51,21
Jalapa,Casado(a),45 - 64,347,201,146,21
Jalapa,Casado(a),65 y más,668,417,251,21
Jalapa,Casado(a),Ignorado,0,0,0,21
Jalapa,Unido(a),Todas las edades,8,4,4,21
Jalapa,Unido(a),Menos de 15 años,0,0,0,21
Jalapa,Unido(a),15 - 24,0,0,0,21
Jalapa,Unido(a),25 - 44,1,1,0,21
Jalapa,Unido(a),45 - 64,0,0,0,21
Jalapa,Unido(a),65 y más,7,3,4,21
Jalapa,Unido(a),Ignorado,0,0,0,21
Jalapa,Ignorado(a),Todas las edades,5,5,0,21
Jalapa,Ignorado(a),Menos de 15 años,0,0,0,21
Jalapa,Ignorado(a),15 - 24,1,1,0,21
Jalapa,Ignorado(a),25 - 44,0,0,0,21
Jalapa,Ignorado(a),45 - 64,0,0,0,21
Jalapa,Ignorado(a),65 y más,0,0,0,21
Jalapa,Ignorado(a),Ignorado,4,4,0,21
Jutiapa,Todos los estados civiles,Todas las edades,3675,2017,1658,21
Jutiapa,Todos los estados civiles,Menos de 15 años,38,19,19,21
Jutiapa,Todos los estados civiles,15 - 24,126,92,34,21
Jutiapa,Todos los estados civiles,25 - 44,411,277,134,21
Jutiapa,Todos los estados civiles,45 - 64,868,479,389,21
Jutiapa,Todos los estados civiles,65 y más,2228,1148,1080,21
Jutiapa,Todos los estados civiles,Ignorado,4,2,2,21
Jutiapa,Soltero(a),Todas las edades,2066,1061,1005,21
Jutiapa,Soltero(a),Menos de 15 años,38,19,19,21
Jutiapa,Soltero(a),15 - 24,121,91,30,21
Jutiapa,Soltero(a),25 - 44,281,199,82,21
Jutiapa,Soltero(a),45 - 64,372,208,164,21
Jutiapa,Soltero(a),65 y más,1253,544,709,21
Jutiapa,Soltero(a),Ignorado,1,0,1,21
Jutiapa,Casado(a),Todas las edades,1571,932,639,21
Jutiapa,Casado(a),Menos de 15 años,0,0,0,21
Jutiapa,Casado(a),15 - 24,5,1,4,21
Jutiapa,Casado(a),25 - 44,128,76,52,21
Jutiapa,Casado(a),45 - 64,487,264,223,21
Jutiapa,Casado(a),65 y más,949,590,359,21
Jutiapa,Casado(a),Ignorado,2,1,1,21
Jutiapa,Unido(a),Todas las edades,35,22,13,21
Jutiapa,Unido(a),Menos de 15 años,0,0,0,21
Jutiapa,Unido(a),15 - 24,0,0,0,21
Jutiapa,Unido(a),25 - 44,2,2,0,21
Jutiapa,Unido(a),45 - 64,8,6,2,21
Jutiapa,Unido(a),65 y más,25,14,11,21
Jutiapa,Unido(a),Ignorado,0,0,0,21
Jutiapa,Ignorado(a),Todas las edades,3,2,1,21
Jutiapa,Ignorado(a),Menos de 15 años,0,0,0,21
Jutiapa,Ignorado(a),15 - 24,0,0,0,21
Jutiapa,Ignorado(a),25 - 44,0,0,0,21
Jutiapa,Ignorado(a),45 - 64,1,1,0,21
Jutiapa,Ignorado(a),65 y más,1,0,1,21
Jutiapa,Ignorado(a),Ignorado,1,1,0,21
Extranjero,Todos los estados civiles,Todas las edades,208,150,58,21
Extranjero,Todos los estados civiles,Menos de 15 años,3,2,1,21
Extranjero,Todos los estados civiles,15 - 24,7,4,3,21
Extranjero,Todos los estados civiles,25 - 44,57,50,7,21
Extranjero,Todos los estados civiles,45 - 64,100,72,28,21
Extranjero,Todos los estados civiles,65 y más,41,22,19,21
Extranjero,Todos los estados civiles,Ignorado,0,0,0,21
Extranjero,Soltero(a),Todas las edades,120,82,38,21
Extranjero,Soltero(a),Menos de 15 años,3,2,1,21
Extranjero,Soltero(a),15 - 24,6,3,3,21
Extranjero,Soltero(a),25 - 44,35,29,6,21
Extranjero,Soltero(a),45 - 64,48,35,13,21
Extranjero,Soltero(a),65 y más,28,13,15,21
Extranjero,Soltero(a),Ignorado,0,0,0,21
Extranjero,Casado(a),Todas las edades,71,55,16,21
Extranjero,Casado(a),Menos de 15 años,0,0,0,21
Extranjero,Casado(a),15 - 24,0,0,0,21
Extranjero,Casado(a),25 - 44,16,16,0,21
Extranjero,Casado(a),45 - 64,45,31,14,21
Extranjero,Casado(a),65 y más,10,8,2,21
Extranjero,Casado(a),Ignorado,0,0,0,21
Extranjero,Unido(a),Todas las edades,1,1,0,21
Extranjero,Unido(a),Menos de 15 años,0,0,0,21
Extranjero,Unido(a),15 - 24,0,0,0,21
Extranjero,Unido(a),25 - 44,0,0,0,21
Extranjero,Unido(a),45 - 64,1,1,0,21
Extranjero,Unido(a),65 y más,0,0,0,21
Extranjero,Unido(a),Ignorado,0,0,0,21
Extranjero,Ignorado(a),Todas las edades,16,12,4,21
Extranjero,Ignorado(a),Menos de 15 años,0,0,0,21
Extranjero,Ignorado(a),15 - 24,1,1,0,21
Extranjero,Ignorado(a),25 - 44,6,5,1,21
Extranjero,Ignorado(a),45 - 64,6,5,1,21
Extranjero,Ignorado(a),65 y más,3,1,2,21
Extranjero,Ignorado(a),Ignorado,0,0,0,21
Ignorado,Todos los estados civiles,Todas las edades,8750,4964,3786,21
Ignorado,Todos los estados civiles,Menos de 15 años,6744,3717,3027,21
Ignorado,Todos los estados civiles,15 - 24,841,548,293,21
Ignorado,Todos los estados civiles,25 - 44,208,164,44,21
Ignorado,Todos los estados civiles,45 - 64,263,170,93,21
Ignorado,Todos los estados civiles,65 y más,512,230,282,21
Ignorado,Todos los estados civiles,Ignorado,182,135,47,21
Ignorado,Todos los estados civiles,Todas las edades,8387,4684,3703,21
Ignorado,Soltero(a),Menos de 15 años,6743,3717,3026,21
Ignorado,Soltero(a),15 - 24,809,522,287,21
Ignorado,Soltero(a),25 - 44,165,128,37,21
Ignorado,Soltero(a),45 - 64,194,116,78,21
Ignorado,Soltero(a),65 y más,449,187,262,21
Ignorado,Soltero(a),Ignorado,27,14,13,21
Ignorado,Casado(a),Todas las edades,55,40,15,21
Ignorado,Casado(a),Menos de 15 años,0,0,0,21
Ignorado,Casado(a),15 - 24,0,0,0,21
Ignorado,Casado(a),25 - 44,7,5,2,21
Ignorado,Casado(a),45 - 64,18,15,3,21
Ignorado,Casado(a),65 y más,30,20,10,21
Ignorado,Casado(a),Ignorado,0,0,0,21
Ignorado,Unido(a),Todas las edades,3,1,2,21
Ignorado,Unido(a),Menos de 15 años,0,0,0,21
Ignorado,Unido(a),15 - 24,0,0,0,21
Ignorado,Unido(a),25 - 44,0,0,0,21
Ignorado,Unido(a),45 - 64,0,0,0,21
Ignorado,Unido(a),65 y más,3,1,2,21
Ignorado,Unido(a),Ignorado,0,0,0,21
Ignorado,Ignorado(a),Todas las edades,305,239,66,21
Ignorado,Ignorado(a),Menos de 15 años,1,0,1,21
Ignorado,Ignorado(a),15 - 24,32,26,6,21
Ignorado,Ignorado(a),25 - 44,36,31,5,21
Ignorado,Ignorado(a),45 - 64,51,39,12,21
Ignorado,Ignorado(a),65 y más,30,22,8,21
Ignorado,Ignorado(a),Ignorado,155,121,34,21
