Departamento de residencia,Causa de muerte,Total,Hombres,Mujeres,Anio,Código CIE-10
Todos los departamentos,Todas las causas,71707,41354,30353,09,
Todos los departamentos,"Neumonía, organismo no especificado",7013,3770,3243,09,
Todos los departamentos,"Agresión con disparo de otras armas de fuego, y las no especificadas",5000,4512,488,09,
Todos los departamentos,Exposición a factores no especificados,3693,3077,616,09,
Todos los departamentos,Infarto agudo del miocardio,3410,1843,1567,09,
Todos los departamentos,"Diabetes mellitus, no especificada",2997,1275,1722,09,
Todos los departamentos,Diarrea y gastroenteritis de presunto origen infeccioso,2502,1340,1162,09,
Todos los departamentos,"Desnutrición proteicocalórica, no especificada",2031,931,1100,09,
Todos los departamentos,Fibrosis y cirrosis del hígado,1738,1162,576,09,
Todos los departamentos,Insuficiencia cardíaca,1720,846,874,09,
Todos los departamentos,"Accidente vascular encefálico agudo, no especificado como hemorrágico o isquémico",1517,709,808,09,
Todos los departamentos,Tumor maligno del estómago,1404,644,760,09,
Todos los departamentos,Trastornos mentales y del comportamiento debidos al uso de alcohol,1178,1079,99,09,
Todos los departamentos,Tumor maligno del hígado y de las vías biliares intrahepáticas,1130,559,571,09,
Todos los departamentos,Diabetes mellitus no insulinodependiente,989,418,571,09,
Todos los departamentos,Otras septicemias,934,500,434,09,
Todos los departamentos,"Síntomas, signos y hallazgos anormales clínicos y de laboratorio, no clasificados en otra parte",5104,2536,2568,09,
Todos los departamentos,Otras causas,29347,16153,13194,09,
Guatemala,Todas las causas,16887,9705,7182,09,
Guatemala,"Agresión con disparo de otras armas de fuego, y las no especificadas",1936,1728,208,09,
Guatemala,"Diabetes mellitus, no especificada",934,414,520,09,
Guatemala,Infarto agudo del miocardio,870,446,424,09,
Guatemala,Exposición a factores no especificados,844,703,141,09,
Guatemala,"Neumonía, organismo no especificado",756,392,364,09,
Guatemala,Fibrosis y cirrosis del hígado,484,312,172,09,
Guatemala,"Desnutrición proteicocalórica, no especificada",448,191,257,09,
Guatemala,Diabetes mellitus no insulinodependiente,420,187,233,09,
Guatemala,Insuficiencia cardíaca,327,155,172,09,
Guatemala,Tumor maligno del estómago,326,147,179,09,
Guatemala,Tumor maligno del hígado y de las vías biliares intrahepáticas,311,152,159,09,
Guatemala,"Trastornos relacionados con duración corta de la gestación y con bajo peso al nacer, no clasificados en otra parte",283,153,130,09,
Guatemala,Insuficiencia renal crónica,278,133,145,09,
Guatemala,Otras enfermedades cerebrovasculares,227,101,126,09,
Guatemala,Diarrea y gastroenteritis de presunto origen infeccioso,223,128,95,09,
Guatemala,"Síntomas, signos y hallazgos anormales clínicos y de laboratorio, no clasificados en otra parte",810,384,426,09,
Guatemala,Otras causas,7410,3979,3431,09,
El Progreso,Todas las causas,1028,590,438,09,
El Progreso,Infarto agudo del miocardio,113,64,49,09,
El Progreso,"Agresión con disparo de otras armas de fuego, y las no especificadas",84,77,7,09,
El Progreso,"Neumonía, organismo no especificado",59,35,24,09,
El Progreso,"Diabetes mellitus, no especificada",55,24,31,09,
El Progreso,Exposición a factores no especificados,42,35,7,09,
El Progreso,"Accidente vascular encefálico agudo, no especificado como hemorrágico o isquémico",38,20,18,09,
El Progreso,"Desnutrición proteicocalórica, no especificada",27,18,9,09,
El Progreso,Hipertensión esencial (primaria),23,7,16,09,
El Progreso,Tumor maligno del hígado y de las vías biliares intrahepáticas,20,9,11,09,
El Progreso,Diabetes mellitus no insulinodependiente,20,6,14,09,
El Progreso,Otras enfermedades cerebrovasculares,20,6,14,09,
El Progreso,Tumor maligno del estómago,19,12,7,09,
El Progreso,Secuelas de otros efectos y los no especificados de causas externas,18,15,3,09,
El Progreso,Fibrosis y cirrosis del hígado,17,10,7,09,
El Progreso,Otras enfermedades pulmonares obstructivas crónicas,16,9,7,09,
El Progreso,"Síntomas, signos y hallazgos anormales clínicos y de laboratorio, no clasificados en otra parte",29,14,15,09,
El Progreso,Otras causas,428,229,199,09,
Sacatepequez,Todas las causas,1537,847,690,09,
Sacatepequez,"Neumonía, organismo no especificado",128,72,56,09,
Sacatepequez,Exposición a factores no especificados,100,84,16,09,
Sacatepequez,"Desnutrición proteicocalórica, no especificada",72,30,42,09,
Sacatepequez,"Diabetes mellitus, no especificada",65,26,39,09,
Sacatepequez,"Agresión con disparo de otras armas de fuego, y las no especificadas",53,44,9,09,
Sacatepequez,Diabetes mellitus no insulinodependiente,48,20,28,09,
Sacatepequez,Fibrosis y cirrosis del hígado,46,30,16,09,
Sacatepequez,Trastornos mentales y del comportamiento debidos al uso de alcohol,44,43,1,09,
Sacatepequez,Infarto agudo del miocardio,44,28,16,09,
Sacatepequez,Tumor maligno del estómago,34,11,23,09,
Sacatepequez,"Accidente vascular encefálico agudo, no especificado como hemorrágico o isquémico",34,11,23,09,
Sacatepequez,Tumor maligno del hígado y de las vías biliares intrahepáticas,33,9,24,09,
Sacatepequez,Diarrea y gastroenteritis de presunto origen infeccioso,32,19,13,09,
Sacatepequez,Enfermedad alcohólica del hígado,31,28,3,09,
Sacatepequez,Insuficiencia cardíaca,30,11,19,09,
Sacatepequez,"Síntomas, signos y hallazgos anormales clínicos y de laboratorio, no clasificados en otra parte",90,43,47,09,
Sacatepequez,Otras causas,653,338,315,09,
Chimaltenango,Todas las causas,2670,1529,1141,09,
Chimaltenango,"Neumonía, organismo no especificado",338,175,163,09,
Chimaltenango,Exposición a factores no especificados,161,129,32,09,
Chimaltenango,Insuficiencia cardíaca,136,67,69,09,
Chimaltenango,Infarto agudo del miocardio,120,66,54,09,
Chimaltenango,Trastornos mentales y del comportamiento debidos al uso de alcohol,104,97,7,09,
Chimaltenango,Enfermedad alcohólica del hígado,100,79,21,09,
Chimaltenango,Tumor maligno del estómago,98,47,51,09,
Chimaltenango,"Diabetes mellitus, no especificada",89,34,55,09,
Chimaltenango,Otras enfermedades pulmonares obstructivas crónicas,78,46,32,09,
Chimaltenango,Fibrosis y cirrosis del hígado,76,52,24,09,
Chimaltenango,"Agresión con disparo de otras armas de fuego, y las no especificadas",75,71,4,09,
Chimaltenango,"Accidente vascular encefálico agudo, no especificado como hemorrágico o isquémico",61,28,33,09,
Chimaltenango,"Desnutrición proteicocalórica, no especificada",58,25,33,09,
Chimaltenango,Sepsis bacteriana del recién nacido,46,25,21,09,
Chimaltenango,Insuficiencia renal no especificada,45,16,29,09,
Chimaltenango,"Síntomas, signos y hallazgos anormales clínicos y de laboratorio, no clasificados en otra parte",128,60,68,09,
Chimaltenango,Otras causas,957,512,445,09,
Escuintla,Todas las causas,3950,2446,1504,09,
Escuintla,"Agresión con disparo de otras armas de fuego, y las no especificadas",358,335,23,09,
Escuintla,Exposición a factores no especificados,290,257,33,09,
Escuintla,"Neumonía, organismo no especificado",211,114,97,09,
Escuintla,"Diabetes mellitus, no especificada",210,86,124,09,
Escuintla,Diarrea y gastroenteritis de presunto origen infeccioso,203,112,91,09,
Escuintla,Infarto agudo del miocardio,172,103,69,09,
Escuintla,"Desnutrición proteicocalórica, no especificada",109,62,47,09,
Escuintla,Fibrosis y cirrosis del hígado,92,67,25,09,
Escuintla,"Enfermedad por virus de la inmunodeficiencia humana [VIH], sin otra especificación",77,60,17,09,
Escuintla,Tumor maligno del hígado y de las vías biliares intrahepáticas,71,37,34,09,
Escuintla,Insuficiencia renal crónica,65,38,27,09,
Escuintla,Diabetes mellitus no insulinodependiente,56,20,36,09,
Escuintla,"Accidente vascular encefálico agudo, no especificado como hemorrágico o isquémico",56,33,23,09,
Escuintla,Tumor maligno del estómago,51,25,26,09,
Escuintla,Otras septicemias,39,24,15,09,
Escuintla,"Síntomas, signos y hallazgos anormales clínicos y de laboratorio, no clasificados en otra parte",434,199,235,09,
Escuintla,Otras causas,1456,874,582,09,
Santa Rosa,Todas las causas,2067,1232,835,09,
Santa Rosa,"Agresión con disparo de otras armas de fuego, y las no especificadas",200,177,23,09,
Santa Rosa,Infarto agudo del miocardio,137,77,60,09,
Santa Rosa,Exposición a factores no especificados,127,106,21,09,
Santa Rosa,"Neumonía, organismo no especificado",121,69,52,09,
Santa Rosa,Insuficiencia cardíaca,115,62,53,09,
Santa Rosa,"Accidente vascular encefálico agudo, no especificado como hemorrágico o isquémico",89,38,51,09,
Santa Rosa,"Diabetes mellitus, no especificada",83,26,57,09,
Santa Rosa,Insuficiencia renal crónica,49,29,20,09,
Santa Rosa,Fibrosis y cirrosis del hígado,48,36,12,09,
Santa Rosa,Tumor maligno del estómago,43,19,24,09,
Santa Rosa,Tumor maligno del hígado y de las vías biliares intrahepáticas,38,20,18,09,
Santa Rosa,Diabetes mellitus no insulinodependiente,35,14,21,09,
Santa Rosa,Trastornos mentales y del comportamiento debidos al uso de alcohol,30,30,0,09,
Santa Rosa,Hipertensión esencial (primaria),30,12,18,09,
Santa Rosa,Diarrea y gastroenteritis de presunto origen infeccioso,29,18,11,09,
Santa Rosa,"Síntomas, signos y hallazgos anormales clínicos y de laboratorio, no clasificados en otra parte",53,28,25,09,
Santa Rosa,Otras causas,840,471,369,09,
Solola,Todas las causas,1743,929,814,09,
Solola,"Neumonía, organismo no especificado",234,129,105,09,
Solola,"Desnutrición proteicocalórica, no especificada",99,41,58,09,
Solola,Exposición a factores no especificados,82,66,16,09,
Solola,Diarrea y gastroenteritis de presunto origen infeccioso,67,33,34,09,
Solola,Trastornos mentales y del comportamiento debidos al uso de alcohol,64,55,9,09,
Solola,Infarto agudo del miocardio,53,22,31,09,
Solola,"Diabetes mellitus, no especificada",48,20,28,09,
Solola,Fibrosis y cirrosis del hígado,41,27,14,09,
Solola,"Agresión con disparo de otras armas de fuego, y las no especificadas",37,37,0,09,
Solola,Otras septicemias,35,14,21,09,
Solola,Tumor maligno del estómago,30,14,16,09,
Solola,"Accidente vascular encefálico agudo, no especificado como hemorrágico o isquémico",28,13,15,09,
Solola,Otras enfermedades pulmonares obstructivas crónicas,22,12,10,09,
Solola,Otros trastornos del encéfalo,21,9,12,09,
Solola,Sepsis bacteriana del recién nacido,21,15,6,09,
Solola,"Síntomas, signos y hallazgos anormales clínicos y de laboratorio, no clasificados en otra parte",236,103,133,09,
Solola,Otras causas,625,319,306,09,
Totonicapan,Todas las causas,2289,1290,999,09,
Totonicapan,"Neumonía, organismo no especificado",522,271,251,09,
Totonicapan,Diarrea y gastroenteritis de presunto origen infeccioso,107,66,41,09,
Totonicapan,Infarto agudo del miocardio,103,54,49,09,
Totonicapan,Fibrosis y cirrosis del hígado,93,63,30,09,
Totonicapan,Exposición a factores no especificados,82,70,12,09,
Totonicapan,Insuficiencia cardíaca,81,48,33,09,
Totonicapan,"Diabetes mellitus, no especificada",76,45,31,09,
Totonicapan,Trastornos mentales y del comportamiento debidos al uso de alcohol,74,59,15,09,
Totonicapan,Hipertensión esencial (primaria),48,18,30,09,
Totonicapan,"Accidente vascular encefálico agudo, no especificado como hemorrágico o isquémico",31,13,18,09,
Totonicapan,Sepsis bacteriana del recién nacido,29,18,11,09,
Totonicapan,"Desnutrición proteicocalórica, no especificada",28,13,15,09,
Totonicapan,Úlcera gástrica,28,13,15,09,
Totonicapan,Neumonía congénita,28,16,12,09,
Totonicapan,Depleción del volumen,26,15,11,09,
Totonicapan,"Síntomas, signos y hallazgos anormales clínicos y de laboratorio, no clasificados en otra parte",273,140,133,09,
Totonicapan,Otras causas,660,368,292,09,
Quetzaltenango,Todas las causas,3921,2154,1767,09,
Quetzaltenango,"Neumonía, organismo no especificado",372,193,179,09,
Quetzaltenango,"Diabetes mellitus, no especificada",238,101,137,09,
Quetzaltenango,Exposición a factores no especificados,235,181,54,09,
Quetzaltenango,Trastornos mentales y del comportamiento debidos al uso de alcohol,156,140,16,09,
Quetzaltenango,"Desnutrición proteicocalórica, no especificada",152,72,80,09,
Quetzaltenango,Diarrea y gastroenteritis de presunto origen infeccioso,121,65,56,09,
Quetzaltenango,Insuficiencia cardíaca,117,56,61,09,
Quetzaltenango,"Agresión con disparo de otras armas de fuego, y las no especificadas",116,111,5,09,
Quetzaltenango,Infarto agudo del miocardio,110,61,49,09,
Quetzaltenango,Fibrosis y cirrosis del hígado,95,52,43,09,
Quetzaltenango,Enfermedad alcohólica del hígado,82,61,21,09,
Quetzaltenango,Diabetes mellitus no insulinodependiente,79,31,48,09,
Quetzaltenango,Tumor maligno del estómago,77,42,35,09,
Quetzaltenango,"Accidente vascular encefálico agudo, no especificado como hemorrágico o isquémico",69,26,43,09,
Quetzaltenango,Tumor maligno del hígado y de las vías biliares intrahepáticas,66,29,37,09,
Quetzaltenango,"Síntomas, signos y hallazgos anormales clínicos y de laboratorio, no clasificados en otra parte",247,110,137,09,
Quetzaltenango,Otras causas,1589,823,766,09,
Suchitepequez,Todas las causas,2781,1615,1166,09,
Suchitepequez,"Neumonía, organismo no especificado",227,127,100,09,
Suchitepequez,Exposición a factores no especificados,176,143,33,09,
Suchitepequez,"Diabetes mellitus, no especificada",146,58,88,09,
Suchitepequez,"Agresión con disparo de otras armas de fuego, y las no especificadas",145,129,16,09,
Suchitepequez,Diarrea y gastroenteritis de presunto origen infeccioso,88,44,44,09,
Suchitepequez,Infarto agudo del miocardio,80,49,31,09,
Suchitepequez,Fibrosis y cirrosis del hígado,65,43,22,09,
Suchitepequez,"Desnutrición proteicocalórica, no especificada",62,33,29,09,
Suchitepequez,Tumor maligno del hígado y de las vías biliares intrahepáticas,56,29,27,09,
Suchitepequez,Tumor maligno del estómago,50,23,27,09,
Suchitepequez,Insuficiencia cardíaca,46,19,27,09,
Suchitepequez,"Accidente vascular encefálico agudo, no especificado como hemorrágico o isquémico",45,21,24,09,
Suchitepequez,Insuficiencia renal crónica,43,28,15,09,
Suchitepequez,Insuficiencia renal no especificada,38,25,13,09,
Suchitepequez,Tumor maligno de sitios no especificados,35,17,18,09,
Suchitepequez,"Síntomas, signos y hallazgos anormales clínicos y de laboratorio, no clasificados en otra parte",535,273,262,09,
Suchitepequez,Otras causas,944,554,390,09,
Retalhuleu,Todas las causas,1621,947,674,09,
Retalhuleu,"Diabetes mellitus, no especificada",128,51,77,09,
Retalhuleu,"Neumonía, organismo no especificado",111,65,46,09,
Retalhuleu,Exposición a factores no especificados,90,78,12,09,
Retalhuleu,"Agresión con disparo de otras armas de fuego, y las no especificadas",73,67,6,09,
Retalhuleu,Infarto agudo del miocardio,65,35,30,09,
Retalhuleu,Insuficiencia renal crónica,62,48,14,09,
Retalhuleu,Insuficiencia cardíaca,57,22,35,09,
Retalhuleu,Fibrosis y cirrosis del hígado,57,38,19,09,
Retalhuleu,Diarrea y gastroenteritis de presunto origen infeccioso,46,28,18,09,
Retalhuleu,"Accidente vascular encefálico agudo, no especificado como hemorrágico o isquémico",46,22,24,09,
Retalhuleu,Tumor maligno del estómago,37,19,18,09,
Retalhuleu,Tumor maligno del hígado y de las vías biliares intrahepáticas,35,14,21,09,
Retalhuleu,Úlcera gástrica,27,14,13,09,
Retalhuleu,Otras septicemias,26,13,13,09,
Retalhuleu,Tumor maligno de la próstata,26,26,0,09,
Retalhuleu,"Síntomas, signos y hallazgos anormales clínicos y de laboratorio, no clasificados en otra parte",66,33,33,09,
Retalhuleu,Otras causas,669,374,295,09,
San Marcos,Todas las causas,4787,2784,2003,09,
San Marcos,"Neumonía, organismo no especificado",741,425,316,09,
San Marcos,Diarrea y gastroenteritis de presunto origen infeccioso,210,121,89,09,
San Marcos,Exposición a factores no especificados,207,170,37,09,
San Marcos,"Desnutrición proteicocalórica, no especificada",196,87,109,09,
San Marcos,Infarto agudo del miocardio,196,112,84,09,
San Marcos,"Agresión con disparo de otras armas de fuego, y las no especificadas",186,162,24,09,
San Marcos,Fibrosis y cirrosis del hígado,156,113,43,09,
San Marcos,"Diabetes mellitus, no especificada",146,72,74,09,
San Marcos,Trastornos mentales y del comportamiento debidos al uso de alcohol,121,111,10,09,
San Marcos,Insuficiencia cardíaca,119,64,55,09,
San Marcos,"Accidente vascular encefálico agudo, no especificado como hemorrágico o isquémico",106,48,58,09,
San Marcos,Otros trastornos del encéfalo,98,63,35,09,
San Marcos,Úlcera gástrica,96,55,41,09,
San Marcos,Tumor maligno del hígado y de las vías biliares intrahepáticas,81,42,39,09,
San Marcos,Tumor maligno del estómago,79,31,48,09,
San Marcos,"Síntomas, signos y hallazgos anormales clínicos y de laboratorio, no clasificados en otra parte",401,215,186,09,
San Marcos,Otras causas,1648,893,755,09,
Huehuetenango,Todas las causas,3934,2215,1719,09,
Huehuetenango,"Neumonía, organismo no especificado",636,350,286,09,
Huehuetenango,Diarrea y gastroenteritis de presunto origen infeccioso,271,154,117,09,
Huehuetenango,Exposición a factores no especificados,173,143,30,09,
Huehuetenango,Infarto agudo del miocardio,128,69,59,09,
Huehuetenango,Tumor maligno del estómago,116,50,66,09,
Huehuetenango,"Diabetes mellitus, no especificada",111,45,66,09,
Huehuetenango,Trastornos mentales y del comportamiento debidos al uso de alcohol,106,101,5,09,
Huehuetenango,"Accidente vascular encefálico agudo, no especificado como hemorrágico o isquémico",92,49,43,09,
Huehuetenango,Insuficiencia cardíaca,90,46,44,09,
Huehuetenango,"Agresión con disparo de otras armas de fuego, y las no especificadas",85,72,13,09,
Huehuetenango,Fibrosis y cirrosis del hígado,73,55,18,09,
Huehuetenango,"Desnutrición proteicocalórica, no especificada",66,28,38,09,
Huehuetenango,Depleción del volumen,66,36,30,09,
Huehuetenango,Tumor maligno del hígado y de las vías biliares intrahepáticas,54,34,20,09,
Huehuetenango,Úlcera gástrica,54,20,34,09,
Huehuetenango,"Síntomas, signos y hallazgos anormales clínicos y de laboratorio, no clasificados en otra parte",359,190,169,09,
Huehuetenango,Otras causas,1454,773,681,09,
Quiche,Todas las causas,3826,2103,1723,09,
Quiche,"Neumonía, organismo no especificado",687,355,332,09,
Quiche,Diarrea y gastroenteritis de presunto origen infeccioso,290,149,141,09,
Quiche,Exposición a factores no especificados,162,135,27,09,
Quiche,Trastornos mentales y del comportamiento debidos al uso de alcohol,121,114,7,09,
Quiche,Infarto agudo del miocardio,121,66,55,09,
Quiche,"Desnutrición proteicocalórica, no especificada",100,37,63,09,
Quiche,Insuficiencia cardíaca,92,41,51,09,
Quiche,"Diabetes mellitus, no especificada",81,37,44,09,
Quiche,Fibrosis y cirrosis del hígado,79,51,28,09,
Quiche,"Agresión con disparo de otras armas de fuego, y las no especificadas",77,73,4,09,
Quiche,Otras septicemias,76,40,36,09,
Quiche,Tumor maligno del estómago,67,30,37,09,
Quiche,Depleción del volumen,61,28,33,09,
Quiche,"Accidente vascular encefálico agudo, no especificado como hemorrágico o isquémico",53,24,29,09,
Quiche,Enfermedad alcohólica del hígado,44,33,11,09,
Quiche,"Síntomas, signos y hallazgos anormales clínicos y de laboratorio, no clasificados en otra parte",508,244,264,09,
Quiche,Otras causas,1207,646,561,09,
Baja Verapaz,Todas las causas,1238,717,521,09,
Baja Verapaz,"Neumonía, organismo no especificado",183,98,85,09,
Baja Verapaz,Infarto agudo del miocardio,92,48,44,09,
Baja Verapaz,"Agresión con disparo de otras armas de fuego, y las no especificadas",80,75,5,09,
Baja Verapaz,Exposición a factores no especificados,62,54,8,09,
Baja Verapaz,"Accidente vascular encefálico agudo, no especificado como hemorrágico o isquémico",56,28,28,09,
Baja Verapaz,Diarrea y gastroenteritis de presunto origen infeccioso,51,26,25,09,
Baja Verapaz,Tumor maligno del estómago,44,21,23,09,
Baja Verapaz,"Diabetes mellitus, no especificada",29,13,16,09,
Baja Verapaz,Insuficiencia cardíaca,22,9,13,09,
Baja Verapaz,Otras septicemias,21,11,10,09,
Baja Verapaz,Tumor maligno del hígado y de las vías biliares intrahepáticas,18,11,7,09,
Baja Verapaz,Trastornos mentales y del comportamiento debidos al uso de alcohol,18,17,1,09,
Baja Verapaz,"Desnutrición proteicocalórica, no especificada",17,7,10,09,
Baja Verapaz,Fibrosis y cirrosis del hígado,16,10,6,09,
Baja Verapaz,Otras enfermedades pulmonares obstructivas crónicas,13,9,4,09,
Baja Verapaz,"Síntomas, signos y hallazgos anormales clínicos y de laboratorio, no clasificados en otra parte",47,22,25,09,
Baja Verapaz,Otras causas,469,258,211,09,
Alta Verapaz,Todas las causas,4240,2267,1973,09,
Alta Verapaz,"Neumonía, organismo no especificado",758,399,359,09,
Alta Verapaz,"Desnutrición proteicocalórica, no especificada",400,180,220,09,
Alta Verapaz,Diarrea y gastroenteritis de presunto origen infeccioso,320,150,170,09,
Alta Verapaz,Infarto agudo del miocardio,163,88,75,09,
Alta Verapaz,Exposición a factores no especificados,145,122,23,09,
Alta Verapaz,"Agresión con disparo de otras armas de fuego, y las no especificadas",132,127,5,09,
Alta Verapaz,Fibrosis y cirrosis del hígado,105,64,41,09,
Alta Verapaz,Otras anemias,98,37,61,09,
Alta Verapaz,Tumor maligno del estómago,77,32,45,09,
Alta Verapaz,"Diabetes mellitus, no especificada",76,30,46,09,
Alta Verapaz,Otras anemias nutricionales,73,28,45,09,
Alta Verapaz,"Accidente vascular encefálico agudo, no especificado como hemorrágico o isquémico",68,34,34,09,
Alta Verapaz,Tumor maligno del hígado y de las vías biliares intrahepáticas,64,38,26,09,
Alta Verapaz,Insuficiencia cardíaca,50,28,22,09,
Alta Verapaz,Otras septicemias,49,22,27,09,
Alta Verapaz,"Síntomas, signos y hallazgos anormales clínicos y de laboratorio, no clasificados en otra parte",140,76,64,09,
Alta Verapaz,Otras causas,1522,812,710,09,
Peten,Todas las causas,1824,1144,680,09,
Peten,"Agresión con disparo de otras armas de fuego, y las no especificadas",266,253,13,09,
Peten,Exposición a factores no especificados,97,82,15,09,
Peten,"Neumonía, organismo no especificado",89,47,42,09,
Peten,"Diabetes mellitus, no especificada",84,27,57,09,
Peten,Agresión por medios no especificados,74,69,5,09,
Peten,Diarrea y gastroenteritis de presunto origen infeccioso,71,32,39,09,
Peten,Infarto agudo del miocardio,53,26,27,09,
Peten,Tumor maligno de sitios no especificados,34,12,22,09,
Peten,Tumor maligno del hígado y de las vías biliares intrahepáticas,31,17,14,09,
Peten,Otras enfermedades cerebrovasculares,30,18,12,09,
Peten,Tumor maligno del estómago,28,15,13,09,
Peten,Diabetes mellitus no insulinodependiente,27,13,14,09,
Peten,Secuelas de otros efectos y los no especificados de causas externas,26,22,4,09,
Peten,"Desnutrición proteicocalórica, no especificada",23,8,15,09,
Peten,Agresión con objeto cortante,23,20,3,09,
Peten,"Síntomas, signos y hallazgos anormales clínicos y de laboratorio, no clasificados en otra parte",229,125,104,09,
Peten,Otras causas,639,358,281,09,
Izabal,Todas las causas,1873,1114,759,09,
Izabal,"Agresión con disparo de otras armas de fuego, y las no especificadas",213,198,15,09,
Izabal,"Neumonía, organismo no especificado",129,65,64,09,
Izabal,Infarto agudo del miocardio,118,66,52,09,
Izabal,"Diabetes mellitus, no especificada",90,39,51,09,
Izabal,Exposición a factores no especificados,70,58,12,09,
Izabal,Secuelas de otros efectos y los no especificados de causas externas,66,50,16,09,
Izabal,Diarrea y gastroenteritis de presunto origen infeccioso,62,27,35,09,
Izabal,Insuficiencia cardíaca,42,18,24,09,
Izabal,Fibrosis y cirrosis del hígado,42,24,18,09,
Izabal,Otras septicemias,35,20,15,09,
Izabal,"Accidente vascular encefálico agudo, no especificado como hemorrágico o isquémico",34,22,12,09,
Izabal,Tumor maligno del estómago,23,8,15,09,
Izabal,Tumor maligno del hígado y de las vías biliares intrahepáticas,21,9,12,09,
Izabal,Agresión con objeto cortante,21,19,2,09,
Izabal,Diabetes mellitus no insulinodependiente,20,5,15,09,
Izabal,"Síntomas, signos y hallazgos anormales clínicos y de laboratorio, no clasificados en otra parte",159,86,73,09,
Izabal,Otras causas,728,400,328,09,
Zacapa,Todas las causas,1294,746,548,09,
Zacapa,Infarto agudo del miocardio,140,70,70,09,
Zacapa,"Agresión con disparo de otras armas de fuego, y las no especificadas",107,97,10,09,
Zacapa,Exposición a factores no especificados,73,64,9,09,
Zacapa,"Diabetes mellitus, no especificada",68,22,46,09,
Zacapa,"Neumonía, organismo no especificado",65,38,27,09,
Zacapa,Insuficiencia cardíaca,55,34,21,09,
Zacapa,"Accidente vascular encefálico agudo, no especificado como hemorrágico o isquémico",43,24,19,09,
Zacapa,Tumor maligno del hígado y de las vías biliares intrahepáticas,25,10,15,09,
Zacapa,"Desnutrición proteicocalórica, no especificada",24,16,8,09,
Zacapa,Diarrea y gastroenteritis de presunto origen infeccioso,21,11,10,09,
Zacapa,Tumor maligno del estómago,21,12,9,09,
Zacapa,Diabetes mellitus no insulinodependiente,20,6,14,09,
Zacapa,Tumor maligno de la próstata,19,19,0,09,
Zacapa,Hipertensión esencial (primaria),19,8,11,09,
Zacapa,Otros trastornos del encéfalo,16,6,10,09,
Zacapa,"Síntomas, signos y hallazgos anormales clínicos y de laboratorio, no clasificados en otra parte",40,17,23,09,
Zacapa,Otras causas,538,292,246,09,
Chiquimula,Todas las causas,1985,1165,820,09,
Chiquimula,"Neumonía, organismo no especificado",226,112,114,09,
Chiquimula,Infarto agudo del miocardio,183,96,87,09,
Chiquimula,"Agresión con disparo de otras armas de fuego, y las no especificadas",182,164,18,09,
Chiquimula,Insuficiencia cardíaca,110,47,63,09,
Chiquimula,Exposición a factores no especificados,85,64,21,09,
Chiquimula,"Accidente vascular encefálico agudo, no especificado como hemorrágico o isquémico",80,36,44,09,
Chiquimula,Diarrea y gastroenteritis de presunto origen infeccioso,67,36,31,09,
Chiquimula,"Diabetes mellitus, no especificada",64,29,35,09,
Chiquimula,Fibrosis y cirrosis del hígado,49,38,11,09,
Chiquimula,Tumor maligno del estómago,45,22,23,09,
Chiquimula,Agresión con objeto cortante,39,39,0,09,
Chiquimula,Otras septicemias,37,21,16,09,
Chiquimula,Agresión por medios no especificados,27,24,3,09,
Chiquimula,"Desnutrición proteicocalórica, no especificada",22,13,9,09,
Chiquimula,Úlcera gástrica,22,14,8,09,
Chiquimula,"Síntomas, signos y hallazgos anormales clínicos y de laboratorio, no clasificados en otra parte",61,31,30,09,
Chiquimula,Otras causas,686,379,307,09,
Jalapa,Todas las causas,1584,911,673,09,
Jalapa,"Neumonía, organismo no especificado",185,98,87,09,
Jalapa,"Agresión con disparo de otras armas de fuego, y las no especificadas",136,117,19,09,
Jalapa,Infarto agudo del miocardio,119,59,60,09,
Jalapa,"Accidente vascular encefálico agudo, no especificado como hemorrágico o isquémico",78,37,41,09,
Jalapa,Diarrea y gastroenteritis de presunto origen infeccioso,76,41,35,09,
Jalapa,Exposición a factores no especificados,53,45,8,09,
Jalapa,"Diabetes mellitus, no especificada",52,22,30,09,
Jalapa,Tumor maligno del estómago,43,19,24,09,
Jalapa,Insuficiencia cardíaca,43,26,17,09,
Jalapa,Otras enfermedades pulmonares obstructivas crónicas,32,21,11,09,
Jalapa,Tumor maligno del hígado y de las vías biliares intrahepáticas,27,14,13,09,
Jalapa,Agresión con objeto cortante,23,21,2,09,
Jalapa,"Desnutrición proteicocalórica, no especificada",20,13,7,09,
Jalapa,Fibrosis y cirrosis del hígado,20,16,4,09,
Jalapa,Tumor maligno de los bronquios y del pulmón,18,8,10,09,
Jalapa,"Síntomas, signos y hallazgos anormales clínicos y de laboratorio, no clasificados en otra parte",140,70,70,09,
Jalapa,Otras causas,519,284,235,09,
Jutiapa,Todas las causas,2499,1500,999,09,
Jutiapa,"Agresión con disparo de otras armas de fuego, y las no especificadas",244,213,31,09,
Jutiapa,Infarto agudo del miocardio,216,125,91,09,
Jutiapa,"Accidente vascular encefálico agudo, no especificado como hemorrágico o isquémico",186,99,87,09,
Jutiapa,"Neumonía, organismo no especificado",120,68,52,09,
Jutiapa,"Diabetes mellitus, no especificada",113,47,66,09,
Jutiapa,Exposición a factores no especificados,103,89,14,09,
Jutiapa,Insuficiencia cardíaca,89,46,43,09,
Jutiapa,Tumor maligno del estómago,74,38,36,09,
Jutiapa,Tumor maligno del hígado y de las vías biliares intrahepáticas,54,25,29,09,
Jutiapa,Diarrea y gastroenteritis de presunto origen infeccioso,49,26,23,09,
Jutiapa,Diabetes mellitus no insulinodependiente,43,15,28,09,
Jutiapa,Otras enfermedades cerebrovasculares,43,18,25,09,
Jutiapa,Fibrosis y cirrosis del hígado,41,26,15,09,
Jutiapa,Tumor maligno de la próstata,36,36,0,09,
Jutiapa,Hipertensión esencial (primaria),34,13,21,09,
Jutiapa,"Síntomas, signos y hallazgos anormales clínicos y de laboratorio, no clasificados en otra parte",73,46,27,09,
Jutiapa,Otras causas,981,570,411,09,
Extranjero,Todas las causas,153,105,48,09,
Extranjero,"Agresión con disparo de otras armas de fuego, y las no especificadas",32,25,7,09,
Extranjero,Exposición a factores no especificados,22,17,5,09,
Extranjero,Infarto agudo del miocardio,7,7,0,09,
Extranjero,"Neumonía, organismo no especificado",4,2,2,09,
Extranjero,Otras septicemias,3,2,1,09,
Extranjero,"Enfermedad por virus de la inmunodeficiencia humana [VIH], sin otra especificación",3,2,1,09,
Extranjero,"Diabetes mellitus, no especificada",3,1,2,09,
Extranjero,Insuficiencia cardíaca,3,2,1,09,
Extranjero,Ahogamiento y sumersión no especificados,3,3,0,09,
Extranjero,"Agresión por ahorcamiento, estrangulamiento y sofocación",3,3,0,09,
Extranjero,"Disparo de otras armas de fuego, y las no especificadas, de intención no determinada",3,3,0,09,
Extranjero,Tumor maligno del colon,2,0,2,09,
Extranjero,Otros trastornos del encéfalo,2,0,2,09,
Extranjero,Hipertensión esencial (primaria),2,1,1,09,
Extranjero,Fibrosis y cirrosis del hígado,2,2,0,09,
Extranjero,"Síntomas, signos y hallazgos anormales clínicos y de laboratorio, no clasificados en otra parte",4,3,1,09,
Extranjero,Otras causas,55,32,23,09,
Ignorado,Todas las causas,1976,1299,677,09,
Ignorado,Exposición a factores no especificados,212,182,30,09,
Ignorado,"Trastornos relacionados con duración corta de la gestación y con bajo peso al nacer, no clasificados en otra parte",170,103,67,09,
Ignorado,"Agresión con disparo de otras armas de fuego, y las no especificadas",170,147,23,09,
Ignorado,Síndromes de aspiración neonatal,121,67,54,09,
Ignorado,Dificultad respiratoria del recién nacido,115,73,42,09,
Ignorado,"Neumonía, organismo no especificado",111,71,40,09,
Ignorado,Sepsis bacteriana del recién nacido,78,46,32,09,
Ignorado,Hipoxia intrauterina,66,32,34,09,
Ignorado,Neumonía congénita,48,26,22,09,
Ignorado,Otras septicemias,42,26,16,09,
Ignorado,Diarrea y gastroenteritis de presunto origen infeccioso,41,22,19,09,
Ignorado,"Otras malformaciones congénitas, no clasificadas en otra parte",39,19,20,09,
Ignorado,"Disparo de otras armas de fuego, y las no especificadas, de intención no determinada",26,24,2,09,
Ignorado,Otras malformaciones congénitas del corazón,25,11,14,09,
Ignorado,"Desnutrición proteicocalórica, no especificada",24,12,12,09,
Ignorado,"Síntomas, signos y hallazgos anormales clínicos y de laboratorio, no clasificados en otra parte",42,24,18,09,
Ignorado,Otras causas,646,414,232,09,
Todos los departamentos,Todas las causas,72748,41829,30919,10,
Todos los departamentos,"Neumonía, organismo no especificado",7321,3932,3389,10,
Todos los departamentos,"Agresión con disparo de otras armas de fuego, y las no especificadas",4658,4149,509,10,
Todos los departamentos,Infarto agudo del miocardio,3848,2065,1783,10,
Todos los departamentos,"Diabetes mellitus, no especificada",3404,1437,1967,10,
Todos los departamentos,Exposición a factores no especificados,2879,2318,561,10,
Todos los departamentos,Diarrea y gastroenteritis de presunto origen infeccioso,2485,1308,1177,10,
Todos los departamentos,Fibrosis y cirrosis del hígado,1846,1233,613,10,
Todos los departamentos,Insuficiencia cardíaca,1748,870,878,10,
Todos los departamentos,"Desnutrición proteicocalórica, no especificada",1645,792,853,10,
Todos los departamentos,"Accidente vascular encefálico agudo, no especificado como hemorrágico o isquémico",1533,757,776,10,
Todos los departamentos,Tumor maligno del estómago,1506,699,807,10,
Todos los departamentos,Trastornos mentales y del comportamiento debidos al uso de alcohol,1235,1133,102,10,
Todos los departamentos,Tumor maligno del hígado y de las vías biliares intrahepáticas,1128,488,640,10,
Todos los departamentos,"Trastornos relacionados con duración corta de la gestación y con bajo peso al nacer, no clasificados en otra parte",1108,651,457,10,
Todos los departamentos,Diabetes mellitus no insulinodependiente,1071,442,629,10,
Todos los departamentos,"Síntomas, signos y hallazgos anormales clínicos y de laboratorio, no clasificados en otra parte",5054,2581,2473,10,
Todos los departamentos,Otras causas,30279,16974,13305,10,
Guatemala,Todas las causas,18187,10367,7820,10,
Guatemala,"Agresión con disparo de otras armas de fuego, y las no especificadas",1826,1610,216,10,
Guatemala,"Diabetes mellitus, no especificada",1124,502,622,10,
Guatemala,Infarto agudo del miocardio,1013,538,475,10,
Guatemala,"Neumonía, organismo no especificado",841,455,386,10,
Guatemala,Exposición a factores no especificados,773,619,154,10,
Guatemala,Fibrosis y cirrosis del hígado,615,432,183,10,
Guatemala,"Trastornos relacionados con duración corta de la gestación y con bajo peso al nacer, no clasificados en otra parte",495,278,217,10,
Guatemala,"Desnutrición proteicocalórica, no especificada",455,202,253,10,
Guatemala,Diabetes mellitus no insulinodependiente,414,175,239,10,
Guatemala,Tumor maligno del estómago,368,160,208,10,
Guatemala,Insuficiencia cardíaca,337,155,182,10,
Guatemala,Insuficiencia renal crónica,329,157,172,10,
Guatemala,Tumor maligno del hígado y de las vías biliares intrahepáticas,317,131,186,10,
Guatemala,"Disparo de otras armas de fuego, y las no especificadas, de intención no determinada",303,263,40,10,
Guatemala,Otras septicemias,250,118,132,10,
Guatemala,"Síntomas, signos y hallazgos anormales clínicos y de laboratorio, no clasificados en otra parte",935,438,497,10,
Guatemala,Otras causas,7792,4134,3658,10,
El Progreso,Todas las causas,993,573,420,10,
El Progreso,Infarto agudo del miocardio,120,52,68,10,
El Progreso,"Neumonía, organismo no especificado",65,38,27,10,
El Progreso,"Diabetes mellitus, no especificada",54,18,36,10,
El Progreso,"Agresión con disparo de otras armas de fuego, y las no especificadas",54,47,7,10,
El Progreso,"Accidente vascular encefálico agudo, no especificado como hemorrágico o isquémico",50,26,24,10,
El Progreso,Exposición a factores no especificados,43,38,5,10,
El Progreso,Tumor maligno del estómago,27,18,9,10,
El Progreso,Tumor maligno del hígado y de las vías biliares intrahepáticas,25,10,15,10,
El Progreso,Insuficiencia cardíaca,24,10,14,10,
El Progreso,"Desnutrición proteicocalórica, no especificada",19,9,10,10,
El Progreso,Diarrea y gastroenteritis de presunto origen infeccioso,17,7,10,10,
El Progreso,Fibrosis y cirrosis del hígado,16,13,3,10,
El Progreso,Insuficiencia renal crónica,15,11,4,10,
El Progreso,Secuelas de otros efectos y los no especificados de causas externas,15,15,0,10,
El Progreso,Tumor maligno de la próstata,14,14,0,10,
El Progreso,"Síntomas, signos y hallazgos anormales clínicos y de laboratorio, no clasificados en otra parte",46,25,21,10,
El Progreso,Otras causas,389,222,167,10,
Sacatepequez,Todas las causas,1535,833,702,10,
Sacatepequez,"Neumonía, organismo no especificado",131,74,57,10,
Sacatepequez,"Diabetes mellitus, no especificada",101,36,65,10,
Sacatepequez,Exposición a factores no especificados,74,61,13,10,
Sacatepequez,Infarto agudo del miocardio,73,33,40,10,
Sacatepequez,"Desnutrición proteicocalórica, no especificada",55,27,28,10,
Sacatepequez,Fibrosis y cirrosis del hígado,55,33,22,10,
Sacatepequez,"Agresión con disparo de otras armas de fuego, y las no especificadas",48,42,6,10,
Sacatepequez,"Accidente vascular encefálico agudo, no especificado como hemorrágico o isquémico",41,23,18,10,
Sacatepequez,Trastornos mentales y del comportamiento debidos al uso de alcohol,36,32,4,10,
Sacatepequez,"Trastornos relacionados con duración corta de la gestación y con bajo peso al nacer, no clasificados en otra parte",31,17,14,10,
Sacatepequez,Diabetes mellitus no insulinodependiente,27,14,13,10,
Sacatepequez,Insuficiencia cardíaca,27,9,18,10,
Sacatepequez,Diarrea y gastroenteritis de presunto origen infeccioso,26,9,17,10,
Sacatepequez,Otras enfermedades cerebrovasculares,26,14,12,10,
Sacatepequez,Tumor maligno del hígado y de las vías biliares intrahepáticas,25,11,14,10,
Sacatepequez,"Síntomas, signos y hallazgos anormales clínicos y de laboratorio, no clasificados en otra parte",54,22,32,10,
Sacatepequez,Otras causas,705,376,329,10,
Chimaltenango,Todas las causas,2612,1501,1111,10,
Chimaltenango,"Neumonía, organismo no especificado",306,180,126,10,
Chimaltenango,Insuficiencia cardíaca,179,77,102,10,
Chimaltenango,"Diabetes mellitus, no especificada",115,42,73,10,
Chimaltenango,Trastornos mentales y del comportamiento debidos al uso de alcohol,114,102,12,10,
Chimaltenango,Infarto agudo del miocardio,106,53,53,10,
Chimaltenango,Exposición a factores no especificados,101,85,16,10,
Chimaltenango,Tumor maligno del estómago,97,43,54,10,
Chimaltenango,Enfermedad alcohólica del hígado,82,71,11,10,
Chimaltenango,"Accidente vascular encefálico agudo, no especificado como hemorrágico o isquémico",69,28,41,10,
Chimaltenango,"Agresión con disparo de otras armas de fuego, y las no especificadas",69,61,8,10,
Chimaltenango,"Desnutrición proteicocalórica, no especificada",61,29,32,10,
Chimaltenango,Fibrosis y cirrosis del hígado,59,47,12,10,
Chimaltenango,Secuelas de otros efectos y los no especificados de causas externas,56,47,9,10,
Chimaltenango,Otras septicemias,51,26,25,10,
Chimaltenango,Otras enfermedades pulmonares obstructivas crónicas,50,22,28,10,
Chimaltenango,"Síntomas, signos y hallazgos anormales clínicos y de laboratorio, no clasificados en otra parte",103,63,40,10,
Chimaltenango,Otras causas,994,525,469,10,
Escuintla,Todas las causas,3915,2385,1530,10,
Escuintla,"Agresión con disparo de otras armas de fuego, y las no especificadas",388,348,40,10,
Escuintla,"Neumonía, organismo no especificado",224,122,102,10,
Escuintla,Exposición a factores no especificados,213,176,37,10,
Escuintla,Infarto agudo del miocardio,191,108,83,10,
Escuintla,"Diabetes mellitus, no especificada",186,67,119,10,
Escuintla,Diarrea y gastroenteritis de presunto origen infeccioso,185,91,94,10,
Escuintla,Insuficiencia renal crónica,103,64,39,10,
Escuintla,Fibrosis y cirrosis del hígado,94,54,40,10,
Escuintla,Diabetes mellitus no insulinodependiente,74,25,49,10,
Escuintla,"Desnutrición proteicocalórica, no especificada",72,40,32,10,
Escuintla,Tumor maligno del hígado y de las vías biliares intrahepáticas,63,21,42,10,
Escuintla,Insuficiencia cardíaca,62,36,26,10,
Escuintla,Tumor maligno del estómago,49,25,24,10,
Escuintla,"Enfermedad por virus de la inmunodeficiencia humana [VIH], sin otra especificación",48,40,8,10,
Escuintla,Secuelas de otros efectos y los no especificados de causas externas,48,37,11,10,
Escuintla,"Síntomas, signos y hallazgos anormales clínicos y de laboratorio, no clasificados en otra parte",417,230,187,10,
Escuintla,Otras causas,1498,901,597,10,
Santa Rosa,Todas las causas,2134,1268,866,10,
Santa Rosa,"Agresión con disparo de otras armas de fuego, y las no especificadas",193,174,19,10,
Santa Rosa,Infarto agudo del miocardio,191,109,82,10,
Santa Rosa,"Neumonía, organismo no especificado",149,85,64,10,
Santa Rosa,"Diabetes mellitus, no especificada",119,50,69,10,
Santa Rosa,Insuficiencia cardíaca,113,60,53,10,
Santa Rosa,Exposición a factores no especificados,93,72,21,10,
Santa Rosa,"Accidente vascular encefálico agudo, no especificado como hemorrágico o isquémico",75,41,34,10,
Santa Rosa,Tumor maligno del estómago,48,24,24,10,
Santa Rosa,Tumor maligno del hígado y de las vías biliares intrahepáticas,43,15,28,10,
Santa Rosa,Secuelas de otros efectos y los no especificados de causas externas,39,33,6,10,
Santa Rosa,Fibrosis y cirrosis del hígado,38,26,12,10,
Santa Rosa,"Desnutrición proteicocalórica, no especificada",34,18,16,10,
Santa Rosa,Insuficiencia renal crónica,33,19,14,10,
Santa Rosa,Diarrea y gastroenteritis de presunto origen infeccioso,29,15,14,10,
Santa Rosa,Diabetes mellitus no insulinodependiente,28,8,20,10,
Santa Rosa,"Síntomas, signos y hallazgos anormales clínicos y de laboratorio, no clasificados en otra parte",47,25,22,10,
Santa Rosa,Otras causas,862,494,368,10,
Solola,Todas las causas,1543,879,664,10,
Solola,"Neumonía, organismo no especificado",259,139,120,10,
Solola,Exposición a factores no especificados,62,44,18,10,
Solola,Infarto agudo del miocardio,53,31,22,10,
Solola,"Diabetes mellitus, no especificada",52,25,27,10,
Solola,Trastornos mentales y del comportamiento debidos al uso de alcohol,52,45,7,10,
Solola,Diarrea y gastroenteritis de presunto origen infeccioso,47,22,25,10,
Solola,"Obstrucción de la respiración debida a hundimiento, caída de tierra u otras sustancias",44,37,7,10,
Solola,Fibrosis y cirrosis del hígado,39,27,12,10,
Solola,"Trastornos relacionados con duración corta de la gestación y con bajo peso al nacer, no clasificados en otra parte",31,17,14,10,
Solola,"Desnutrición proteicocalórica, no especificada",27,8,19,10,
Solola,Secuelas de otros efectos y los no especificados de causas externas,24,21,3,10,
Solola,Insuficiencia cardíaca,23,11,12,10,
Solola,"Accidente vascular encefálico agudo, no especificado como hemorrágico o isquémico",23,12,11,10,
Solola,Otras septicemias,22,10,12,10,
Solola,Enfermedad alcohólica del hígado,21,16,5,10,
Solola,"Síntomas, signos y hallazgos anormales clínicos y de laboratorio, no clasificados en otra parte",216,112,104,10,
Solola,Otras causas,548,302,246,10,
Totonicapan,Todas las causas,2269,1227,1042,10,
Totonicapan,"Neumonía, organismo no especificado",526,270,256,10,
Totonicapan,Diarrea y gastroenteritis de presunto origen infeccioso,126,65,61,10,
Totonicapan,Trastornos mentales y del comportamiento debidos al uso de alcohol,107,97,10,10,
Totonicapan,Insuficiencia cardíaca,92,44,48,10,
Totonicapan,Infarto agudo del miocardio,88,42,46,10,
Totonicapan,"Diabetes mellitus, no especificada",76,41,35,10,
Totonicapan,Exposición a factores no especificados,76,64,12,10,
Totonicapan,Fibrosis y cirrosis del hígado,60,44,16,10,
Totonicapan,Hipertensión esencial (primaria),28,14,14,10,
Totonicapan,Secuelas de otros efectos y los no especificados de causas externas,28,23,5,10,
Totonicapan,Diabetes mellitus no insulinodependiente,27,15,12,10,
Totonicapan,Obstrucción no especificada de la respiración,27,18,9,10,
Totonicapan,Sepsis bacteriana del recién nacido,26,17,9,10,
Totonicapan,Úlcera gástrica,25,11,14,10,
Totonicapan,"Desnutrición proteicocalórica, no especificada",24,10,14,10,
Totonicapan,"Síntomas, signos y hallazgos anormales clínicos y de laboratorio, no clasificados en otra parte",286,119,167,10,
Totonicapan,Otras causas,647,333,314,10,
Quetzaltenango,Todas las causas,3901,2233,1668,10,
Quetzaltenango,"Neumonía, organismo no especificado",346,182,164,10,
Quetzaltenango,"Diabetes mellitus, no especificada",245,100,145,10,
Quetzaltenango,Exposición a factores no especificados,175,129,46,10,
Quetzaltenango,Trastornos mentales y del comportamiento debidos al uso de alcohol,164,144,20,10,
Quetzaltenango,"Agresión con disparo de otras armas de fuego, y las no especificadas",150,130,20,10,
Quetzaltenango,"Desnutrición proteicocalórica, no especificada",110,46,64,10,
Quetzaltenango,"Trastornos relacionados con duración corta de la gestación y con bajo peso al nacer, no clasificados en otra parte",108,72,36,10,
Quetzaltenango,Infarto agudo del miocardio,107,63,44,10,
Quetzaltenango,Tumor maligno del estómago,95,46,49,10,
Quetzaltenango,Enfermedad alcohólica del hígado,95,81,14,10,
Quetzaltenango,Insuficiencia cardíaca,90,46,44,10,
Quetzaltenango,"Accidente vascular encefálico agudo, no especificado como hemorrágico o isquémico",88,46,42,10,
Quetzaltenango,Fibrosis y cirrosis del hígado,81,51,30,10,
Quetzaltenango,Diarrea y gastroenteritis de presunto origen infeccioso,70,33,37,10,
Quetzaltenango,Diabetes mellitus no insulinodependiente,68,33,35,10,
Quetzaltenango,"Síntomas, signos y hallazgos anormales clínicos y de laboratorio, no clasificados en otra parte",253,125,128,10,
Quetzaltenango,Otras causas,1656,906,750,10,
Suchitepequez,Todas las causas,2794,1634,1160,10,
Suchitepequez,"Neumonía, organismo no especificado",262,146,116,10,
Suchitepequez,"Diabetes mellitus, no especificada",132,52,80,10,
Suchitepequez,"Agresión con disparo de otras armas de fuego, y las no especificadas",120,107,13,10,
Suchitepequez,Exposición a factores no especificados,107,82,25,10,
Suchitepequez,Infarto agudo del miocardio,86,55,31,10,
Suchitepequez,Diarrea y gastroenteritis de presunto origen infeccioso,75,39,36,10,
Suchitepequez,Fibrosis y cirrosis del hígado,72,47,25,10,
Suchitepequez,Tumor maligno del hígado y de las vías biliares intrahepáticas,49,20,29,10,
Suchitepequez,Insuficiencia renal no especificada,46,29,17,10,
Suchitepequez,Tumor maligno de sitios no especificados,45,13,32,10,
Suchitepequez,"Desnutrición proteicocalórica, no especificada",44,26,18,10,
Suchitepequez,Insuficiencia renal crónica,41,28,13,10,
Suchitepequez,"Disparo de otras armas de fuego, y las no especificadas, de intención no determinada",41,35,6,10,
Suchitepequez,Tumor maligno del estómago,38,18,20,10,
Suchitepequez,Otras anemias,36,27,9,10,
Suchitepequez,"Síntomas, signos y hallazgos anormales clínicos y de laboratorio, no clasificados en otra parte",613,331,282,10,
Suchitepequez,Otras causas,987,579,408,10,
Retalhuleu,Todas las causas,1512,899,613,10,
Retalhuleu,"Diabetes mellitus, no especificada",138,54,84,10,
Retalhuleu,"Neumonía, organismo no especificado",99,50,49,10,
Retalhuleu,Fibrosis y cirrosis del hígado,74,47,27,10,
Retalhuleu,Exposición a factores no especificados,61,50,11,10,
Retalhuleu,Infarto agudo del miocardio,60,32,28,10,
Retalhuleu,Insuficiencia renal crónica,54,38,16,10,
Retalhuleu,"Agresión con disparo de otras armas de fuego, y las no especificadas",54,53,1,10,
Retalhuleu,Insuficiencia cardíaca,45,27,18,10,
Retalhuleu,"Accidente vascular encefálico agudo, no especificado como hemorrágico o isquémico",40,28,12,10,
Retalhuleu,Otras septicemias,36,22,14,10,
Retalhuleu,Diarrea y gastroenteritis de presunto origen infeccioso,35,22,13,10,
Retalhuleu,Tumor maligno del estómago,32,15,17,10,
Retalhuleu,Tumor maligno del hígado y de las vías biliares intrahepáticas,31,17,14,10,
Retalhuleu,Insuficiencia renal no especificada,31,21,10,10,
Retalhuleu,Secuelas de otros efectos y los no especificados de causas externas,25,18,7,10,
Retalhuleu,"Síntomas, signos y hallazgos anormales clínicos y de laboratorio, no clasificados en otra parte",59,34,25,10,
Retalhuleu,Otras causas,638,371,267,10,
San Marcos,Todas las causas,4586,2639,1947,10,
San Marcos,"Neumonía, organismo no especificado",810,467,343,10,
San Marcos,Infarto agudo del miocardio,215,111,104,10,
San Marcos,Diarrea y gastroenteritis de presunto origen infeccioso,207,117,90,10,
San Marcos,"Diabetes mellitus, no especificada",155,72,83,10,
San Marcos,"Desnutrición proteicocalórica, no especificada",148,78,70,10,
San Marcos,Exposición a factores no especificados,138,106,32,10,
San Marcos,"Agresión con disparo de otras armas de fuego, y las no especificadas",138,120,18,10,
San Marcos,Fibrosis y cirrosis del hígado,136,98,38,10,
San Marcos,Trastornos mentales y del comportamiento debidos al uso de alcohol,122,114,8,10,
San Marcos,"Accidente vascular encefálico agudo, no especificado como hemorrágico o isquémico",110,64,46,10,
San Marcos,Insuficiencia cardíaca,106,54,52,10,
San Marcos,Tumor maligno del estómago,94,45,49,10,
San Marcos,Úlcera gástrica,93,46,47,10,
San Marcos,Tumor maligno del hígado y de las vías biliares intrahepáticas,72,37,35,10,
San Marcos,Secuelas de otros efectos y los no especificados de causas externas,72,47,25,10,
San Marcos,"Síntomas, signos y hallazgos anormales clínicos y de laboratorio, no clasificados en otra parte",336,185,151,10,
San Marcos,Otras causas,1634,878,756,10,
Huehuetenango,Todas las causas,4266,2376,1890,10,
Huehuetenango,"Neumonía, organismo no especificado",678,360,318,10,
Huehuetenango,Diarrea y gastroenteritis de presunto origen infeccioso,309,163,146,10,
Huehuetenango,"Diabetes mellitus, no especificada",140,57,83,10,
Huehuetenango,Tumor maligno del estómago,134,65,69,10,
Huehuetenango,Infarto agudo del miocardio,132,76,56,10,
Huehuetenango,Exposición a factores no especificados,116,95,21,10,
Huehuetenango,"Accidente vascular encefálico agudo, no especificado como hemorrágico o isquémico",108,60,48,10,
Huehuetenango,"Agresión con disparo de otras armas de fuego, y las no especificadas",101,85,16,10,
Huehuetenango,Trastornos mentales y del comportamiento debidos al uso de alcohol,94,89,5,10,
Huehuetenango,Secuelas de otros efectos y los no especificados de causas externas,94,73,21,10,
Huehuetenango,Insuficiencia cardíaca,93,49,44,10,
Huehuetenango,Fibrosis y cirrosis del hígado,91,67,24,10,
Huehuetenango,Insuficiencia renal no especificada,81,37,44,10,
Huehuetenango,Tumor maligno del hígado y de las vías biliares intrahepáticas,67,38,29,10,
Huehuetenango,Otras septicemias,63,41,22,10,
Huehuetenango,"Síntomas, signos y hallazgos anormales clínicos y de laboratorio, no clasificados en otra parte",292,156,136,10,
Huehuetenango,Otras causas,1673,865,808,10,
Quiche,Todas las causas,3967,2107,1860,10,
Quiche,"Neumonía, organismo no especificado",693,354,339,10,
Quiche,Diarrea y gastroenteritis de presunto origen infeccioso,357,165,192,10,
Quiche,Trastornos mentales y del comportamiento debidos al uso de alcohol,128,111,17,10,
Quiche,Exposición a factores no especificados,126,100,26,10,
Quiche,Infarto agudo del miocardio,114,61,53,10,
Quiche,"Diabetes mellitus, no especificada",94,40,54,10,
Quiche,Insuficiencia cardíaca,90,43,47,10,
Quiche,Otras septicemias,85,31,54,10,
Quiche,Tumor maligno del estómago,77,29,48,10,
Quiche,"Agresión con disparo de otras armas de fuego, y las no especificadas",76,70,6,10,
Quiche,"Desnutrición proteicocalórica, no especificada",59,33,26,10,
Quiche,Fibrosis y cirrosis del hígado,57,40,17,10,
Quiche,Obstrucción no especificada de la respiración,54,35,19,10,
Quiche,"Accidente vascular encefálico agudo, no especificado como hemorrágico o isquémico",49,20,29,10,
Quiche,Secuelas de otros efectos y los no especificados de causas externas,49,36,13,10,
Quiche,"Síntomas, signos y hallazgos anormales clínicos y de laboratorio, no clasificados en otra parte",419,197,222,10,
Quiche,Otras causas,1440,742,698,10,
Baja Verapaz,Todas las causas,1285,697,588,10,
Baja Verapaz,"Neumonía, organismo no especificado",185,90,95,10,
Baja Verapaz,Infarto agudo del miocardio,105,48,57,10,
Baja Verapaz,Diarrea y gastroenteritis de presunto origen infeccioso,52,33,19,10,
Baja Verapaz,Exposición a factores no especificados,50,39,11,10,
Baja Verapaz,"Accidente vascular encefálico agudo, no especificado como hemorrágico o isquémico",47,19,28,10,
Baja Verapaz,"Diabetes mellitus, no especificada",41,12,29,10,
Baja Verapaz,"Agresión con disparo de otras armas de fuego, y las no especificadas",37,33,4,10,
Baja Verapaz,Insuficiencia cardíaca,35,14,21,10,
Baja Verapaz,Tumor maligno del estómago,31,11,20,10,
Baja Verapaz,Tumor maligno del hígado y de las vías biliares intrahepáticas,27,11,16,10,
Baja Verapaz,Otras enfermedades cerebrovasculares,22,13,9,10,
Baja Verapaz,Fibrosis y cirrosis del hígado,22,20,2,10,
Baja Verapaz,"Desnutrición proteicocalórica, no especificada",20,13,7,10,
Baja Verapaz,Otras enfermedades pulmonares obstructivas crónicas,17,11,6,10,
Baja Verapaz,Secuelas de otros efectos y los no especificados de causas externas,17,13,4,10,
Baja Verapaz,"Síntomas, signos y hallazgos anormales clínicos y de laboratorio, no clasificados en otra parte",54,29,25,10,
Baja Verapaz,Otras causas,523,288,235,10,
Alta Verapaz,Todas las causas,4694,2506,2188,10,
Alta Verapaz,"Neumonía, organismo no especificado",786,385,401,10,
Alta Verapaz,Diarrea y gastroenteritis de presunto origen infeccioso,326,170,156,10,
Alta Verapaz,"Desnutrición proteicocalórica, no especificada",309,144,165,10,
Alta Verapaz,Infarto agudo del miocardio,187,84,103,10,
Alta Verapaz,Exposición a factores no especificados,131,104,27,10,
Alta Verapaz,"Agresión con disparo de otras armas de fuego, y las no especificadas",118,108,10,10,
Alta Verapaz,Fibrosis y cirrosis del hígado,113,58,55,10,
Alta Verapaz,Otras anemias nutricionales,106,48,58,10,
Alta Verapaz,"Diabetes mellitus, no especificada",106,38,68,10,
Alta Verapaz,Tumor maligno del estómago,86,47,39,10,
Alta Verapaz,"Trastornos relacionados con duración corta de la gestación y con bajo peso al nacer, no clasificados en otra parte",81,53,28,10,
Alta Verapaz,"Desnutrición proteicocalórica severa, no especificada",74,31,43,10,
Alta Verapaz,Otras septicemias,70,31,39,10,
Alta Verapaz,Otras anemias,70,27,43,10,
Alta Verapaz,Tumor maligno del hígado y de las vías biliares intrahepáticas,69,24,45,10,
Alta Verapaz,"Síntomas, signos y hallazgos anormales clínicos y de laboratorio, no clasificados en otra parte",138,64,74,10,
Alta Verapaz,Otras causas,1924,1090,834,10,
Peten,Todas las causas,1755,1117,638,10,
Peten,"Agresión con disparo de otras armas de fuego, y las no especificadas",236,221,15,10,
Peten,"Neumonía, organismo no especificado",117,68,49,10,
Peten,Infarto agudo del miocardio,72,49,23,10,
Peten,"Diabetes mellitus, no especificada",62,30,32,10,
Peten,Exposición a factores no especificados,60,48,12,10,
Peten,Secuelas de otros efectos y los no especificados de causas externas,57,47,10,10,
Peten,Diarrea y gastroenteritis de presunto origen infeccioso,39,20,19,10,
Peten,Agresión por medios no especificados,39,37,2,10,
Peten,Tumor maligno de sitios no especificados,31,11,20,10,
Peten,Tumor maligno del hígado y de las vías biliares intrahepáticas,29,15,14,10,
Peten,Fibrosis y cirrosis del hígado,24,18,6,10,
Peten,Tumor maligno del estómago,23,11,12,10,
Peten,Agresión con objeto cortante,22,20,2,10,
Peten,Diabetes mellitus no insulinodependiente,21,10,11,10,
Peten,Otros trastornos del encéfalo,20,7,13,10,
Peten,"Síntomas, signos y hallazgos anormales clínicos y de laboratorio, no clasificados en otra parte",228,124,104,10,
Peten,Otras causas,675,381,294,10,
Izabal,Todas las causas,1874,1133,741,10,
Izabal,"Agresión con disparo de otras armas de fuego, y las no especificadas",170,149,21,10,
Izabal,Infarto agudo del miocardio,135,87,48,10,
Izabal,"Diabetes mellitus, no especificada",124,55,69,10,
Izabal,"Neumonía, organismo no especificado",122,68,54,10,
Izabal,Diarrea y gastroenteritis de presunto origen infeccioso,83,52,31,10,
Izabal,Exposición a factores no especificados,62,54,8,10,
Izabal,Secuelas de otros efectos y los no especificados de causas externas,55,52,3,10,
Izabal,"Accidente vascular encefálico agudo, no especificado como hemorrágico o isquémico",50,22,28,10,
Izabal,Fibrosis y cirrosis del hígado,44,19,25,10,
Izabal,Otras septicemias,36,19,17,10,
Izabal,Tumor maligno del estómago,34,16,18,10,
Izabal,Insuficiencia cardíaca,32,15,17,10,
Izabal,Insuficiencia renal no especificada,26,16,10,10,
Izabal,Tumor maligno del hígado y de las vías biliares intrahepáticas,25,13,12,10,
Izabal,Otros trastornos del encéfalo,22,9,13,10,
Izabal,"Síntomas, signos y hallazgos anormales clínicos y de laboratorio, no clasificados en otra parte",179,97,82,10,
Izabal,Otras causas,675,390,285,10,
Zacapa,Todas las causas,1357,806,551,10,
Zacapa,Infarto agudo del miocardio,168,96,72,10,
Zacapa,"Agresión con disparo de otras armas de fuego, y las no especificadas",106,97,9,10,
Zacapa,"Diabetes mellitus, no especificada",74,33,41,10,
Zacapa,"Neumonía, organismo no especificado",65,41,24,10,
Zacapa,"Accidente vascular encefálico agudo, no especificado como hemorrágico o isquémico",52,26,26,10,
Zacapa,Exposición a factores no especificados,52,39,13,10,
Zacapa,Insuficiencia cardíaca,30,22,8,10,
Zacapa,Tumor maligno del hígado y de las vías biliares intrahepáticas,29,16,13,10,
Zacapa,Otras enfermedades cerebrovasculares,25,13,12,10,
Zacapa,Diabetes mellitus no insulinodependiente,24,7,17,10,
Zacapa,"Desnutrición proteicocalórica, no especificada",23,11,12,10,
Zacapa,Tumor maligno del estómago,22,14,8,10,
Zacapa,Agresión con objeto cortante,22,16,6,10,
Zacapa,Diarrea y gastroenteritis de presunto origen infeccioso,19,10,9,10,
Zacapa,Fibrosis y cirrosis del hígado,19,10,9,10,
Zacapa,"Síntomas, signos y hallazgos anormales clínicos y de laboratorio, no clasificados en otra parte",38,18,20,10,
Zacapa,Otras causas,589,337,252,10,
Chiquimula,Todas las causas,2085,1262,823,10,
Chiquimula,"Neumonía, organismo no especificado",239,130,109,10,
Chiquimula,"Agresión con disparo de otras armas de fuego, y las no especificadas",194,183,11,10,
Chiquimula,Infarto agudo del miocardio,177,100,77,10,
Chiquimula,"Diabetes mellitus, no especificada",99,38,61,10,
Chiquimula,Insuficiencia cardíaca,99,61,38,10,
Chiquimula,"Accidente vascular encefálico agudo, no especificado como hemorrágico o isquémico",91,44,47,10,
Chiquimula,Diarrea y gastroenteritis de presunto origen infeccioso,63,39,24,10,
Chiquimula,Tumor maligno del estómago,61,24,37,10,
Chiquimula,Exposición a factores no especificados,58,50,8,10,
Chiquimula,Fibrosis y cirrosis del hígado,45,31,14,10,
Chiquimula,Otras septicemias,43,22,21,10,
Chiquimula,Secuelas de otros efectos y los no especificados de causas externas,43,37,6,10,
Chiquimula,Agresión con objeto cortante,39,37,2,10,
Chiquimula,Úlcera gástrica,32,17,15,10,
Chiquimula,Otras enfermedades cerebrovasculares,24,13,11,10,
Chiquimula,"Síntomas, signos y hallazgos anormales clínicos y de laboratorio, no clasificados en otra parte",78,47,31,10,
Chiquimula,Otras causas,700,389,311,10,
Jalapa,Todas las causas,1638,941,697,10,
Jalapa,"Neumonía, organismo no especificado",190,99,91,10,
Jalapa,Infarto agudo del miocardio,125,53,72,10,
Jalapa,"Agresión con disparo de otras armas de fuego, y las no especificadas",111,102,9,10,
Jalapa,"Accidente vascular encefálico agudo, no especificado como hemorrágico o isquémico",103,54,49,10,
Jalapa,Diarrea y gastroenteritis de presunto origen infeccioso,75,42,33,10,
Jalapa,"Diabetes mellitus, no especificada",61,26,35,10,
Jalapa,Insuficiencia cardíaca,51,27,24,10,
Jalapa,Exposición a factores no especificados,51,47,4,10,
Jalapa,Tumor maligno del estómago,48,24,24,10,
Jalapa,Otras enfermedades pulmonares obstructivas crónicas,32,19,13,10,
Jalapa,Agresión con objeto cortante,30,27,3,10,
Jalapa,Tumor maligno del hígado y de las vías biliares intrahepáticas,29,13,16,10,
Jalapa,Diabetes mellitus no insulinodependiente,26,7,19,10,
Jalapa,Fibrosis y cirrosis del hígado,25,14,11,10,
Jalapa,Otras septicemias,22,10,12,10,
Jalapa,"Síntomas, signos y hallazgos anormales clínicos y de laboratorio, no clasificados en otra parte",134,67,67,10,
Jalapa,Otras causas,525,310,215,10,
Jutiapa,Todas las causas,2589,1522,1067,10,
Jutiapa,Infarto agudo del miocardio,316,173,143,10,
Jutiapa,"Agresión con disparo de otras armas de fuego, y las no especificadas",247,226,21,10,
Jutiapa,"Accidente vascular encefálico agudo, no especificado como hemorrágico o isquémico",139,73,66,10,
Jutiapa,"Neumonía, organismo no especificado",130,66,64,10,
Jutiapa,Insuficiencia cardíaca,118,57,61,10,
Jutiapa,"Diabetes mellitus, no especificada",101,48,53,10,
Jutiapa,Tumor maligno del estómago,82,36,46,10,
Jutiapa,Exposición a factores no especificados,78,64,14,10,
Jutiapa,Secuelas de otros efectos y los no especificados de causas externas,72,63,9,10,
Jutiapa,Diabetes mellitus no insulinodependiente,64,23,41,10,
Jutiapa,Diarrea y gastroenteritis de presunto origen infeccioso,47,26,21,10,
Jutiapa,Insuficiencia renal crónica,46,23,23,10,
Jutiapa,Fibrosis y cirrosis del hígado,45,20,25,10,
Jutiapa,Otras enfermedades cerebrovasculares,42,19,23,10,
Jutiapa,Tumor maligno del hígado y de las vías biliares intrahepáticas,39,7,32,10,
Jutiapa,"Síntomas, signos y hallazgos anormales clínicos y de laboratorio, no clasificados en otra parte",60,29,31,10,
Jutiapa,Otras causas,963,569,394,10,
Extranjero,Todas las causas,136,94,42,10,
Extranjero,"Agresión con disparo de otras armas de fuego, y las no especificadas",37,28,9,10,
Extranjero,Exposición a factores no especificados,14,12,2,10,
Extranjero,"Disparo de otras armas de fuego, y las no especificadas, de intención no determinada",9,8,1,10,
Extranjero,Secuelas de otros efectos y los no especificados de causas externas,5,3,2,10,
Extranjero,"Neumonía, organismo no especificado",4,3,1,10,
Extranjero,Agresión con objeto cortante,4,2,2,10,
Extranjero,Diabetes mellitus no insulinodependiente,3,0,3,10,
Extranjero,Infarto agudo del miocardio,3,2,1,10,
Extranjero,Obstrucción no especificada de la respiración,3,3,0,10,
Extranjero,Otras septicemias,2,0,2,10,
Extranjero,"Diabetes mellitus, no especificada",2,0,2,10,
Extranjero,"Meningitis bacteriana, no clasificada en otra parte",2,1,1,10,
Extranjero,Hipertensión esencial (primaria),2,1,1,10,
Extranjero,Otras enfermedades cerebrovasculares,2,1,1,10,
Extranjero,Ahogamiento y sumersión no especificados,2,2,0,10,
Extranjero,"Síntomas, signos y hallazgos anormales clínicos y de laboratorio, no clasificados en otra parte",5,3,2,10,
Extranjero,Otras causas,37,25,12,10,
Ignorado,Todas las causas,1121,830,291,10,
Ignorado,Exposición a factores no especificados,165,140,25,10,
Ignorado,"Agresión con disparo de otras armas de fuego, y las no especificadas",149,121,28,10,
Ignorado,"Neumonía, organismo no especificado",94,60,34,10,
Ignorado,Agresión con objeto cortante,34,29,5,10,
Ignorado,Diarrea y gastroenteritis de presunto origen infeccioso,30,17,13,10,
Ignorado,"Desnutrición proteicocalórica, no especificada",30,19,11,10,
Ignorado,Secuelas de otros efectos y los no especificados de causas externas,29,23,6,10,
Ignorado,"Trastornos relacionados con duración corta de la gestación y con bajo peso al nacer, no clasificados en otra parte",28,15,13,10,
Ignorado,Fibrosis y cirrosis del hígado,21,16,5,10,
Ignorado,Otras septicemias,18,12,6,10,
Ignorado,"Ahogamiento y sumersión, de intención no determinada",18,15,3,10,
Ignorado,"Disparo de otras armas de fuego, y las no especificadas, de intención no determinada",18,18,0,10,
Ignorado,Trastornos mentales y del comportamiento debidos al uso de alcohol,17,17,0,10,
Ignorado,Edema pulmonar,17,15,2,10,
Ignorado,Otros trastornos del encéfalo,14,8,6,10,
Ignorado,"Síntomas, signos y hallazgos anormales clínicos y de laboratorio, no clasificados en otra parte",64,41,23,10,
Ignorado,Otras causas,375,264,111,10,
Todos los departamentos,Todas las causas,72354,41295,31059,11,
Todos los departamentos,"Neumonía, organismo no especificado",6842,3647,3195,11,
Todos los departamentos,Infarto agudo del miocardio,4649,2494,2155,11,
Todos los departamentos,"Diabetes mellitus, no especificada",3515,1400,2115,11,
Todos los departamentos,"Agresión con disparo de otras armas de fuego, y las no especificadas",3459,3092,367,11,
Todos los departamentos,Exposición a factores no especificados,3028,2425,603,11,
Todos los departamentos,Diarrea y gastroenteritis de presunto origen infeccioso,2294,1191,1103,11,
Todos los departamentos,Fibrosis y cirrosis del hígado,1709,1158,551,11,
Todos los departamentos,Insuficiencia cardíaca,1618,799,819,11,
Todos los departamentos,"Accidente vascular encefálico agudo, no especificado como hemorrágico o isquémico",1544,750,794,11,
Todos los departamentos,"Desnutrición proteicocalórica, no especificada",1372,734,638,11,
Todos los departamentos,Tumor maligno del estómago,1366,637,729,11,
Todos los departamentos,"Disparo de otras armas de fuego, y las no especificadas",1295,1154,141,11,
Todos los departamentos,Tumor maligno del hígado y de las vías biliares intrahepáticas,1124,518,606,11,
Todos los departamentos,Diabetes mellitus no insulinodependiente,1055,428,627,11,
Todos los departamentos,Otras septicemias,1001,505,496,11,
Todos los departamentos,"Síntomas, signos y hallazgos anormales clínicos y de laboratorio, no clasificados en otra parte",5321,2755,2566,11,
Todos los departamentos,Otras causas,31162,17608,13554,11,
Guatemala,Todas las causas,17275,9720,7555,11,
Guatemala,Infarto agudo del miocardio,1288,680,608,11,
Guatemala,"Agresión con disparo de otras armas de fuego, y las no especificadas",1106,974,132,11,
Guatemala,"Diabetes mellitus, no especificada",1084,450,634,11,
Guatemala,Exposición a factores no especificados,838,667,171,11,
Guatemala,"Neumonía, organismo no especificado",664,347,317,11,
Guatemala,"Disparo de otras armas de fuego, y las no especificadas",606,527,79,11,
Guatemala,Fibrosis y cirrosis del hígado,553,395,158,11,
Guatemala,Diabetes mellitus no insulinodependiente,391,158,233,11,
Guatemala,"Desnutrición proteicocalórica, no especificada",330,168,162,11,
Guatemala,Tumor maligno del hígado y de las vías biliares intrahepáticas,329,148,181,11,
Guatemala,Insuficiencia cardíaca,315,139,176,11,
Guatemala,Tumor maligno del estómago,289,138,151,11,
Guatemala,Insuficiencia renal crónica,280,131,149,11,
Guatemala,Otras septicemias,252,123,129,11,
Guatemala,Otras enfermedades cerebrovasculares,239,106,133,11,
Guatemala,"Síntomas, signos y hallazgos anormales clínicos y de laboratorio, no clasificados en otra parte",908,413,495,11,
Guatemala,Otras causas,7803,4156,3647,11,
El Progreso,Todas las causas,919,522,397,11,
El Progreso,Infarto agudo del miocardio,132,74,58,11,
El Progreso,"Neumonía, organismo no especificado",66,34,32,11,
El Progreso,"Diabetes mellitus, no especificada",52,23,29,11,
El Progreso,Exposición a factores no especificados,49,41,8,11,
El Progreso,"Accidente vascular encefálico agudo, no especificado como hemorrágico o isquémico",44,24,20,11,
El Progreso,"Agresión con disparo de otras armas de fuego, y las no especificadas",39,38,1,11,
El Progreso,Tumor maligno del hígado y de las vías biliares intrahepáticas,31,12,19,11,
El Progreso,Tumor maligno del estómago,23,10,13,11,
El Progreso,Insuficiencia cardíaca,18,8,10,11,
El Progreso,"Envenenamiento accidental por, y exposición a otros productos químicos y sustancias nocivas, y los no especificados",16,12,4,11,
El Progreso,Diabetes mellitus no insulinodependiente,15,4,11,11,
El Progreso,Otras enfermedades pulmonares obstructivas crónicas,15,5,10,11,
El Progreso,"Disparo de otras armas de fuego, y las no especificadas",15,12,3,11,
El Progreso,Tumor maligno de la próstata,14,14,0,11,
El Progreso,Secuelas de otros efectos y los no especificados de causas externas,14,10,4,11,
El Progreso,"Síntomas, signos y hallazgos anormales clínicos y de laboratorio, no clasificados en otra parte",39,23,16,11,
El Progreso,Otras causas,337,178,159,11,
Sacatepéquez,Todas las causas,1481,816,665,11,
Sacatepéquez,"Neumonía, organismo no especificado",132,70,62,11,
Sacatepéquez,Infarto agudo del miocardio,110,52,58,11,
Sacatepéquez,"Diabetes mellitus, no especificada",95,44,51,11,
Sacatepéquez,Exposición a factores no especificados,73,58,15,11,
Sacatepéquez,"Desnutrición proteicocalórica, no especificada",49,27,22,11,
Sacatepéquez,Diabetes mellitus no insulinodependiente,44,24,20,11,
Sacatepéquez,Fibrosis y cirrosis del hígado,44,25,19,11,
Sacatepéquez,Enfermedad alcohólica del hígado,40,33,7,11,
Sacatepéquez,Otras enfermedades cerebrovasculares,32,11,21,11,
Sacatepéquez,"Accidente vascular encefálico agudo, no especificado como hemorrágico o isquémico",31,7,24,11,
Sacatepéquez,Tumor maligno del hígado y de las vías biliares intrahepáticas,29,8,21,11,
Sacatepéquez,"Agresión con disparo de otras armas de fuego, y las no especificadas",27,26,1,11,
Sacatepéquez,Trastornos mentales y del comportamiento debidos al uso de alcohol,24,24,0,11,
Sacatepéquez,Insuficiencia cardíaca,22,16,6,11,
Sacatepéquez,Tumor maligno del estómago,21,13,8,11,
Sacatepéquez,"Síntomas, signos y hallazgos anormales clínicos y de laboratorio, no clasificados en otra parte",86,41,45,11,
Sacatepéquez,Otras causas,622,337,285,11,
Chimaltenango,Todas las causas,2459,1377,1082,11,
Chimaltenango,"Neumonía, organismo no especificado",253,124,129,11,
Chimaltenango,Insuficiencia cardíaca,155,81,74,11,
Chimaltenango,Infarto agudo del miocardio,150,77,73,11,
Chimaltenango,"Diabetes mellitus, no especificada",114,39,75,11,
Chimaltenango,Exposición a factores no especificados,100,78,22,11,
Chimaltenango,Enfermedad alcohólica del hígado,74,57,17,11,
Chimaltenango,Tumor maligno del estómago,70,30,40,11,
Chimaltenango,"Accidente vascular encefálico agudo, no especificado como hemorrágico o isquémico",67,33,34,11,
Chimaltenango,"Agresión con disparo de otras armas de fuego, y las no especificadas",65,59,6,11,
Chimaltenango,"Desnutrición proteicocalórica, no especificada",61,35,26,11,
Chimaltenango,"Envenenamiento accidental por, y exposición al alcohol",56,53,3,11,
Chimaltenango,Fibrosis y cirrosis del hígado,55,33,22,11,
Chimaltenango,Trastornos mentales y del comportamiento debidos al uso de alcohol,54,51,3,11,
Chimaltenango,Otras enfermedades pulmonares obstructivas crónicas,48,27,21,11,
Chimaltenango,Tumor maligno del hígado y de las vías biliares intrahepáticas,46,16,30,11,
Chimaltenango,"Síntomas, signos y hallazgos anormales clínicos y de laboratorio, no clasificados en otra parte",116,68,48,11,
Chimaltenango,Otras causas,975,516,459,11,
Escuintla,Todas las causas,3742,2271,1471,11,
Escuintla,"Agresión con disparo de otras armas de fuego, y las no especificadas",347,316,31,11,
Escuintla,"Diabetes mellitus, no especificada",220,77,143,11,
Escuintla,Infarto agudo del miocardio,219,123,96,11,
Escuintla,"Neumonía, organismo no especificado",196,119,77,11,
Escuintla,Exposición a factores no especificados,192,151,41,11,
Escuintla,Diarrea y gastroenteritis de presunto origen infeccioso,131,77,54,11,
Escuintla,Diabetes mellitus no insulinodependiente,86,30,56,11,
Escuintla,Insuficiencia renal crónica,85,56,29,11,
Escuintla,Fibrosis y cirrosis del hígado,69,44,25,11,
Escuintla,Tumor maligno del hígado y de las vías biliares intrahepáticas,67,34,33,11,
Escuintla,"Disparo de otras armas de fuego, y las no especificadas",58,54,4,11,
Escuintla,"Desnutrición proteicocalórica, no especificada",56,31,25,11,
Escuintla,Secuelas de otros efectos y los no especificados de causas externas,54,53,1,11,
Escuintla,Tumor maligno del estómago,53,20,33,11,
Escuintla,Insuficiencia cardíaca,52,26,26,11,
Escuintla,"Síntomas, signos y hallazgos anormales clínicos y de laboratorio, no clasificados en otra parte",462,244,218,11,
Escuintla,Otras causas,1395,816,579,11,
Santa Rosa,Todas las causas,2023,1208,815,11,
Santa Rosa,"Agresión con disparo de otras armas de fuego, y las no especificadas",203,176,27,11,
Santa Rosa,Infarto agudo del miocardio,134,80,54,11,
Santa Rosa,"Neumonía, organismo no especificado",103,61,42,11,
Santa Rosa,Exposición a factores no especificados,100,79,21,11,
Santa Rosa,"Diabetes mellitus, no especificada",98,27,71,11,
Santa Rosa,Insuficiencia cardíaca,77,41,36,11,
Santa Rosa,"Accidente vascular encefálico agudo, no especificado como hemorrágico o isquémico",68,26,42,11,
Santa Rosa,Secuelas de otros efectos y los no especificados de causas externas,56,44,12,11,
Santa Rosa,Tumor maligno del estómago,47,28,19,11,
Santa Rosa,Fibrosis y cirrosis del hígado,44,25,19,11,
Santa Rosa,Insuficiencia renal crónica,44,30,14,11,
Santa Rosa,Otras enfermedades cerebrovasculares,41,21,20,11,
Santa Rosa,Tumor maligno del hígado y de las vías biliares intrahepáticas,39,19,20,11,
Santa Rosa,Diabetes mellitus no insulinodependiente,34,12,22,11,
Santa Rosa,"Desnutrición proteicocalórica, no especificada",33,13,20,11,
Santa Rosa,"Síntomas, signos y hallazgos anormales clínicos y de laboratorio, no clasificados en otra parte",96,48,48,11,
Santa Rosa,Otras causas,806,478,328,11,
Sololá,Todas las causas,1432,794,638,11,
Sololá,"Neumonía, organismo no especificado",254,123,131,11,
Sololá,Exposición a factores no especificados,66,56,10,11,
Sololá,"Diabetes mellitus, no especificada",54,20,34,11,
Sololá,Diarrea y gastroenteritis de presunto origen infeccioso,45,23,22,11,
Sololá,Infarto agudo del miocardio,39,18,21,11,
Sololá,Fibrosis y cirrosis del hígado,35,26,9,11,
Sololá,"Envenenamiento accidental por, y exposición al alcohol",34,32,2,11,
Sololá,"Accidente vascular encefálico agudo, no especificado como hemorrágico o isquémico",27,15,12,11,
Sololá,"Desnutrición proteicocalórica, no especificada",25,12,13,11,
Sololá,Otras enfermedades cerebrovasculares,23,14,9,11,
Sololá,Enfermedad alcohólica del hígado,22,17,5,11,
Sololá,Insuficiencia renal crónica,22,7,15,11,
Sololá,Tumor maligno del estómago,21,9,12,11,
Sololá,Secuelas de otros efectos y los no especificados de causas externas,21,20,1,11,
Sololá,Tumor maligno del hígado y de las vías biliares intrahepáticas,19,10,9,11,
Sololá,"Síntomas, signos y hallazgos anormales clínicos y de laboratorio, no clasificados en otra parte",181,88,93,11,
Sololá,Otras causas,544,304,240,11,
Totonicapán,Todas las causas,1995,1083,912,11,
Totonicapán,"Neumonía, organismo no especificado",331,164,167,11,
Totonicapán,Insuficiencia cardíaca,107,50,57,11,
Totonicapán,Diarrea y gastroenteritis de presunto origen infeccioso,90,48,42,11,
Totonicapán,"Diabetes mellitus, no especificada",78,50,28,11,
Totonicapán,"Envenenamiento accidental por, y exposición al alcohol",71,65,6,11,
Totonicapán,Infarto agudo del miocardio,67,40,27,11,
Totonicapán,Fibrosis y cirrosis del hígado,59,32,27,11,
Totonicapán,Otras enfermedades pulmonares obstructivas crónicas,56,28,28,11,
Totonicapán,Exposición a factores no especificados,51,44,7,11,
Totonicapán,Hipertensión esencial (primaria),37,13,24,11,
Totonicapán,Trastornos mentales y del comportamiento debidos al uso de alcohol,34,28,6,11,
Totonicapán,Enfermedad alcohólica del hígado,33,24,9,11,
Totonicapán,Secuelas de otros efectos y los no especificados de causas externas,32,23,9,11,
Totonicapán,Otros trastornos del encéfalo,30,16,14,11,
Totonicapán,Úlcera gástrica,25,10,15,11,
Totonicapán,"Síntomas, signos y hallazgos anormales clínicos y de laboratorio, no clasificados en otra parte",250,122,128,11,
Totonicapán,Otras causas,644,326,318,11,
Quetzaltenango,Todas las causas,3708,2133,1575,11,
Quetzaltenango,"Diabetes mellitus, no especificada",277,116,161,11,
Quetzaltenango,"Neumonía, organismo no especificado",264,145,119,11,
Quetzaltenango,Exposición a factores no especificados,176,134,42,11,
Quetzaltenango,Infarto agudo del miocardio,163,101,62,11,
Quetzaltenango,"Desnutrición proteicocalórica, no especificada",141,75,66,11,
Quetzaltenango,"Agresión con disparo de otras armas de fuego, y las no especificadas",136,116,20,11,
Quetzaltenango,"Accidente vascular encefálico agudo, no especificado como hemorrágico o isquémico",108,56,52,11,
Quetzaltenango,Enfermedad alcohólica del hígado,106,92,14,11,
Quetzaltenango,Fibrosis y cirrosis del hígado,88,63,25,11,
Quetzaltenango,Diabetes mellitus no insulinodependiente,86,34,52,11,
Quetzaltenango,Tumor maligno del estómago,80,33,47,11,
Quetzaltenango,"Envenenamiento accidental por, y exposición al alcohol",78,69,9,11,
Quetzaltenango,Insuficiencia cardíaca,74,34,40,11,
Quetzaltenango,Trastornos mentales y del comportamiento debidos al uso de alcohol,66,55,11,11,
Quetzaltenango,Tumor maligno del hígado y de las vías biliares intrahepáticas,53,28,25,11,
Quetzaltenango,"Síntomas, signos y hallazgos anormales clínicos y de laboratorio, no clasificados en otra parte",229,104,125,11,
Quetzaltenango,Otras causas,1583,878,705,11,
Suchitepéquez,Todas las causas,2564,1468,1096,11,
Suchitepéquez,"Neumonía, organismo no especificado",213,123,90,11,
Suchitepéquez,"Diabetes mellitus, no especificada",141,55,86,11,
Suchitepéquez,Exposición a factores no especificados,117,95,22,11,
Suchitepéquez,Infarto agudo del miocardio,80,46,34,11,
Suchitepéquez,"Disparo de otras armas de fuego, y las no especificadas",80,69,11,11,
Suchitepéquez,Insuficiencia renal no especificada,59,38,21,11,
Suchitepéquez,Fibrosis y cirrosis del hígado,54,32,22,11,
Suchitepéquez,"Agresión con disparo de otras armas de fuego, y las no especificadas",54,52,2,11,
Suchitepéquez,Tumor maligno de sitios no especificados,51,20,31,11,
Suchitepéquez,Diarrea y gastroenteritis de presunto origen infeccioso,49,27,22,11,
Suchitepéquez,Tumor maligno del estómago,49,21,28,11,
Suchitepéquez,Insuficiencia renal crónica,45,24,21,11,
Suchitepéquez,Tumor maligno del hígado y de las vías biliares intrahepáticas,41,14,27,11,
Suchitepéquez,Insuficiencia cardíaca,34,16,18,11,
Suchitepéquez,"Accidente vascular encefálico agudo, no especificado como hemorrágico o isquémico",32,16,16,11,
Suchitepéquez,"Síntomas, signos y hallazgos anormales clínicos y de laboratorio, no clasificados en otra parte",580,315,265,11,
Suchitepéquez,Otras causas,885,505,380,11,
Retalhuleu,Todas las causas,1483,891,592,11,
Retalhuleu,"Diabetes mellitus, no especificada",132,59,73,11,
Retalhuleu,Infarto agudo del miocardio,86,53,33,11,
Retalhuleu,Insuficiencia cardíaca,70,35,35,11,
Retalhuleu,"Neumonía, organismo no especificado",70,45,25,11,
Retalhuleu,Exposición a factores no especificados,66,54,12,11,
Retalhuleu,Fibrosis y cirrosis del hígado,62,37,25,11,
Retalhuleu,Insuficiencia renal crónica,54,38,16,11,
Retalhuleu,"Agresión con disparo de otras armas de fuego, y las no especificadas",49,42,7,11,
Retalhuleu,"Accidente vascular encefálico agudo, no especificado como hemorrágico o isquémico",41,23,18,11,
Retalhuleu,Insuficiencia renal no especificada,38,26,12,11,
Retalhuleu,Tumor maligno del estómago,32,12,20,11,
Retalhuleu,Tumor maligno del hígado y de las vías biliares intrahepáticas,30,16,14,11,
Retalhuleu,Secuelas de otros efectos y los no especificados de causas externas,26,19,7,11,
Retalhuleu,Diarrea y gastroenteritis de presunto origen infeccioso,25,12,13,11,
Retalhuleu,Tumor maligno de la próstata,25,25,0,11,
Retalhuleu,"Síntomas, signos y hallazgos anormales clínicos y de laboratorio, no clasificados en otra parte",46,25,21,11,
Retalhuleu,Otras causas,631,370,261,11,
San Marcos,Todas las causas,4213,2495,1718,11,
San Marcos,"Neumonía, organismo no especificado",564,330,234,11,
San Marcos,Infarto agudo del miocardio,313,179,134,11,
San Marcos,"Diabetes mellitus, no especificada",179,64,115,11,
San Marcos,Fibrosis y cirrosis del hígado,175,120,55,11,
San Marcos,Exposición a factores no especificados,168,132,36,11,
San Marcos,Diarrea y gastroenteritis de presunto origen infeccioso,155,86,69,11,
San Marcos,Insuficiencia cardíaca,127,68,59,11,
San Marcos,"Agresión con disparo de otras armas de fuego, y las no especificadas",115,104,11,11,
San Marcos,"Accidente vascular encefálico agudo, no especificado como hemorrágico o isquémico",107,63,44,11,
San Marcos,"Desnutrición proteicocalórica, no especificada",99,59,40,11,
San Marcos,Tumor maligno del hígado y de las vías biliares intrahepáticas,93,48,45,11,
San Marcos,Tumor maligno del estómago,83,46,37,11,
San Marcos,"Envenenamiento accidental por, y exposición al alcohol",81,77,4,11,
San Marcos,Úlcera gástrica,69,33,36,11,
San Marcos,Secuelas de otros efectos y los no especificados de causas externas,61,49,12,11,
San Marcos,"Síntomas, signos y hallazgos anormales clínicos y de laboratorio, no clasificados en otra parte",351,186,165,11,
San Marcos,Otras causas,1473,851,622,11,
Huehuetenango,Todas las causas,3865,2181,1684,11,
Huehuetenango,"Neumonía, organismo no especificado",602,319,283,11,
Huehuetenango,Diarrea y gastroenteritis de presunto origen infeccioso,213,118,95,11,
Huehuetenango,Infarto agudo del miocardio,190,101,89,11,
Huehuetenango,"Diabetes mellitus, no especificada",140,50,90,11,
Huehuetenango,Exposición a factores no especificados,130,108,22,11,
Huehuetenango,"Accidente vascular encefálico agudo, no especificado como hemorrágico o isquémico",115,61,54,11,
Huehuetenango,Tumor maligno del estómago,101,52,49,11,
Huehuetenango,"Agresión con disparo de otras armas de fuego, y las no especificadas",87,77,10,11,
Huehuetenango,Fibrosis y cirrosis del hígado,79,62,17,11,
Huehuetenango,Secuelas de otros efectos y los no especificados de causas externas,79,59,20,11,
Huehuetenango,"Envenenamiento accidental por, y exposición al alcohol",73,69,4,11,
Huehuetenango,Tumor maligno del hígado y de las vías biliares intrahepáticas,72,38,34,11,
Huehuetenango,Insuficiencia cardíaca,69,31,38,11,
Huehuetenango,Insuficiencia renal no especificada,66,28,38,11,
Huehuetenango,Úlcera gástrica,56,21,35,11,
Huehuetenango,"Síntomas, signos y hallazgos anormales clínicos y de laboratorio, no clasificados en otra parte",274,164,110,11,
Huehuetenango,Otras causas,1519,823,696,11,
Quiché,Todas las causas,3394,1839,1555,11,
Quiché,"Neumonía, organismo no especificado",511,262,249,11,
Quiché,Diarrea y gastroenteritis de presunto origen infeccioso,269,132,137,11,
Quiché,Infarto agudo del miocardio,135,64,71,11,
Quiché,Insuficiencia cardíaca,110,47,63,11,
Quiché,Exposición a factores no especificados,103,87,16,11,
Quiché,"Diabetes mellitus, no especificada",99,41,58,11,
Quiché,Otras septicemias,71,41,30,11,
Quiché,"Envenenamiento accidental por, y exposición al alcohol",66,61,5,11,
Quiché,Fibrosis y cirrosis del hígado,61,39,22,11,
Quiché,"Accidente vascular encefálico agudo, no especificado como hemorrágico o isquémico",57,21,36,11,
Quiché,"Desnutrición proteicocalórica, no especificada",55,32,23,11,
Quiché,"Agresión con disparo de otras armas de fuego, y las no especificadas",52,48,4,11,
Quiché,Tumor maligno del estómago,50,22,28,11,
Quiché,Enfermedad alcohólica del hígado,49,41,8,11,
Quiché,Secuelas de otros efectos y los no especificados de causas externas,47,35,12,11,
Quiché,"Síntomas, signos y hallazgos anormales clínicos y de laboratorio, no clasificados en otra parte",323,159,164,11,
Quiché,Otras causas,1336,707,629,11,
Baja Verapaz,Todas las causas,1197,654,543,11,
Baja Verapaz,"Neumonía, organismo no especificado",171,98,73,11,
Baja Verapaz,Infarto agudo del miocardio,111,46,65,11,
Baja Verapaz,"Accidente vascular encefálico agudo, no especificado como hemorrágico o isquémico",64,34,30,11,
Baja Verapaz,"Diabetes mellitus, no especificada",53,15,38,11,
Baja Verapaz,Tumor maligno del estómago,50,19,31,11,
Baja Verapaz,Exposición a factores no especificados,41,30,11,11,
Baja Verapaz,"Agresión con disparo de otras armas de fuego, y las no especificadas",38,32,6,11,
Baja Verapaz,Diarrea y gastroenteritis de presunto origen infeccioso,34,19,15,11,
Baja Verapaz,"Desnutrición proteicocalórica, no especificada",26,17,9,11,
Baja Verapaz,Secuelas de otros efectos y los no especificados de causas externas,23,17,6,11,
Baja Verapaz,Fibrosis y cirrosis del hígado,22,16,6,11,
Baja Verapaz,Hipertensión esencial (primaria),21,9,12,11,
Baja Verapaz,Otras enfermedades cerebrovasculares,19,11,8,11,
Baja Verapaz,Otras enfermedades pulmonares obstructivas crónicas,19,15,4,11,
Baja Verapaz,Tumor maligno del hígado y de las vías biliares intrahepáticas,18,5,13,11,
Baja Verapaz,"Síntomas, signos y hallazgos anormales clínicos y de laboratorio, no clasificados en otra parte",28,18,10,11,
Baja Verapaz,Otras causas,459,253,206,11,
Alta Verapaz,Todas las causas,3736,1966,1770,11,
Alta Verapaz,"Neumonía, organismo no especificado",560,272,288,11,
Alta Verapaz,Diarrea y gastroenteritis de presunto origen infeccioso,233,118,115,11,
Alta Verapaz,"Desnutrición proteicocalórica, no especificada",226,118,108,11,
Alta Verapaz,Infarto agudo del miocardio,213,113,100,11,
Alta Verapaz,Exposición a factores no especificados,126,104,22,11,
Alta Verapaz,"Diabetes mellitus, no especificada",120,39,81,11,
Alta Verapaz,Tumor maligno del estómago,102,47,55,11,
Alta Verapaz,Fibrosis y cirrosis del hígado,94,57,37,11,
Alta Verapaz,Otras anemias nutricionales,79,29,50,11,
Alta Verapaz,"Accidente vascular encefálico agudo, no especificado como hemorrágico o isquémico",77,35,42,11,
Alta Verapaz,Otras septicemias,66,38,28,11,
Alta Verapaz,Tumor maligno del hígado y de las vías biliares intrahepáticas,62,34,28,11,
Alta Verapaz,"Agresión con disparo de otras armas de fuego, y las no especificadas",61,54,7,11,
Alta Verapaz,Úlcera gástrica,54,22,32,11,
Alta Verapaz,Otras anemias,53,24,29,11,
Alta Verapaz,"Síntomas, signos y hallazgos anormales clínicos y de laboratorio, no clasificados en otra parte",127,53,74,11,
Alta Verapaz,Otras causas,1483,809,674,11,
Petén,Todas las causas,1669,1028,641,11,
Petén,"Agresión con disparo de otras armas de fuego, y las no especificadas",132,127,5,11,
Petén,"Diabetes mellitus, no especificada",94,35,59,11,
Petén,"Neumonía, organismo no especificado",83,50,33,11,
Petén,Infarto agudo del miocardio,80,48,32,11,
Petén,Exposición a factores no especificados,80,64,16,11,
Petén,Secuelas de otros efectos y los no especificados de causas externas,49,42,7,11,
Petén,Agresión por medios no especificados,42,38,4,11,
Petén,Agresión con objeto cortante,36,31,5,11,
Petén,Tumor maligno de sitios no especificados,35,13,22,11,
Petén,"Disparo de otras armas de fuego, y las no especificadas",27,25,2,11,
Petén,Diarrea y gastroenteritis de presunto origen infeccioso,26,12,14,11,
Petén,Diabetes mellitus no insulinodependiente,26,9,17,11,
Petén,Tumor maligno del estómago,25,13,12,11,
Petén,Tumor maligno del hígado y de las vías biliares intrahepáticas,25,16,9,11,
Petén,Otros trastornos del encéfalo,24,12,12,11,
Petén,"Síntomas, signos y hallazgos anormales clínicos y de laboratorio, no clasificados en otra parte",184,98,86,11,
Petén,Otras causas,701,395,306,11,
Izabal,Todas las causas,1783,1039,744,11,
Izabal,Infarto agudo del miocardio,153,91,62,11,
Izabal,"Diabetes mellitus, no especificada",123,50,73,11,
Izabal,"Agresión con disparo de otras armas de fuego, y las no especificadas",116,106,10,11,
Izabal,"Neumonía, organismo no especificado",67,37,30,11,
Izabal,"Disparo de otras armas de fuego, y las no especificadas",67,60,7,11,
Izabal,Exposición a factores no especificados,67,55,12,11,
Izabal,Secuelas de otros efectos y los no especificados de causas externas,52,43,9,11,
Izabal,Diarrea y gastroenteritis de presunto origen infeccioso,42,22,20,11,
Izabal,Otras septicemias,42,24,18,11,
Izabal,"Accidente vascular encefálico agudo, no especificado como hemorrágico o isquémico",39,21,18,11,
Izabal,Tumor maligno del estómago,37,11,26,11,
Izabal,Fibrosis y cirrosis del hígado,34,19,15,11,
Izabal,Insuficiencia renal no especificada,28,13,15,11,
Izabal,Insuficiencia cardíaca,24,19,5,11,
Izabal,Tumor maligno de la próstata,22,22,0,11,
Izabal,"Síntomas, signos y hallazgos anormales clínicos y de laboratorio, no clasificados en otra parte",246,115,131,11,
Izabal,Otras causas,624,331,293,11,
Zacapa,Todas las causas,1366,801,565,11,
Zacapa,Infarto agudo del miocardio,197,90,107,11,
Zacapa,"Agresión con disparo de otras armas de fuego, y las no especificadas",144,125,19,11,
Zacapa,"Diabetes mellitus, no especificada",91,35,56,11,
Zacapa,Exposición a factores no especificados,65,48,17,11,
Zacapa,"Accidente vascular encefálico agudo, no especificado como hemorrágico o isquémico",48,27,21,11,
Zacapa,"Neumonía, organismo no especificado",43,19,24,11,
Zacapa,Insuficiencia cardíaca,35,25,10,11,
Zacapa,Tumor maligno del estómago,32,19,13,11,
Zacapa,Tumor maligno del hígado y de las vías biliares intrahepáticas,27,13,14,11,
Zacapa,"Disparo de otras armas de fuego, y las no especificadas",26,25,1,11,
Zacapa,Diabetes mellitus no insulinodependiente,24,10,14,11,
Zacapa,Otras enfermedades cerebrovasculares,21,9,12,11,
Zacapa,Secuelas de otros efectos y los no especificados de causas externas,21,15,6,11,
Zacapa,"Desnutrición proteicocalórica, no especificada",19,11,8,11,
Zacapa,Otras enfermedades pulmonares obstructivas crónicas,16,12,4,11,
Zacapa,"Síntomas, signos y hallazgos anormales clínicos y de laboratorio, no clasificados en otra parte",38,24,14,11,
Zacapa,Otras causas,519,294,225,11,
Chiquimula,Todas las causas,1929,1094,835,11,
Chiquimula,Infarto agudo del miocardio,225,120,105,11,
Chiquimula,"Neumonía, organismo no especificado",210,107,103,11,
Chiquimula,"Agresión con disparo de otras armas de fuego, y las no especificadas",150,140,10,11,
Chiquimula,"Diabetes mellitus, no especificada",88,36,52,11,
Chiquimula,Insuficiencia cardíaca,86,39,47,11,
Chiquimula,"Accidente vascular encefálico agudo, no especificado como hemorrágico o isquémico",71,35,36,11,
Chiquimula,Exposición a factores no especificados,57,36,21,11,
Chiquimula,Tumor maligno del estómago,46,21,25,11,
Chiquimula,Agresión con objeto cortante,35,29,6,11,
Chiquimula,Diarrea y gastroenteritis de presunto origen infeccioso,34,17,17,11,
Chiquimula,Úlcera gástrica,33,16,17,11,
Chiquimula,Secuelas de otros efectos y los no especificados de causas externas,33,27,6,11,
Chiquimula,"Disparo de otras armas de fuego, y las no especificadas",27,25,2,11,
Chiquimula,Fibrosis y cirrosis del hígado,25,20,5,11,
Chiquimula,Otras septicemias,24,15,9,11,
Chiquimula,"Síntomas, signos y hallazgos anormales clínicos y de laboratorio, no clasificados en otra parte",85,45,40,11,
Chiquimula,Otras causas,700,366,334,11,
Jalapa,Todas las causas,1571,884,687,11,
Jalapa,Infarto agudo del miocardio,201,95,106,11,
Jalapa,"Neumonía, organismo no especificado",164,89,75,11,
Jalapa,"Agresión con disparo de otras armas de fuego, y las no especificadas",89,80,9,11,
Jalapa,"Accidente vascular encefálico agudo, no especificado como hemorrágico o isquémico",82,37,45,11,
Jalapa,Diarrea y gastroenteritis de presunto origen infeccioso,63,33,30,11,
Jalapa,Exposición a factores no especificados,56,45,11,11,
Jalapa,"Diabetes mellitus, no especificada",51,19,32,11,
Jalapa,Otras enfermedades pulmonares obstructivas crónicas,43,17,26,11,
Jalapa,Tumor maligno del estómago,41,24,17,11,
Jalapa,"Disparo de otras armas de fuego, y las no especificadas",29,28,1,11,
Jalapa,Otras enfermedades cerebrovasculares,28,11,17,11,
Jalapa,Tumor maligno del hígado y de las vías biliares intrahepáticas,27,7,20,11,
Jalapa,Fibrosis y cirrosis del hígado,27,22,5,11,
Jalapa,Insuficiencia cardíaca,22,10,12,11,
Jalapa,Otras septicemias,21,12,9,11,
Jalapa,"Síntomas, signos y hallazgos anormales clínicos y de laboratorio, no clasificados en otra parte",97,42,55,11,
Jalapa,Otras causas,530,313,217,11,
Jutiapa,Todas las causas,2481,1485,996,11,
Jutiapa,Infarto agudo del miocardio,336,185,151,11,
Jutiapa,"Agresión con disparo de otras armas de fuego, y las no especificadas",242,223,19,11,
Jutiapa,"Accidente vascular encefálico agudo, no especificado como hemorrágico o isquémico",162,91,71,11,
Jutiapa,"Diabetes mellitus, no especificada",117,50,67,11,
Jutiapa,Insuficiencia cardíaca,103,58,45,11,
Jutiapa,"Neumonía, organismo no especificado",103,64,39,11,
Jutiapa,Tumor maligno del estómago,82,41,41,11,
Jutiapa,Exposición a factores no especificados,76,64,12,11,
Jutiapa,Secuelas de otros efectos y los no especificados de causas externas,64,55,9,11,
Jutiapa,Otras enfermedades cerebrovasculares,57,22,35,11,
Jutiapa,Insuficiencia renal crónica,55,31,24,11,
Jutiapa,Fibrosis y cirrosis del hígado,48,35,13,11,
Jutiapa,"Disparo de otras armas de fuego, y las no especificadas",38,35,3,11,
Jutiapa,Tumor maligno del hígado y de las vías biliares intrahepáticas,37,10,27,11,
Jutiapa,Tumor maligno de la próstata,37,37,0,11,
Jutiapa,"Síntomas, signos y hallazgos anormales clínicos y de laboratorio, no clasificados en otra parte",52,26,26,11,
Jutiapa,Otras causas,872,458,414,11,
Extranjero,Todas las causas,144,91,53,11,
Extranjero,"Agresión con disparo de otras armas de fuego, y las no especificadas",31,25,6,11,
Extranjero,"Disparo de otras armas de fuego, y las no especificadas",12,10,2,11,
Extranjero,Exposición a factores no especificados,12,10,2,11,
Extranjero,Secuelas de otros efectos y los no especificados de causas externas,10,6,4,11,
Extranjero,Infarto agudo del miocardio,6,6,0,11,
Extranjero,Ahogamiento y sumersión no especificados,6,4,2,11,
Extranjero,"Enfermedad por virus de la inmunodeficiencia humana [VIH], sin otra especificación",4,2,2,11,
Extranjero,Diabetes mellitus no insulinodependiente,4,1,3,11,
Extranjero,Agresión con objeto cortante,4,2,2,11,
Extranjero,Otras septicemias,3,0,3,11,
Extranjero,Tumor maligno de los bronquios y del pulmón,3,1,2,11,
Extranjero,"Diabetes mellitus, no especificada",3,1,2,11,
Extranjero,"Neumonía, organismo no especificado",3,2,1,11,
Extranjero,"Enfermedad por virus de la inmunodeficiencia humana [VIH], resultante en enfermedades infecciosas y parasitarias",2,1,1,11,
Extranjero,Otras enfermedades del sistema digestivo,2,1,1,11,
Extranjero,"Síntomas, signos y hallazgos anormales clínicos y de laboratorio, no clasificados en otra parte",3,3,0,11,
Extranjero,Otras causas,36,16,20,11,
Ignorado,Todas las causas,5925,3455,2470,11,
Ignorado,"Neumonía, organismo no especificado",1215,643,572,11,
Ignorado,Diarrea y gastroenteritis de presunto origen infeccioso,533,278,255,11,
Ignorado,Exposición a factores no especificados,219,185,34,11,
Ignorado,Sepsis bacteriana del recién nacido,202,117,85,11,
Ignorado,Dificultad respiratoria del recién nacido,181,110,71,11,
Ignorado,Otras septicemias,154,67,87,11,
Ignorado,"Agresión con disparo de otras armas de fuego, y las no especificadas",146,124,22,11,
Ignorado,Neumonía congénita,140,67,73,11,
Ignorado,Síndromes de aspiración neonatal,127,67,60,11,
Ignorado,Asfixia del nacimiento,111,63,48,11,
Ignorado,Otras malformaciones congénitas del corazón,104,61,43,11,
Ignorado,"Otras malformaciones congénitas, no clasificadas en otra parte",102,49,53,11,
Ignorado,"Desnutrición proteicocalórica, no especificada",100,59,41,11,
Ignorado,"Trastornos relacionados con duración corta de la gestación y con bajo peso al nacer, no clasificados en otra parte",100,57,43,11,
Ignorado,"Disparo de otras armas de fuego, y las no especificadas",80,72,8,11,
Ignorado,"Síntomas, signos y hallazgos anormales clínicos y de laboratorio, no clasificados en otra parte",520,331,189,11,
Ignorado,Otras causas,1891,1105,786,11,
Todos los departamentos,Todas las causas,72657,41099,31558,12,
Todos los departamentos,"Neumonía, organismo no especificado",6684,3548,3136,12,
Todos los departamentos,Infarto agudo del miocardio,4943,2681,2262,12,
Todos los departamentos,"Diabetes mellitus, no especificada",3657,1510,2147,12,
Todos los departamentos,"Agresión con disparo de otras armas de fuego, y las no especificadas",3176,2869,307,12,
Todos los departamentos,Exposición a factores no especificados,2999,2380,619,12,
Todos los departamentos,Diarrea y gastroenteritis de presunto origen infeccioso,2192,1154,1038,12,
Todos los departamentos,Fibrosis y cirrosis del hígado,1903,1258,645,12,
Todos los departamentos,"Accidente vascular encefálico agudo, no especificado como hemorrágico o isquémico",1705,769,936,12,
Todos los departamentos,Insuficiencia cardíaca,1664,798,866,12,
Todos los departamentos,"Desnutrición proteicocalórica, no especificada",1462,686,776,12,
Todos los departamentos,Tumor maligno del estómago,1400,638,762,12,
Todos los departamentos,"Disparo de otras armas de fuego, y las no especificadas",1326,1169,157,12,
Todos los departamentos,Diabetes mellitus no insulinodependiente,1249,505,744,12,
Todos los departamentos,Tumor maligno del hígado y de las vías biliares intrahepáticas,1236,570,666,12,
Todos los departamentos,Insuficiencia renal crónica,1198,630,568,12,
Todos los departamentos,"Síntomas, signos y hallazgos anormales clínicos y de laboratorio, no clasificados en otra parte",5217,2690,2527,12,
Todos los departamentos,Otras causas,30646,17244,13402,12,
Guatemala,Todas las causas,17302,9657,7645,12,
Guatemala,Infarto agudo del miocardio,1248,648,600,12,
Guatemala,"Diabetes mellitus, no especificada",1131,496,635,12,
Guatemala,"Agresión con disparo de otras armas de fuego, y las no especificadas",1056,932,124,12,
Guatemala,Exposición a factores no especificados,867,670,197,12,
Guatemala,"Neumonía, organismo no especificado",733,381,352,12,
Guatemala,Fibrosis y cirrosis del hígado,613,446,167,12,
Guatemala,Diabetes mellitus no insulinodependiente,483,202,281,12,
Guatemala,"Disparo de otras armas de fuego, y las no especificadas",459,396,63,12,
Guatemala,"Desnutrición proteicocalórica, no especificada",383,177,206,12,
Guatemala,Insuficiencia renal crónica,370,180,190,12,
Guatemala,Tumor maligno del hígado y de las vías biliares intrahepáticas,335,155,180,12,
Guatemala,Tumor maligno del estómago,272,105,167,12,
Guatemala,Insuficiencia cardíaca,246,111,135,12,
Guatemala,"Accidente vascular encefálico agudo, no especificado como hemorrágico o isquémico",239,92,147,12,
Guatemala,Otras enfermedades cerebrovasculares,232,109,123,12,
Guatemala,"Síntomas, signos y hallazgos anormales clínicos y de laboratorio, no clasificados en otra parte",1072,516,556,12,
Guatemala,Otras causas,7563,4041,3522,12,
El Progreso,Todas las causas,964,529,435,12,
El Progreso,Infarto agudo del miocardio,142,78,64,12,
El Progreso,"Diabetes mellitus, no especificada",71,23,48,12,
El Progreso,"Neumonía, organismo no especificado",61,34,27,12,
El Progreso,"Agresión con disparo de otras armas de fuego, y las no especificadas",45,41,4,12,
El Progreso,"Accidente vascular encefálico agudo, no especificado como hemorrágico o isquémico",43,20,23,12,
El Progreso,Exposición a factores no especificados,40,32,8,12,
El Progreso,Tumor maligno del hígado y de las vías biliares intrahepáticas,33,13,20,12,
El Progreso,Tumor maligno del estómago,32,17,15,12,
El Progreso,Secuelas de otros efectos y los no especificados de causas externas,24,23,1,12,
El Progreso,Diabetes mellitus no insulinodependiente,21,5,16,12,
El Progreso,Insuficiencia cardíaca,18,7,11,12,
El Progreso,Fibrosis y cirrosis del hígado,18,9,9,12,
El Progreso,"Envenenamiento accidental por, y exposición a otros productos químicos y sustancias nocivas, y los no especificados",18,15,3,12,
El Progreso,Insuficiencia renal crónica,13,8,5,12,
El Progreso,Otras enfermedades cerebrovasculares,11,7,4,12,
El Progreso,"Síntomas, signos y hallazgos anormales clínicos y de laboratorio, no clasificados en otra parte",33,18,15,12,
El Progreso,Otras causas,341,179,162,12,
Sacatepequez,Todas las causas,1605,862,743,12,
Sacatepequez,"Neumonía, organismo no especificado",70,44,26,12,
Sacatepequez,Infarto agudo del miocardio,141,78,63,12,
Sacatepequez,"Diabetes mellitus, no especificada",118,61,57,12,
Sacatepequez,Exposición a factores no especificados,98,40,58,12,
Sacatepequez,Fibrosis y cirrosis del hígado,80,60,20,12,
Sacatepequez,"Desnutrición proteicocalórica, no especificada",49,30,19,12,
Sacatepequez,Enfermedad alcohólica del hígado,46,21,25,12,
Sacatepequez,Tumor maligno del estómago,44,36,8,12,
Sacatepequez,Diabetes mellitus no insulinodependiente,37,19,18,12,
Sacatepequez,Otras enfermedades cerebrovasculares,36,17,19,12,
Sacatepequez,Tumor maligno del hígado y de las vías biliares intrahepáticas,36,16,20,12,
Sacatepequez,"Accidente vascular encefálico agudo, no especificado como hemorrágico o isquémico",34,8,26,12,
Sacatepequez,"Agresión con disparo de otras armas de fuego, y las no especificadas",31,14,17,12,
Sacatepequez,Diarrea y gastroenteritis de presunto origen infeccioso,31,27,4,12,
Sacatepequez,Insuficiencia renal crónica,29,13,16,12,
Sacatepequez,"Síntomas, signos y hallazgos anormales clínicos y de laboratorio, no clasificados en otra parte",29,12,17,12,
Sacatepequez,Otras causas,696,366,330,12,
Chimaltenango,Todas las causas,2758,1546,1212,12,
Chimaltenango,"Neumonía, organismo no especificado",289,148,141,12,
Chimaltenango,Infarto agudo del miocardio,166,98,68,12,
Chimaltenango,Insuficiencia cardíaca,141,60,81,12,
Chimaltenango,"Diabetes mellitus, no especificada",123,51,72,12,
Chimaltenango,Enfermedad alcohólica del hígado,104,87,17,12,
Chimaltenango,Exposición a factores no especificados,103,80,23,12,
Chimaltenango,"Accidente vascular encefálico agudo, no especificado como hemorrágico o isquémico",86,40,46,12,
Chimaltenango,Tumor maligno del estómago,73,36,37,12,
Chimaltenango,Fibrosis y cirrosis del hígado,68,48,20,12,
Chimaltenango,"Desnutrición proteicocalórica, no especificada",64,28,36,12,
Chimaltenango,"Envenenamiento accidental por, y exposición al alcohol",62,57,5,12,
Chimaltenango,Tumor maligno del hígado y de las vías biliares intrahepáticas,53,25,28,12,
Chimaltenango,Sepsis bacteriana del recién nacido,50,23,27,12,
Chimaltenango,Otras enfermedades pulmonares obstructivas crónicas,49,24,25,12,
Chimaltenango,Insuficiencia renal crónica,48,26,22,12,
Chimaltenango,"Síntomas, signos y hallazgos anormales clínicos y de laboratorio, no clasificados en otra parte",99,59,40,12,
Chimaltenango,Otras causas,1180,656,524,12,
Escuintla,Todas las causas,4296,2581,1715,12,
Escuintla,"Agresión con disparo de otras armas de fuego, y las no especificadas",394,358,36,12,
Escuintla,Infarto agudo del miocardio,297,153,144,12,
Escuintla,"Neumonía, organismo no especificado",242,146,96,12,
Escuintla,Exposición a factores no especificados,220,194,26,12,
Escuintla,"Diabetes mellitus, no especificada",218,82,136,12,
Escuintla,Diabetes mellitus no insulinodependiente,114,31,83,12,
Escuintla,Insuficiencia renal crónica,109,60,49,12,
Escuintla,Fibrosis y cirrosis del hígado,98,68,30,12,
Escuintla,"Disparo de otras armas de fuego, y las no especificadas",87,76,11,12,
Escuintla,"Accidente vascular encefálico agudo, no especificado como hemorrágico o isquémico",77,37,40,12,
Escuintla,Tumor maligno del hígado y de las vías biliares intrahepáticas,75,31,44,12,
Escuintla,Diarrea y gastroenteritis de presunto origen infeccioso,68,35,33,12,
Escuintla,Secuelas de otros efectos y los no especificados de causas externas,65,55,10,12,
Escuintla,"Desnutrición proteicocalórica, no especificada",62,29,33,12,
Escuintla,Otras enfermedades cerebrovasculares,62,30,32,12,
Escuintla,"Síntomas, signos y hallazgos anormales clínicos y de laboratorio, no clasificados en otra parte",421,220,201,12,
Escuintla,Otras causas,1687,976,711,12,
Santa Rosa,Todas las causas,2196,1350,846,12,
Santa Rosa,"Agresión con disparo de otras armas de fuego, y las no especificadas",181,167,14,12,
Santa Rosa,Infarto agudo del miocardio,169,102,67,12,
Santa Rosa,"Neumonía, organismo no especificado",117,63,54,12,
Santa Rosa,"Diabetes mellitus, no especificada",97,38,59,12,
Santa Rosa,Exposición a factores no especificados,93,78,15,12,
Santa Rosa,Insuficiencia cardíaca,72,43,29,12,
Santa Rosa,Secuelas de otros efectos y los no especificados de causas externas,71,57,14,12,
Santa Rosa,"Accidente vascular encefálico agudo, no especificado como hemorrágico o isquémico",56,25,31,12,
Santa Rosa,Insuficiencia renal crónica,38,25,13,12,
Santa Rosa,Tumor maligno del estómago,37,19,18,12,
Santa Rosa,"Desnutrición proteicocalórica, no especificada",36,18,18,12,
Santa Rosa,Diabetes mellitus no insulinodependiente,33,12,21,12,
Santa Rosa,Fibrosis y cirrosis del hígado,31,22,9,12,
Santa Rosa,Diarrea y gastroenteritis de presunto origen infeccioso,28,15,13,12,
Santa Rosa,Otras septicemias,27,11,16,12,
Santa Rosa,"Síntomas, signos y hallazgos anormales clínicos y de laboratorio, no clasificados en otra parte",149,85,64,12,
Santa Rosa,Otras causas,961,570,391,12,
Solola,Todas las causas,1675,917,758,12,
Solola,"Neumonía, organismo no especificado",319,168,151,12,
Solola,"Diabetes mellitus, no especificada",64,31,33,12,
Solola,Exposición a factores no especificados,60,44,16,12,
Solola,Infarto agudo del miocardio,58,32,26,12,
Solola,Fibrosis y cirrosis del hígado,55,33,22,12,
Solola,Diarrea y gastroenteritis de presunto origen infeccioso,54,25,29,12,
Solola,"Desnutrición proteicocalórica, no especificada",44,24,20,12,
Solola,"Envenenamiento accidental por, y exposición al alcohol",40,38,2,12,
Solola,Insuficiencia cardíaca,29,8,21,12,
Solola,"Accidente vascular encefálico agudo, no especificado como hemorrágico o isquémico",26,4,22,12,
Solola,Otras septicemias,25,15,10,12,
Solola,Otras enfermedades cerebrovasculares,25,10,15,12,
Solola,Tumor maligno del estómago,24,10,14,12,
Solola,Diabetes mellitus no insulinodependiente,22,10,12,12,
Solola,Insuficiencia renal no especificada,22,9,13,12,
Solola,"Síntomas, signos y hallazgos anormales clínicos y de laboratorio, no clasificados en otra parte",171,99,72,12,
Solola,Otras causas,637,357,280,12,
Totonicapan,Todas las causas,2359,1293,1066,12,
Totonicapan,"Neumonía, organismo no especificado",472,252,220,12,
Totonicapan,Diarrea y gastroenteritis de presunto origen infeccioso,116,63,53,12,
Totonicapan,Insuficiencia cardíaca,112,57,55,12,
Totonicapan,"Diabetes mellitus, no especificada",99,44,55,12,
Totonicapan,Infarto agudo del miocardio,89,48,41,12,
Totonicapan,"Envenenamiento accidental por, y exposición al alcohol",76,71,5,12,
Totonicapan,Fibrosis y cirrosis del hígado,75,50,25,12,
Totonicapan,Exposición a factores no especificados,64,52,12,12,
Totonicapan,Otras enfermedades pulmonares obstructivas crónicas,56,24,32,12,
Totonicapan,Enfermedad alcohólica del hígado,41,32,9,12,
Totonicapan,Otras enfermedades cerebrovasculares,35,13,22,12,
Totonicapan,Hipertensión esencial (primaria),30,14,16,12,
Totonicapan,Secuelas de otros efectos y los no especificados de causas externas,29,27,2,12,
Totonicapan,Úlcera gástrica,26,13,13,12,
Totonicapan,Sepsis bacteriana del recién nacido,26,12,14,12,
Totonicapan,"Síntomas, signos y hallazgos anormales clínicos y de laboratorio, no clasificados en otra parte",320,142,178,12,
Totonicapan,Otras causas,693,379,314,12,
Quetzaltenango,Todas las causas,4076,2274,1802,12,
Quetzaltenango,"Diabetes mellitus, no especificada",279,126,153,12,
Quetzaltenango,"Neumonía, organismo no especificado",272,141,131,12,
Quetzaltenango,Infarto agudo del miocardio,248,130,118,12,
Quetzaltenango,Exposición a factores no especificados,201,149,52,12,
Quetzaltenango,"Desnutrición proteicocalórica, no especificada",151,68,83,12,
Quetzaltenango,Diabetes mellitus no insulinodependiente,110,44,66,12,
Quetzaltenango,Enfermedad alcohólica del hígado,110,85,25,12,
Quetzaltenango,"Accidente vascular encefálico agudo, no especificado como hemorrágico o isquémico",108,46,62,12,
Quetzaltenango,Fibrosis y cirrosis del hígado,107,64,43,12,
Quetzaltenango,Insuficiencia cardíaca,97,40,57,12,
Quetzaltenango,"Agresión con disparo de otras armas de fuego, y las no especificadas",96,90,6,12,
Quetzaltenango,"Envenenamiento accidental por, y exposición al alcohol",85,76,9,12,
Quetzaltenango,Diarrea y gastroenteritis de presunto origen infeccioso,83,44,39,12,
Quetzaltenango,Tumor maligno del estómago,79,41,38,12,
Quetzaltenango,Tumor maligno del hígado y de las vías biliares intrahepáticas,73,34,39,12,
Quetzaltenango,"Síntomas, signos y hallazgos anormales clínicos y de laboratorio, no clasificados en otra parte",148,82,66,12,
Quetzaltenango,Otras causas,1829,1014,815,12,
Suchitepequez,Todas las causas,2852,1655,1197,12,
Suchitepequez,"Neumonía, organismo no especificado",163,80,83,12,
Suchitepequez,"Diabetes mellitus, no especificada",150,63,87,12,
Suchitepequez,Exposición a factores no especificados,142,115,27,12,
Suchitepequez,Infarto agudo del miocardio,77,47,30,12,
Suchitepequez,Diarrea y gastroenteritis de presunto origen infeccioso,66,47,19,12,
Suchitepequez,"Disparo de otras armas de fuego, y las no especificadas",59,55,4,12,
Suchitepequez,Fibrosis y cirrosis del hígado,58,35,23,12,
Suchitepequez,Insuficiencia renal no especificada,57,37,20,12,
Suchitepequez,"Agresión con disparo de otras armas de fuego, y las no especificadas",51,48,3,12,
Suchitepequez,Insuficiencia renal crónica,49,36,13,12,
Suchitepequez,"Desnutrición proteicocalórica, no especificada",40,20,20,12,
Suchitepequez,Otros trastornos del encéfalo,38,20,18,12,
Suchitepequez,Tumor maligno del hígado y de las vías biliares intrahepáticas,36,18,18,12,
Suchitepequez,"Accidente vascular encefálico agudo, no especificado como hemorrágico o isquémico",28,15,13,12,
Suchitepequez,Insuficiencia cardíaca,27,14,13,12,
Suchitepequez,"Síntomas, signos y hallazgos anormales clínicos y de laboratorio, no clasificados en otra parte",862,450,412,12,
Suchitepequez,Otras causas,949,555,394,12,
Retalhuleu,Todas las causas,1667,948,719,12,
Retalhuleu,"Diabetes mellitus, no especificada",120,50,70,12,
Retalhuleu,"Neumonía, organismo no especificado",119,72,47,12,
Retalhuleu,Insuficiencia renal crónica,78,50,28,12,
Retalhuleu,Insuficiencia cardíaca,77,34,43,12,
Retalhuleu,Fibrosis y cirrosis del hígado,73,46,27,12,
Retalhuleu,Infarto agudo del miocardio,71,38,33,12,
Retalhuleu,"Accidente vascular encefálico agudo, no especificado como hemorrágico o isquémico",66,27,39,12,
Retalhuleu,Exposición a factores no especificados,56,45,11,12,
Retalhuleu,Insuficiencia renal no especificada,49,38,11,12,
Retalhuleu,"Agresión con disparo de otras armas de fuego, y las no especificadas",47,45,2,12,
Retalhuleu,Diarrea y gastroenteritis de presunto origen infeccioso,40,21,19,12,
Retalhuleu,Tumor maligno del hígado y de las vías biliares intrahepáticas,40,20,20,12,
Retalhuleu,Secuelas de otros efectos y los no especificados de causas externas,37,30,7,12,
Retalhuleu,Tumor maligno del estómago,27,12,15,12,
Retalhuleu,Otras anemias,26,13,13,12,
Retalhuleu,"Síntomas, signos y hallazgos anormales clínicos y de laboratorio, no clasificados en otra parte",55,31,24,12,
Retalhuleu,Otras causas,686,376,310,12,
San Marcos,Todas las causas,4846,2756,2090,12,
San Marcos,"Neumonía, organismo no especificado",758,413,345,12,
San Marcos,Infarto agudo del miocardio,306,190,116,12,
San Marcos,Diarrea y gastroenteritis de presunto origen infeccioso,260,149,111,12,
San Marcos,Insuficiencia cardíaca,170,86,84,12,
San Marcos,"Diabetes mellitus, no especificada",163,62,101,12,
San Marcos,"Desnutrición proteicocalórica, no especificada",148,74,74,12,
San Marcos,Exposición a factores no especificados,144,114,30,12,
San Marcos,Fibrosis y cirrosis del hígado,132,84,48,12,
San Marcos,"Accidente vascular encefálico agudo, no especificado como hemorrágico o isquémico",131,70,61,12,
San Marcos,"Agresión con disparo de otras armas de fuego, y las no especificadas",111,98,13,12,
San Marcos,Tumor maligno del hígado y de las vías biliares intrahepáticas,92,43,49,12,
San Marcos,Tumor maligno del estómago,91,43,48,12,
San Marcos,Úlcera gástrica,89,54,35,12,
San Marcos,Insuficiencia renal no especificada,74,40,34,12,
San Marcos,Insuficiencia renal crónica,69,40,29,12,
San Marcos,"Síntomas, signos y hallazgos anormales clínicos y de laboratorio, no clasificados en otra parte",336,175,161,12,
San Marcos,Otras causas,1772,1021,751,12,
Huehuetenango,Todas las causas,4158,2322,1836,12,
Huehuetenango,"Neumonía, organismo no especificado",715,398,317,12,
Huehuetenango,Diarrea y gastroenteritis de presunto origen infeccioso,249,136,113,12,
Huehuetenango,Infarto agudo del miocardio,214,115,99,12,
Huehuetenango,"Diabetes mellitus, no especificada",156,74,82,12,
Huehuetenango,"Accidente vascular encefálico agudo, no especificado como hemorrágico o isquémico",131,59,72,12,
Huehuetenango,Exposición a factores no especificados,123,95,28,12,
Huehuetenango,Tumor maligno del estómago,110,51,59,12,
Huehuetenango,Secuelas de otros efectos y los no especificados de causas externas,90,78,12,12,
Huehuetenango,"Envenenamiento accidental por, y exposición al alcohol",89,85,4,12,
Huehuetenango,Insuficiencia cardíaca,84,40,44,12,
Huehuetenango,Fibrosis y cirrosis del hígado,81,56,25,12,
Huehuetenango,Insuficiencia renal no especificada,77,38,39,12,
Huehuetenango,Tumor maligno del hígado y de las vías biliares intrahepáticas,68,32,36,12,
Huehuetenango,"Agresión con disparo de otras armas de fuego, y las no especificadas",68,60,8,12,
Huehuetenango,Úlcera gástrica,63,36,27,12,
Huehuetenango,"Síntomas, signos y hallazgos anormales clínicos y de laboratorio, no clasificados en otra parte",231,113,118,12,
Huehuetenango,Otras causas,1609,856,753,12,
Quiche,Todas las causas,3912,2123,1789,12,
Quiche,"Neumonía, organismo no especificado",610,291,319,12,
Quiche,Diarrea y gastroenteritis de presunto origen infeccioso,327,146,181,12,
Quiche,Exposición a factores no especificados,140,107,33,12,
Quiche,Infarto agudo del miocardio,134,79,55,12,
Quiche,"Diabetes mellitus, no especificada",98,42,56,12,
Quiche,Insuficiencia cardíaca,93,49,44,12,
Quiche,"Envenenamiento accidental por, y exposición al alcohol",91,82,9,12,
Quiche,Fibrosis y cirrosis del hígado,75,51,24,12,
Quiche,"Desnutrición proteicocalórica, no especificada",73,35,38,12,
Quiche,Otras septicemias,64,40,24,12,
Quiche,Tumor maligno del estómago,64,29,35,12,
Quiche,Enfermedad alcohólica del hígado,50,39,11,12,
Quiche,"Agresión con disparo de otras armas de fuego, y las no especificadas",50,43,7,12,
Quiche,"Accidente vascular encefálico agudo, no especificado como hemorrágico o isquémico",48,15,33,12,
Quiche,Insuficiencia renal crónica,48,24,24,12,
Quiche,"Síntomas, signos y hallazgos anormales clínicos y de laboratorio, no clasificados en otra parte",362,182,180,12,
Quiche,Otras causas,1585,869,716,12,
Baja Verapaz,Todas las causas,1311,717,594,12,
Baja Verapaz,"Neumonía, organismo no especificado",179,93,86,12,
Baja Verapaz,Infarto agudo del miocardio,131,64,67,12,
Baja Verapaz,"Accidente vascular encefálico agudo, no especificado como hemorrágico o isquémico",92,33,59,12,
Baja Verapaz,"Diabetes mellitus, no especificada",60,25,35,12,
Baja Verapaz,Tumor maligno del estómago,41,21,20,12,
Baja Verapaz,Exposición a factores no especificados,37,29,8,12,
Baja Verapaz,"Agresión con disparo de otras armas de fuego, y las no especificadas",34,32,2,12,
Baja Verapaz,Diarrea y gastroenteritis de presunto origen infeccioso,32,17,15,12,
Baja Verapaz,Fibrosis y cirrosis del hígado,30,15,15,12,
Baja Verapaz,Insuficiencia cardíaca,29,6,23,12,
Baja Verapaz,Secuelas de otros efectos y los no especificados de causas externas,28,23,5,12,
Baja Verapaz,Tumor maligno del hígado y de las vías biliares intrahepáticas,27,14,13,12,
Baja Verapaz,"Desnutrición proteicocalórica, no especificada",27,11,16,12,
Baja Verapaz,Otras enfermedades cerebrovasculares,22,12,10,12,
Baja Verapaz,Otras septicemias,18,11,7,12,
Baja Verapaz,"Síntomas, signos y hallazgos anormales clínicos y de laboratorio, no clasificados en otra parte",48,25,23,12,
Baja Verapaz,Otras causas,476,286,190,12,
Alta Verapaz,Todas las causas,4481,2295,2186,12,
Alta Verapaz,"Neumonía, organismo no especificado",739,361,378,12,
Alta Verapaz,Diarrea y gastroenteritis de presunto origen infeccioso,361,182,179,12,
Alta Verapaz,Infarto agudo del miocardio,283,136,147,12,
Alta Verapaz,"Desnutrición proteicocalórica, no especificada",220,100,120,12,
Alta Verapaz,"Diabetes mellitus, no especificada",134,40,94,12,
Alta Verapaz,Exposición a factores no especificados,128,108,20,12,
Alta Verapaz,Fibrosis y cirrosis del hígado,118,61,57,12,
Alta Verapaz,Tumor maligno del estómago,91,42,49,12,
Alta Verapaz,Tumor maligno del hígado y de las vías biliares intrahepáticas,90,38,52,12,
Alta Verapaz,"Accidente vascular encefálico agudo, no especificado como hemorrágico o isquémico",81,34,47,12,
Alta Verapaz,Úlcera gástrica,78,40,38,12,
Alta Verapaz,Síndromes de aspiración neonatal,75,44,31,12,
Alta Verapaz,Otras anemias,70,26,44,12,
Alta Verapaz,Dificultad respiratoria del recién nacido,69,46,23,12,
Alta Verapaz,Insuficiencia cardíaca,65,34,31,12,
Alta Verapaz,"Síntomas, signos y hallazgos anormales clínicos y de laboratorio, no clasificados en otra parte",111,49,62,12,
Alta Verapaz,Otras causas,1768,954,814,12,
Peten,Todas las causas,1772,1086,686,12,
Peten,"Agresión con disparo de otras armas de fuego, y las no especificadas",178,170,8,12,
Peten,"Neumonía, organismo no especificado",103,61,42,12,
Peten,Infarto agudo del miocardio,85,45,40,12,
Peten,"Diabetes mellitus, no especificada",83,25,58,12,
Peten,Exposición a factores no especificados,71,52,19,12,
Peten,Secuelas de otros efectos y los no especificados de causas externas,52,49,3,12,
Peten,Diarrea y gastroenteritis de presunto origen infeccioso,44,23,21,12,
Peten,"Disparo de otras armas de fuego, y las no especificadas",39,38,1,12,
Peten,Tumor maligno de sitios no especificados,37,17,20,12,
Peten,Agresión con objeto cortante,31,24,7,12,
Peten,Tumor maligno del hígado y de las vías biliares intrahepáticas,29,19,10,12,
Peten,Fibrosis y cirrosis del hígado,28,17,11,12,
Peten,"Accidente vascular encefálico agudo, no especificado como hemorrágico o isquémico",27,14,13,12,
Peten,Diabetes mellitus no insulinodependiente,25,8,17,12,
Peten,Tumor maligno del estómago,24,12,12,12,
Peten,"Síntomas, signos y hallazgos anormales clínicos y de laboratorio, no clasificados en otra parte",213,113,100,12,
Peten,Otras causas,703,399,304,12,
Izabal,Todas las causas,1864,1068,796,12,
Izabal,Infarto agudo del miocardio,175,100,75,12,
Izabal,"Agresión con disparo de otras armas de fuego, y las no especificadas",114,105,9,12,
Izabal,"Diabetes mellitus, no especificada",108,41,67,12,
Izabal,"Neumonía, organismo no especificado",89,47,42,12,
Izabal,"Disparo de otras armas de fuego, y las no especificadas",82,69,13,12,
Izabal,Exposición a factores no especificados,67,55,12,12,
Izabal,Diarrea y gastroenteritis de presunto origen infeccioso,61,29,32,12,
Izabal,"Accidente vascular encefálico agudo, no especificado como hemorrágico o isquémico",52,28,24,12,
Izabal,Secuelas de otros efectos y los no especificados de causas externas,52,43,9,12,
Izabal,Fibrosis y cirrosis del hígado,49,24,25,12,
Izabal,Insuficiencia renal no especificada,49,24,25,12,
Izabal,Tumor maligno del estómago,43,22,21,12,
Izabal,Insuficiencia cardíaca,31,13,18,12,
Izabal,Tumor maligno del hígado y de las vías biliares intrahepáticas,30,9,21,12,
Izabal,"Enfermedad por virus de la inmunodeficiencia humana [VIH], sin otra especificación",25,16,9,12,
Izabal,"Síntomas, signos y hallazgos anormales clínicos y de laboratorio, no clasificados en otra parte",157,85,72,12,
Izabal,Otras causas,680,358,322,12,
Zacapa,Todas las causas,1468,852,616,12,
Zacapa,Infarto agudo del miocardio,185,91,94,12,
Zacapa,"Agresión con disparo de otras armas de fuego, y las no especificadas",121,108,13,12,
Zacapa,"Diabetes mellitus, no especificada",94,34,60,12,
Zacapa,"Neumonía, organismo no especificado",73,43,30,12,
Zacapa,Exposición a factores no especificados,64,49,15,12,
Zacapa,"Accidente vascular encefálico agudo, no especificado como hemorrágico o isquémico",53,24,29,12,
Zacapa,Tumor maligno del estómago,44,20,24,12,
Zacapa,Secuelas de otros efectos y los no especificados de causas externas,44,37,7,12,
Zacapa,Insuficiencia cardíaca,43,23,20,12,
Zacapa,Diabetes mellitus no insulinodependiente,38,18,20,12,
Zacapa,Tumor maligno del hígado y de las vías biliares intrahepáticas,30,13,17,12,
Zacapa,Otras enfermedades cerebrovasculares,27,10,17,12,
Zacapa,Insuficiencia renal crónica,23,11,12,12,
Zacapa,Fibrosis y cirrosis del hígado,22,17,5,12,
Zacapa,Enfermedad cardíaca hipertensiva,19,9,10,12,
Zacapa,"Síntomas, signos y hallazgos anormales clínicos y de laboratorio, no clasificados en otra parte",32,23,9,12,
Zacapa,Otras causas,556,322,234,12,
Chiquimula,Todas las causas,2116,1259,857,12,
Chiquimula,Infarto agudo del miocardio,222,123,99,12,
Chiquimula,"Disparo de otras armas de fuego, y las no especificadas",215,191,24,12,
Chiquimula,"Neumonía, organismo no especificado",189,105,84,12,
Chiquimula,Insuficiencia cardíaca,113,58,55,12,
Chiquimula,"Diabetes mellitus, no especificada",97,27,70,12,
Chiquimula,"Accidente vascular encefálico agudo, no especificado como hemorrágico o isquémico",84,51,33,12,
Chiquimula,Exposición a factores no especificados,77,66,11,12,
Chiquimula,Tumor maligno del estómago,55,30,25,12,
Chiquimula,Diarrea y gastroenteritis de presunto origen infeccioso,54,31,23,12,
Chiquimula,"Contacto traumático con cuchillo, espada, daga o puñal",47,43,4,12,
Chiquimula,"Agresión con disparo de otras armas de fuego, y las no especificadas",45,42,3,12,
Chiquimula,Fibrosis y cirrosis del hígado,35,20,15,12,
Chiquimula,Úlcera gástrica,33,17,16,12,
Chiquimula,Otras septicemias,25,12,13,12,
Chiquimula,Secuelas de otros efectos y los no especificados de causas externas,25,10,15,12,
Chiquimula,"Síntomas, signos y hallazgos anormales clínicos y de laboratorio, no clasificados en otra parte",75,36,39,12,
Chiquimula,Otras causas,725,397,328,12,
Jalapa,Todas las causas,1699,970,729,12,
Jalapa,Infarto agudo del miocardio,170,93,77,12,
Jalapa,"Neumonía, organismo no especificado",145,72,73,12,
Jalapa,"Agresión con disparo de otras armas de fuego, y las no especificadas",114,106,8,12,
Jalapa,"Accidente vascular encefálico agudo, no especificado como hemorrágico o isquémico",97,43,54,12,
Jalapa,"Diabetes mellitus, no especificada",76,36,40,12,
Jalapa,Tumor maligno del estómago,65,28,37,12,
Jalapa,Diarrea y gastroenteritis de presunto origen infeccioso,56,37,19,12,
Jalapa,Exposición a factores no especificados,46,35,11,12,
Jalapa,Insuficiencia cardíaca,38,22,16,12,
Jalapa,Agresión con objeto cortante,37,33,4,12,
Jalapa,Tumor maligno del hígado y de las vías biliares intrahepáticas,35,19,16,12,
Jalapa,Fibrosis y cirrosis del hígado,34,22,12,12,
Jalapa,Otras enfermedades pulmonares obstructivas crónicas,33,15,18,12,
Jalapa,"Disparo de otras armas de fuego, y las no especificadas",32,28,4,12,
Jalapa,Insuficiencia renal crónica,24,12,12,12,
Jalapa,"Síntomas, signos y hallazgos anormales clínicos y de laboratorio, no clasificados en otra parte",124,62,62,12,
Jalapa,Otras causas,573,307,266,12,
Jutiapa,Todas las causas,2603,1514,1089,12,
Jutiapa,Infarto agudo del miocardio,341,199,142,12,
Jutiapa,"Agresión con disparo de otras armas de fuego, y las no especificadas",215,198,17,12,
Jutiapa,"Neumonía, organismo no especificado",133,80,53,12,
Jutiapa,"Accidente vascular encefálico agudo, no especificado como hemorrágico o isquémico",132,65,67,12,
Jutiapa,"Diabetes mellitus, no especificada",131,57,74,12,
Jutiapa,Tumor maligno del estómago,96,46,50,12,
Jutiapa,Secuelas de otros efectos y los no especificados de causas externas,81,67,14,12,
Jutiapa,Insuficiencia cardíaca,74,38,36,12,
Jutiapa,Otras enfermedades cerebrovasculares,73,41,32,12,
Jutiapa,Exposición a factores no especificados,61,51,10,12,
Jutiapa,Diabetes mellitus no insulinodependiente,55,26,29,12,
Jutiapa,Insuficiencia renal crónica,55,28,27,12,
Jutiapa,Tumor maligno del hígado y de las vías biliares intrahepáticas,53,22,31,12,
Jutiapa,Tumor maligno de la próstata,41,41,0,12,
Jutiapa,Diarrea y gastroenteritis de presunto origen infeccioso,39,21,18,12,
Jutiapa,"Síntomas, signos y hallazgos anormales clínicos y de laboratorio, no clasificados en otra parte",58,30,28,12,
Jutiapa,Otras causas,965,504,461,12,
Extranjero,Todas las causas,143,93,50,12,
Extranjero,"Agresión con disparo de otras armas de fuego, y las no especificadas",38,34,4,12,
Extranjero,"Disparo de otras armas de fuego, y las no especificadas",12,9,3,12,
Extranjero,Exposición a factores no especificados,10,5,5,12,
Extranjero,Insuficiencia renal crónica,6,2,4,12,
Extranjero,Secuelas de otros efectos y los no especificados de causas externas,6,4,2,12,
Extranjero,"Diabetes mellitus, no especificada",5,1,4,12,
Extranjero,Infarto agudo del miocardio,5,4,1,12,
Extranjero,"Agresión por ahorcamiento, estrangulamiento y sofocación",4,2,2,12,
Extranjero,Insuficiencia cardíaca,3,1,2,12,
Extranjero,"Neumonía, organismo no especificado",3,3,0,12,
Extranjero,Fibrosis y cirrosis del hígado,3,2,1,12,
Extranjero,Diabetes mellitus no insulinodependiente,2,1,1,12,
Extranjero,Embolia pulmonar,2,1,1,12,
Extranjero,Otras enfermedades del pericardio,2,1,1,12,
Extranjero,Hemorragia intraencefálica,2,1,1,12,
Extranjero,"Síntomas, signos y hallazgos anormales clínicos y de laboratorio, no clasificados en otra parte",7,5,2,12,
Extranjero,Otras causas,33,17,16,12,
Ignorado,Todas las causas,534,432,102,12,
Ignorado,Exposición a factores no especificados,105,95,10,12,
Ignorado,"Agresión con disparo de otras armas de fuego, y las no especificadas",45,37,8,12,
Ignorado,"Disparo de otras armas de fuego, y las no especificadas",33,29,4,12,
Ignorado,"Neumonía, organismo no especificado",20,18,2,12,
Ignorado,Agresión con objeto cortante,16,13,3,12,
Ignorado,Obstrucción no especificada de la respiración,15,13,2,12,
Ignorado,Fibrosis y cirrosis del hígado,13,12,1,12,
Ignorado,Ahogamiento y sumersión no especificados,12,10,2,12,
Ignorado,"Agresión por ahorcamiento, estrangulamiento y sofocación",11,10,1,12,
Ignorado,Infarto agudo del miocardio,9,7,2,12,
Ignorado,Edema pulmonar,9,6,3,12,
Ignorado,Secuelas de otros efectos y los no especificados de causas externas,9,9,0,12,
Ignorado,Trastornos mentales y del comportamiento debidos al uso de alcohol,8,6,2,12,
Ignorado,"Contacto traumático con cuchillo, espada, daga o puñal",8,6,2,12,
Ignorado,Otras septicemias,7,6,1,12,
Ignorado,"Síntomas, signos y hallazgos anormales clínicos y de laboratorio, no clasificados en otra parte",63,46,17,12,
Ignorado,Otras causas,151,109,42,12,
Todos los departamentos,Todas las causas,76639,43220,33419,13,Todas las causas
Todos los departamentos,"Neumonía, organismo no especificado",7423,3892,3531,13,J18
Todos los departamentos,Infarto agudo del miocardio,4810,2579,2231,13,I21
Todos los departamentos,"Diabetes mellitus, no especificada",3891,1583,2308,13,E14
Todos los departamentos,"Agresión con disparo de otras armas de fuego, y las no especificadas",3536,3130,406,13,X95
Todos los departamentos,Exposición a factores no especificados,2957,2333,624,13,X59
Todos los departamentos,Diarrea y gastroenteritis de presunto origen infeccioso,2282,1206,1076,13,A09
Todos los departamentos,Fibrosis y cirrosis del hígado,1917,1215,702,13,K74
Todos los departamentos,"Accidente vascular encefálico agudo, no especificado como hemorrágico o isquémico",1836,843,993,13,I64
Todos los departamentos,Insuficiencia cardíaca,1754,832,922,13,I50
Todos los departamentos,"Desnutrición proteicocalórica, no especificada",1465,727,738,13,E46
Todos los departamentos,Tumor maligno del estómago,1390,643,747,13,C16
Todos los departamentos,Tumor maligno del hígado y de las vías biliares intrahepáticas,1302,598,704,13,C22
Todos los departamentos,Diabetes mellitus no insulinodependiente,1296,551,745,13,E11
Todos los departamentos,Insuficiencia renal crónica,1256,664,592,13,N18
Todos los departamentos,"Accidente de vehículo de motor o sin motor, tipo de vehículo no especificado",1158,964,194,13,V89
Todos los departamentos,"Síntomas, signos y hallazgos anormales clínicos y de laboratorio, no clasificados en otra parte",5516,2864,2652,13,R00 - R99
Todos los departamentos,Otras causas,32850,18596,14254,13,Otras causas
Guatemala,Todas las causas,17852,9808,8044,13,Todas las causas
Guatemala,"Diabetes mellitus, no especificada",1212,506,706,13,E14
Guatemala,Infarto agudo del miocardio,1138,572,566,13,I21
Guatemala,"Agresión con disparo de otras armas de fuego, y las no especificadas",1086,938,148,13,X95
Guatemala,Exposición a factores no especificados,835,650,185,13,X59
Guatemala,"Neumonía, organismo no especificado",718,360,358,13,J18
Guatemala,Fibrosis y cirrosis del hígado,633,415,218,13,K74
Guatemala,Diabetes mellitus no insulinodependiente,491,236,255,13,E11
Guatemala,Insuficiencia renal crónica,417,198,219,13,N18
Guatemala,"Desnutrición proteicocalórica, no especificada",403,194,209,13,E46
Guatemala,Tumor maligno del hígado y de las vías biliares intrahepáticas,335,165,170,13,C22
Guatemala,Insuficiencia cardíaca,294,140,154,13,I50
Guatemala,Tumor maligno del estómago,292,124,168,13,C16
Guatemala,"Accidente vascular encefálico agudo, no especificado como hemorrágico o isquémico",276,122,154,13,I64
Guatemala,Enfermedad alcohólica del hígado,244,214,30,13,K70
Guatemala,"Disparo de otras armas de fuego, y las no especificadas",240,207,33,13,W34
Guatemala,"Síntomas, signos y hallazgos anormales clínicos y de laboratorio, no clasificados en otra parte",1070,476,594,13,R00 - R99
Guatemala,Otras causas,8168,4291,3877,13,Otras causas
El Progreso,Todas las causas,930,550,380,13,Todas las causas
El Progreso,Infarto agudo del miocardio,162,105,57,13,I21
El Progreso,"Diabetes mellitus, no especificada",54,22,32,13,E14
El Progreso,"Neumonía, organismo no especificado",53,27,26,13,J18
El Progreso,"Accidente vascular encefálico agudo, no especificado como hemorrágico o isquémico",49,22,27,13,I64
El Progreso,"Agresión con disparo de otras armas de fuego, y las no especificadas",49,45,4,13,X95
El Progreso,Tumor maligno del estómago,33,10,23,13,C16
El Progreso,Exposición a factores no especificados,33,24,9,13,X59
El Progreso,Tumor maligno del hígado y de las vías biliares intrahepáticas,30,12,18,13,C22
El Progreso,Fibrosis y cirrosis del hígado,23,19,4,13,K74
El Progreso,"Accidente de vehículo de motor o sin motor, tipo de vehículo no especificado",17,15,2,13,V89
El Progreso,Diabetes mellitus no insulinodependiente,16,2,14,13,E11
El Progreso,Tumor maligno de la próstata,15,15,0,13,C61
El Progreso,Otras enfermedades pulmonares obstructivas crónicas,14,5,9,13,J44
El Progreso,Otras septicemias,12,4,8,13,A41
El Progreso,Insuficiencia renal no especificada,11,6,5,13,N19
El Progreso,"Síntomas, signos y hallazgos anormales clínicos y de laboratorio, no clasificados en otra parte",24,14,10,13,R00 - R99
El Progreso,Otras causas,335,203,132,13,Otras causas
Sacatepequez,Todas las causas,1569,859,710,13,Todas las causas
Sacatepequez,"Neumonía, organismo no especificado",114,68,46,13,J18
Sacatepequez,"Diabetes mellitus, no especificada",107,40,67,13,E14
Sacatepequez,Infarto agudo del miocardio,106,60,46,13,I21
Sacatepequez,Exposición a factores no especificados,75,61,14,13,X59
Sacatepequez,Diabetes mellitus no insulinodependiente,72,34,38,13,E11
Sacatepequez,"Desnutrición proteicocalórica, no especificada",54,29,25,13,E46
Sacatepequez,Fibrosis y cirrosis del hígado,43,27,16,13,K74
Sacatepequez,"Accidente vascular encefálico agudo, no especificado como hemorrágico o isquémico",40,17,23,13,I64
Sacatepequez,Insuficiencia renal crónica,36,20,16,13,N18
Sacatepequez,Enfermedad alcohólica del hígado,35,29,6,13,K70
Sacatepequez,"Agresión con disparo de otras armas de fuego, y las no especificadas",32,30,2,13,X95
Sacatepequez,Tumor maligno del estómago,31,14,17,13,C16
Sacatepequez,Tumor maligno del hígado y de las vías biliares intrahepáticas,30,12,18,13,C22
Sacatepequez,Otras enfermedades cerebrovasculares,29,14,15,13,I67
Sacatepequez,Otras enfermedades pulmonares obstructivas crónicas,27,17,10,13,J44
Sacatepequez,"Síntomas, signos y hallazgos anormales clínicos y de laboratorio, no clasificados en otra parte",80,40,40,13,R00 - R99
Sacatepequez,Otras causas,658,347,311,13,Otras causas
Chimaltenango,Todas las causas,2573,1411,1162,13,Todas las causas
Chimaltenango,"Neumonía, organismo no especificado",264,132,132,13,J18
Chimaltenango,"Diabetes mellitus, no especificada",138,53,85,13,E14
Chimaltenango,Infarto agudo del miocardio,135,76,59,13,I21
Chimaltenango,Insuficiencia cardíaca,128,68,60,13,I50
Chimaltenango,Exposición a factores no especificados,123,104,19,13,X59
Chimaltenango,Enfermedad alcohólica del hígado,89,82,7,13,K70
Chimaltenango,"Accidente vascular encefálico agudo, no especificado como hemorrágico o isquémico",85,36,49,13,I64
Chimaltenango,Tumor maligno del estómago,83,40,43,13,C16
Chimaltenango,Fibrosis y cirrosis del hígado,80,48,32,13,K74
Chimaltenango,"Accidente de vehículo de motor o sin motor, tipo de vehículo no especificado",79,49,30,13,V89
Chimaltenango,Otras enfermedades pulmonares obstructivas crónicas,59,22,37,13,J44
Chimaltenango,"Agresión con disparo de otras armas de fuego, y las no especificadas",55,51,4,13,X95
Chimaltenango,"Envenenamiento accidental por, y exposición al alcohol",53,51,2,13,X45
Chimaltenango,Tumor maligno del hígado y de las vías biliares intrahepáticas,52,21,31,13,C22
Chimaltenango,Diarrea y gastroenteritis de presunto origen infeccioso,41,26,15,13,A09
Chimaltenango,"Síntomas, signos y hallazgos anormales clínicos y de laboratorio, no clasificados en otra parte",95,41,54,13,R00 - R99
Chimaltenango,Otras causas,1014,511,503,13,Otras causas
Escuintla,Todas las causas,4085,2455,1630,13,Todas las causas
Escuintla,"Agresión con disparo de otras armas de fuego, y las no especificadas",393,351,42,13,X95
Escuintla,Infarto agudo del miocardio,299,160,139,13,I21
Escuintla,"Neumonía, organismo no especificado",270,150,120,13,J18
Escuintla,"Diabetes mellitus, no especificada",258,107,151,13,E14
Escuintla,Exposición a factores no especificados,170,135,35,13,X59
Escuintla,Fibrosis y cirrosis del hígado,107,72,35,13,K74
Escuintla,Insuficiencia renal crónica,103,61,42,13,N18
Escuintla,Tumor maligno del hígado y de las vías biliares intrahepáticas,97,45,52,13,C22
Escuintla,Diabetes mellitus no insulinodependiente,97,32,65,13,E11
Escuintla,"Accidente de vehículo de motor o sin motor, tipo de vehículo no especificado",87,73,14,13,V89
Escuintla,"Desnutrición proteicocalórica, no especificada",72,33,39,13,E46
Escuintla,"Accidente vascular encefálico agudo, no especificado como hemorrágico o isquémico",71,36,35,13,I64
Escuintla,Insuficiencia renal no especificada,69,36,33,13,N19
Escuintla,Otras enfermedades cerebrovasculares,60,31,29,13,I67
Escuintla,Tumor maligno de la próstata,54,54,0,13,C61
Escuintla,"Síntomas, signos y hallazgos anormales clínicos y de laboratorio, no clasificados en otra parte",263,152,111,13,R00 - R99
Escuintla,Otras causas,1615,927,688,13,Otras causas
Santa Rosa,Todas las causas,2095,1270,825,13,Todas las causas
Santa Rosa,"Agresión con disparo de otras armas de fuego, y las no especificadas",168,156,12,13,X95
Santa Rosa,Infarto agudo del miocardio,149,67,82,13,I21
Santa Rosa,"Neumonía, organismo no especificado",98,56,42,13,J18
Santa Rosa,"Diabetes mellitus, no especificada",95,37,58,13,E14
Santa Rosa,Insuficiencia cardíaca,74,40,34,13,I50
Santa Rosa,"Accidente de vehículo de motor o sin motor, tipo de vehículo no especificado",73,64,9,13,V89
Santa Rosa,Exposición a factores no especificados,71,61,10,13,X59
Santa Rosa,"Accidente vascular encefálico agudo, no especificado como hemorrágico o isquémico",59,31,28,13,I64
Santa Rosa,Insuficiencia renal crónica,44,25,19,13,N18
Santa Rosa,Fibrosis y cirrosis del hígado,42,27,15,13,K74
Santa Rosa,Tumor maligno del estómago,34,22,12,13,C16
Santa Rosa,Tumor maligno del hígado y de las vías biliares intrahepáticas,27,9,18,13,C22
Santa Rosa,Otras septicemias,26,17,9,13,A41
Santa Rosa,Diabetes mellitus no insulinodependiente,26,11,15,13,E11
Santa Rosa,Otras enfermedades pulmonares obstructivas crónicas,26,20,6,13,J44
Santa Rosa,"Síntomas, signos y hallazgos anormales clínicos y de laboratorio, no clasificados en otra parte",222,128,94,13,R00 - R99
Santa Rosa,Otras causas,861,499,362,13,Otras causas
Solola,Todas las causas,1720,996,724,13,Todas las causas
Solola,"Neumonía, organismo no especificado",307,134,173,13,J18
Solola,"Diabetes mellitus, no especificada",84,37,47,13,E14
Solola,Diarrea y gastroenteritis de presunto origen infeccioso,60,37,23,13,A09
Solola,Infarto agudo del miocardio,60,32,28,13,I21
Solola,Exposición a factores no especificados,55,50,5,13,X59
Solola,"Envenenamiento accidental por, y exposición al alcohol",52,50,2,13,X45
Solola,Fibrosis y cirrosis del hígado,51,40,11,13,K74
Solola,"Desnutrición proteicocalórica, no especificada",43,21,22,13,E46
Solola,"Accidente vascular encefálico agudo, no especificado como hemorrágico o isquémico",37,16,21,13,I64
Solola,Tumor maligno del estómago,32,17,15,13,C16
Solola,Tumor maligno del hígado y de las vías biliares intrahepáticas,32,16,16,13,C22
Solola,Insuficiencia renal no especificada,32,15,17,13,N19
Solola,Insuficiencia cardíaca,31,14,17,13,I50
Solola,Trastornos mentales y del comportamiento debidos al uso de alcohol,26,24,2,13,F10
Solola,Insuficiencia renal crónica,25,10,15,13,N18
Solola,"Síntomas, signos y hallazgos anormales clínicos y de laboratorio, no clasificados en otra parte",233,132,101,13,R00 - R99
Solola,Otras causas,560,351,209,13,Otras causas
Totonicapan,Todas las causas,2042,1096,946,13,Todas las causas
Totonicapan,"Neumonía, organismo no especificado",370,190,180,13,J18
Totonicapan,Infarto agudo del miocardio,98,47,51,13,I21
Totonicapan,Insuficiencia cardíaca,96,40,56,13,I50
Totonicapan,Diarrea y gastroenteritis de presunto origen infeccioso,88,50,38,13,A09
Totonicapan,"Envenenamiento accidental por, y exposición al alcohol",86,72,14,13,X45
Totonicapan,Fibrosis y cirrosis del hígado,71,47,24,13,K74
Totonicapan,"Diabetes mellitus, no especificada",66,41,25,13,E14
Totonicapan,Exposición a factores no especificados,57,43,14,13,X59
Totonicapan,Enfermedad alcohólica del hígado,48,35,13,13,K70
Totonicapan,Trastornos mentales y del comportamiento debidos al uso de alcohol,34,32,2,13,F10
Totonicapan,Diabetes mellitus no insulinodependiente,33,16,17,13,E11
Totonicapan,"Desnutrición proteicocalórica, no especificada",24,10,14,13,E46
Totonicapan,Otras enfermedades cerebrovasculares,24,12,12,13,I67
Totonicapan,Úlcera gástrica,24,10,14,13,K25
Totonicapan,"Accidente de vehículo de motor o sin motor, tipo de vehículo no especificado",24,20,4,13,V89
Totonicapan,"Síntomas, signos y hallazgos anormales clínicos y de laboratorio, no clasificados en otra parte",259,108,151,13,R00 - R99
Totonicapan,Otras causas,640,323,317,13,Otras causas
Quetzaltenango,Todas las causas,3744,2072,1672,13,Todas las causas
Quetzaltenango,"Neumonía, organismo no especificado",308,156,152,13,J18
Quetzaltenango,"Diabetes mellitus, no especificada",268,108,160,13,E14
Quetzaltenango,Infarto agudo del miocardio,198,100,98,13,I21
Quetzaltenango,Exposición a factores no especificados,172,125,47,13,X59
Quetzaltenango,Insuficiencia cardíaca,129,57,72,13,I50
Quetzaltenango,Enfermedad alcohólica del hígado,122,111,11,13,K70
Quetzaltenango,"Envenenamiento accidental por, y exposición al alcohol",117,109,8,13,X45
Quetzaltenango,"Accidente vascular encefálico agudo, no especificado como hemorrágico o isquémico",106,45,61,13,I64
Quetzaltenango,Diabetes mellitus no insulinodependiente,99,42,57,13,E11
Quetzaltenango,"Agresión con disparo de otras armas de fuego, y las no especificadas",95,81,14,13,X95
Quetzaltenango,Tumor maligno del estómago,90,42,48,13,C16
Quetzaltenango,"Desnutrición proteicocalórica, no especificada",89,47,42,13,E46
Quetzaltenango,Diarrea y gastroenteritis de presunto origen infeccioso,78,44,34,13,A09
Quetzaltenango,Tumor maligno del hígado y de las vías biliares intrahepáticas,76,34,42,13,C22
Quetzaltenango,Fibrosis y cirrosis del hígado,71,43,28,13,K74
Quetzaltenango,"Síntomas, signos y hallazgos anormales clínicos y de laboratorio, no clasificados en otra parte",125,59,66,13,R00 - R99
Quetzaltenango,Otras causas,1601,869,732,13,Otras causas
Suchitepequez,Todas las causas,2694,1553,1141,13,Todas las causas
Suchitepequez,"Diabetes mellitus, no especificada",147,70,77,13,E14
Suchitepequez,Exposición a factores no especificados,101,81,20,13,X59
Suchitepequez,"Neumonía, organismo no especificado",86,54,32,13,J18
Suchitepequez,Fibrosis y cirrosis del hígado,71,42,29,13,K74
Suchitepequez,"Agresión con disparo de otras armas de fuego, y las no especificadas",64,59,5,13,X95
Suchitepequez,Infarto agudo del miocardio,59,31,28,13,I21
Suchitepequez,Insuficiencia renal no especificada,56,40,16,13,N19
Suchitepequez,"Disparo de otras armas de fuego, y las no especificadas",56,46,10,13,W34
Suchitepequez,Tumor maligno del hígado y de las vías biliares intrahepáticas,39,13,26,13,C22
Suchitepequez,"Accidente de vehículo de motor o sin motor, tipo de vehículo no especificado",37,30,7,13,V89
Suchitepequez,Diarrea y gastroenteritis de presunto origen infeccioso,35,23,12,13,A09
Suchitepequez,Otros trastornos del encéfalo,35,17,18,13,G93
Suchitepequez,"Accidente vascular encefálico agudo, no especificado como hemorrágico o isquémico",29,16,13,13,I64
Suchitepequez,Insuficiencia renal crónica,29,21,8,13,N18
Suchitepequez,Diabetes mellitus no insulinodependiente,27,13,14,13,E11
Suchitepequez,"Síntomas, signos y hallazgos anormales clínicos y de laboratorio, no clasificados en otra parte",983,527,456,13,R00 - R99
Suchitepequez,Otras causas,840,470,370,13,Otras causas
Retalhuleu,Todas las causas,1729,1005,724,13,Todas las causas
Retalhuleu,"Diabetes mellitus, no especificada",168,76,92,13,E14
Retalhuleu,"Neumonía, organismo no especificado",98,50,48,13,J18
Retalhuleu,Insuficiencia cardíaca,91,42,49,13,I50
Retalhuleu,Insuficiencia renal crónica,80,61,19,13,N18
Retalhuleu,Infarto agudo del miocardio,68,35,33,13,I21
Retalhuleu,Fibrosis y cirrosis del hígado,63,37,26,13,K74
Retalhuleu,"Accidente vascular encefálico agudo, no especificado como hemorrágico o isquémico",61,27,34,13,I64
Retalhuleu,Exposición a factores no especificados,57,43,14,13,X59
Retalhuleu,"Agresión con disparo de otras armas de fuego, y las no especificadas",55,49,6,13,X95
Retalhuleu,Insuficiencia renal no especificada,47,34,13,13,N19
Retalhuleu,Diarrea y gastroenteritis de presunto origen infeccioso,39,16,23,13,A09
Retalhuleu,"Accidente de vehículo de motor o sin motor, tipo de vehículo no especificado",37,34,3,13,V89
Retalhuleu,Tumor maligno del hígado y de las vías biliares intrahepáticas,34,14,20,13,C22
Retalhuleu,Tumor maligno del estómago,31,13,18,13,C16
Retalhuleu,Otras septicemias,23,16,7,13,A41
Retalhuleu,"Síntomas, signos y hallazgos anormales clínicos y de laboratorio, no clasificados en otra parte",79,53,26,13,R00 - R99
Retalhuleu,Otras causas,698,405,293,13,Otras causas
San Marcos,Todas las causas,4168,2397,1771,13,Todas las causas
San Marcos,"Neumonía, organismo no especificado",561,318,243,13,J18
San Marcos,Infarto agudo del miocardio,305,189,116,13,I21
San Marcos,Diarrea y gastroenteritis de presunto origen infeccioso,176,101,75,13,A09
San Marcos,"Diabetes mellitus, no especificada",147,60,87,13,E14
San Marcos,Exposición a factores no especificados,141,107,34,13,X59
San Marcos,"Desnutrición proteicocalórica, no especificada",133,77,56,13,E46
San Marcos,Fibrosis y cirrosis del hígado,130,93,37,13,K74
San Marcos,Insuficiencia cardíaca,123,56,67,13,I50
San Marcos,"Agresión con disparo de otras armas de fuego, y las no especificadas",116,113,3,13,X95
San Marcos,"Accidente vascular encefálico agudo, no especificado como hemorrágico o isquémico",114,55,59,13,I64
San Marcos,Tumor maligno del hígado y de las vías biliares intrahepáticas,97,50,47,13,C22
San Marcos,Tumor maligno del estómago,87,42,45,13,C16
San Marcos,"Envenenamiento accidental por, y exposición al alcohol",76,70,6,13,X45
San Marcos,Úlcera gástrica,64,31,33,13,K25
San Marcos,Diabetes mellitus no insulinodependiente,62,21,41,13,E11
San Marcos,"Síntomas, signos y hallazgos anormales clínicos y de laboratorio, no clasificados en otra parte",280,158,122,13,R00 - R99
San Marcos,Otras causas,1556,856,700,13,Otras causas
Huehuetenango,Todas las causas,4037,2232,1805,13,Todas las causas
Huehuetenango,"Neumonía, organismo no especificado",585,321,264,13,J18
Huehuetenango,Diarrea y gastroenteritis de presunto origen infeccioso,222,120,102,13,A09
Huehuetenango,Infarto agudo del miocardio,220,128,92,13,I21
Huehuetenango,"Diabetes mellitus, no especificada",192,63,129,13,E14
Huehuetenango,"Accidente vascular encefálico agudo, no especificado como hemorrágico o isquémico",156,78,78,13,I64
Huehuetenango,Exposición a factores no especificados,113,92,21,13,X59
Huehuetenango,Tumor maligno del estómago,112,53,59,13,C16
Huehuetenango,Insuficiencia cardíaca,108,60,48,13,I50
Huehuetenango,Fibrosis y cirrosis del hígado,87,56,31,13,K74
Huehuetenango,Tumor maligno del hígado y de las vías biliares intrahepáticas,78,39,39,13,C22
Huehuetenango,"Envenenamiento accidental por, y exposición al alcohol",74,66,8,13,X45
Huehuetenango,Otras enfermedades cerebrovasculares,63,38,25,13,I67
Huehuetenango,"Accidente de vehículo de motor o sin motor, tipo de vehículo no especificado",59,49,10,13,V89
Huehuetenango,Insuficiencia renal no especificada,57,28,29,13,N19
Huehuetenango,Úlcera gástrica,56,29,27,13,K25
Huehuetenango,"Síntomas, signos y hallazgos anormales clínicos y de laboratorio, no clasificados en otra parte",293,163,130,13,R00 - R99
Huehuetenango,Otras causas,1562,849,713,13,Otras causas
Quiche,Todas las causas,3555,1911,1644,13,Todas las causas
Quiche,"Neumonía, organismo no especificado",548,267,281,13,J18
Quiche,Diarrea y gastroenteritis de presunto origen infeccioso,188,97,91,13,A09
Quiche,"Diabetes mellitus, no especificada",131,61,70,13,E14
Quiche,Infarto agudo del miocardio,124,53,71,13,I21
Quiche,Insuficiencia cardíaca,119,46,73,13,I50
Quiche,Exposición a factores no especificados,114,91,23,13,X59
Quiche,"Envenenamiento accidental por, y exposición al alcohol",91,83,8,13,X45
Quiche,"Accidente vascular encefálico agudo, no especificado como hemorrágico o isquémico",80,38,42,13,I64
Quiche,Tumor maligno del estómago,77,37,40,13,C16
Quiche,Enfermedad alcohólica del hígado,63,50,13,13,K70
Quiche,Otras septicemias,60,31,29,13,A41
Quiche,Fibrosis y cirrosis del hígado,60,32,28,13,K74
Quiche,Tumor maligno del hígado y de las vías biliares intrahepáticas,55,28,27,13,C22
Quiche,"Desnutrición proteicocalórica, no especificada",49,31,18,13,E46
Quiche,Trastornos mentales y del comportamiento debidos al uso de alcohol,48,44,4,13,F10
Quiche,"Síntomas, signos y hallazgos anormales clínicos y de laboratorio, no clasificados en otra parte",304,149,155,13,R00 - R99
Quiche,Otras causas,1444,773,671,13,Otras causas
Baja Verapaz,Todas las causas,1206,636,570,13,Todas las causas
Baja Verapaz,"Neumonía, organismo no especificado",151,87,64,13,J18
Baja Verapaz,Infarto agudo del miocardio,111,56,55,13,I21
Baja Verapaz,"Accidente vascular encefálico agudo, no especificado como hemorrágico o isquémico",87,37,50,13,I64
Baja Verapaz,"Diabetes mellitus, no especificada",53,21,32,13,E14
Baja Verapaz,Tumor maligno del estómago,43,20,23,13,C16
Baja Verapaz,"Accidente de vehículo de motor o sin motor, tipo de vehículo no especificado",33,28,5,13,V89
Baja Verapaz,Exposición a factores no especificados,29,21,8,13,X59
Baja Verapaz,Insuficiencia cardíaca,27,8,19,13,I50
Baja Verapaz,Tumor maligno del hígado y de las vías biliares intrahepáticas,23,10,13,13,C22
Baja Verapaz,"Desnutrición proteicocalórica, no especificada",23,9,14,13,E46
Baja Verapaz,Diarrea y gastroenteritis de presunto origen infeccioso,22,13,9,13,A09
Baja Verapaz,"Agresión con disparo de otras armas de fuego, y las no especificadas",20,17,3,13,X95
Baja Verapaz,Otras septicemias,19,14,5,13,A41
Baja Verapaz,Fibrosis y cirrosis del hígado,18,7,11,13,K74
Baja Verapaz,Hipertensión esencial (primaria),16,7,9,13,I10
Baja Verapaz,"Síntomas, signos y hallazgos anormales clínicos y de laboratorio, no clasificados en otra parte",60,31,29,13,R00 - R99
Baja Verapaz,Otras causas,471,250,221,13,Otras causas
Alta Verapaz,Todas las causas,4189,2198,1991,13,Todas las causas
Alta Verapaz,"Neumonía, organismo no especificado",658,319,339,13,J18
Alta Verapaz,Diarrea y gastroenteritis de presunto origen infeccioso,324,158,166,13,A09
Alta Verapaz,Infarto agudo del miocardio,264,129,135,13,I21
Alta Verapaz,"Desnutrición proteicocalórica, no especificada",260,118,142,13,E46
Alta Verapaz,Exposición a factores no especificados,134,108,26,13,X59
Alta Verapaz,"Diabetes mellitus, no especificada",127,59,68,13,E14
Alta Verapaz,Tumor maligno del hígado y de las vías biliares intrahepáticas,85,41,44,13,C22
Alta Verapaz,"Accidente vascular encefálico agudo, no especificado como hemorrágico o isquémico",85,38,47,13,I64
Alta Verapaz,Fibrosis y cirrosis del hígado,84,32,52,13,K74
Alta Verapaz,Dificultad respiratoria del recién nacido,82,50,32,13,P22
Alta Verapaz,Síndromes de aspiración neonatal,75,48,27,13,P24
Alta Verapaz,Úlcera gástrica,68,39,29,13,K25
Alta Verapaz,Otras septicemias,62,31,31,13,A41
Alta Verapaz,Tumor maligno del estómago,61,28,33,13,C16
Alta Verapaz,"Agresión con disparo de otras armas de fuego, y las no especificadas",56,54,2,13,X95
Alta Verapaz,"Síntomas, signos y hallazgos anormales clínicos y de laboratorio, no clasificados en otra parte",98,53,45,13,R00 - R99
Alta Verapaz,Otras causas,1666,893,773,13,Otras causas
Peten,Todas las causas,1903,1155,748,13,Todas las causas
Peten,"Agresión con disparo de otras armas de fuego, y las no especificadas",212,196,16,13,X95
Peten,"Neumonía, organismo no especificado",116,70,46,13,J18
Peten,Infarto agudo del miocardio,101,63,38,13,I21
Peten,"Diabetes mellitus, no especificada",99,37,62,13,E14
Peten,Exposición a factores no especificados,71,58,13,13,X59
Peten,"Accidente de vehículo de motor o sin motor, tipo de vehículo no especificado",65,55,10,13,V89
Peten,Diarrea y gastroenteritis de presunto origen infeccioso,63,35,28,13,A09
Peten,"Accidente vascular encefálico agudo, no especificado como hemorrágico o isquémico",56,27,29,13,I64
Peten,Fibrosis y cirrosis del hígado,44,19,25,13,K74
Peten,Diabetes mellitus no insulinodependiente,36,16,20,13,E11
Peten,Agresión con objeto cortante,30,28,2,13,X99
Peten,Agresión por medios no especificados,29,28,1,13,Y09
Peten,Tumor maligno del estómago,28,14,14,13,C16
Peten,Tumor maligno del hígado y de las vías biliares intrahepáticas,27,7,20,13,C22
Peten,"Neumonía bacteriana, no clasificada en otra parte",24,11,13,13,J15
Peten,"Síntomas, signos y hallazgos anormales clínicos y de laboratorio, no clasificados en otra parte",140,78,62,13,R00 - R99
Peten,Otras causas,762,413,349,13,Otras causas
Izabal,Todas las causas,1948,1164,784,13,Todas las causas
Izabal,"Agresión con disparo de otras armas de fuego, y las no especificadas",214,185,29,13,X95
Izabal,Infarto agudo del miocardio,179,105,74,13,I21
Izabal,"Diabetes mellitus, no especificada",116,34,82,13,E14
Izabal,"Neumonía, organismo no especificado",102,59,43,13,J18
Izabal,"Accidente de vehículo de motor o sin motor, tipo de vehículo no especificado",90,77,13,13,V89
Izabal,"Accidente vascular encefálico agudo, no especificado como hemorrágico o isquémico",55,30,25,13,I64
Izabal,Diarrea y gastroenteritis de presunto origen infeccioso,54,29,25,13,A09
Izabal,Fibrosis y cirrosis del hígado,50,28,22,13,K74
Izabal,Exposición a factores no especificados,50,35,15,13,X59
Izabal,Insuficiencia cardíaca,37,19,18,13,I50
Izabal,Tumor maligno del estómago,36,15,21,13,C16
Izabal,Insuficiencia renal no especificada,36,22,14,13,N19
Izabal,Otras enfermedades del sistema digestivo,30,18,12,13,K92
Izabal,Otras septicemias,28,17,11,13,A41
Izabal,Tumor maligno del hígado y de las vías biliares intrahepáticas,24,11,13,13,C22
Izabal,"Síntomas, signos y hallazgos anormales clínicos y de laboratorio, no clasificados en otra parte",165,83,82,13,R00 - R99
Izabal,Otras causas,682,397,285,13,Otras causas
Zacapa,Todas las causas,1391,773,618,13,Todas las causas
Zacapa,Infarto agudo del miocardio,229,114,115,13,I21
Zacapa,"Agresión con disparo de otras armas de fuego, y las no especificadas",134,118,16,13,X95
Zacapa,"Diabetes mellitus, no especificada",75,24,51,13,E14
Zacapa,Exposición a factores no especificados,62,46,16,13,X59
Zacapa,"Neumonía, organismo no especificado",60,31,29,13,J18
Zacapa,"Accidente vascular encefálico agudo, no especificado como hemorrágico o isquémico",47,17,30,13,I64
Zacapa,"Accidente de vehículo de motor o sin motor, tipo de vehículo no especificado",37,31,6,13,V89
Zacapa,Tumor maligno del estómago,36,17,19,13,C16
Zacapa,Insuficiencia renal crónica,33,14,19,13,N18
Zacapa,Insuficiencia cardíaca,30,15,15,13,I50
Zacapa,Otras enfermedades cerebrovasculares,28,14,14,13,I67
Zacapa,Tumor maligno del hígado y de las vías biliares intrahepáticas,27,7,20,13,C22
Zacapa,Diabetes mellitus no insulinodependiente,27,6,21,13,E11
Zacapa,Fibrosis y cirrosis del hígado,21,16,5,13,K74
Zacapa,Otras enfermedades pulmonares obstructivas crónicas,19,10,9,13,J44
Zacapa,"Síntomas, signos y hallazgos anormales clínicos y de laboratorio, no clasificados en otra parte",22,17,5,13,R00 - R99
Zacapa,Otras causas,504,276,228,13,Otras causas
Chiquimula,Todas las causas,2095,1178,917,13,Todas las causas
Chiquimula,"Neumonía, organismo no especificado",217,110,107,13,J18
Chiquimula,Infarto agudo del miocardio,208,116,92,13,I21
Chiquimula,"Disparo de otras armas de fuego, y las no especificadas",181,162,19,13,W34
Chiquimula,Insuficiencia cardíaca,118,50,68,13,I50
Chiquimula,"Diabetes mellitus, no especificada",92,27,65,13,E14
Chiquimula,Exposición a factores no especificados,74,62,12,13,X59
Chiquimula,"Accidente vascular encefálico agudo, no especificado como hemorrágico o isquémico",67,28,39,13,I64
Chiquimula,Tumor maligno del estómago,58,28,30,13,C16
Chiquimula,"Contacto traumático con cuchillo, espada, daga o puñal",45,40,5,13,W26
Chiquimula,Diarrea y gastroenteritis de presunto origen infeccioso,41,21,20,13,A09
Chiquimula,Fibrosis y cirrosis del hígado,35,19,16,13,K74
Chiquimula,"Agresión con disparo de otras armas de fuego, y las no especificadas",33,32,1,13,X95
Chiquimula,Otras septicemias,31,15,16,13,A41
Chiquimula,Tumor maligno del hígado y de las vías biliares intrahepáticas,31,17,14,13,C22
Chiquimula,"Accidente de vehículo de motor o sin motor, tipo de vehículo no especificado",28,24,4,13,V89
Chiquimula,"Síntomas, signos y hallazgos anormales clínicos y de laboratorio, no clasificados en otra parte",87,40,47,13,R00 - R99
Chiquimula,Otras causas,749,387,362,13,Otras causas
Jalapa,Todas las causas,1714,961,753,13,Todas las causas
Jalapa,"Neumonía, organismo no especificado",216,122,94,13,J18
Jalapa,Infarto agudo del miocardio,197,110,87,13,I21
Jalapa,"Accidente vascular encefálico agudo, no especificado como hemorrágico o isquémico",125,59,66,13,I64
Jalapa,"Diabetes mellitus, no especificada",79,28,51,13,E14
Jalapa,"Agresión con disparo de otras armas de fuego, y las no especificadas",74,66,8,13,X95
Jalapa,Diarrea y gastroenteritis de presunto origen infeccioso,51,27,24,13,A09
Jalapa,"Disparo de otras armas de fuego, y las no especificadas",48,41,7,13,W34
Jalapa,Exposición a factores no especificados,46,43,3,13,X59
Jalapa,Tumor maligno del estómago,45,23,22,13,C16
Jalapa,Insuficiencia cardíaca,44,22,22,13,I50
Jalapa,Otras enfermedades pulmonares obstructivas crónicas,44,23,21,13,J44
Jalapa,Fibrosis y cirrosis del hígado,32,18,14,13,K74
Jalapa,Insuficiencia renal crónica,29,20,9,13,N18
Jalapa,Tumor maligno del hígado y de las vías biliares intrahepáticas,27,8,19,13,C22
Jalapa,Úlcera gástrica,24,9,15,13,K25
Jalapa,"Síntomas, signos y hallazgos anormales clínicos y de laboratorio, no clasificados en otra parte",73,36,37,13,R00 - R99
Jalapa,Otras causas,560,306,254,13,Otras causas
Jutiapa,Todas las causas,2608,1520,1088,13,Todas las causas
Jutiapa,Infarto agudo del miocardio,357,209,148,13,I21
Jutiapa,"Agresión con disparo de otras armas de fuego, y las no especificadas",218,189,29,13,X95
Jutiapa,"Diabetes mellitus, no especificada",150,54,96,13,E14
Jutiapa,"Neumonía, organismo no especificado",125,59,66,13,J18
Jutiapa,"Accidente vascular encefálico agudo, no especificado como hemorrágico o isquémico",124,57,67,13,I64
Jutiapa,Insuficiencia cardíaca,108,53,55,13,I50
Jutiapa,"Accidente de vehículo de motor o sin motor, tipo de vehículo no especificado",83,72,11,13,V89
Jutiapa,Tumor maligno del estómago,74,42,32,13,C16
Jutiapa,Exposición a factores no especificados,68,55,13,13,X59
Jutiapa,Otras enfermedades cerebrovasculares,61,28,33,13,I67
Jutiapa,Insuficiencia renal crónica,59,30,29,13,N18
Jutiapa,Fibrosis y cirrosis del hígado,52,38,14,13,K74
Jutiapa,Diabetes mellitus no insulinodependiente,51,19,32,13,E11
Jutiapa,Tumor maligno del hígado y de las vías biliares intrahepáticas,41,19,22,13,C22
Jutiapa,Hipertensión esencial (primaria),41,20,21,13,I10
Jutiapa,"Síntomas, signos y hallazgos anormales clínicos y de laboratorio, no clasificados en otra parte",84,45,39,13,R00 - R99
Jutiapa,Otras causas,912,531,381,13,Otras causas
Extranjero,Todas las causas,129,87,42,13,Todas las causas
Extranjero,"Agresión con disparo de otras armas de fuego, y las no especificadas",22,19,3,13,X95
Extranjero,Exposición a factores no especificados,18,16,2,13,X59
Extranjero,"Disparo de otras armas de fuego, y las no especificadas",10,7,3,13,W34
Extranjero,"Accidente de vehículo de motor o sin motor, tipo de vehículo no especificado",9,7,2,13,V89
Extranjero,Infarto agudo del miocardio,5,4,1,13,I21
Extranjero,"Diabetes mellitus, no especificada",4,1,3,13,E14
Extranjero,Agresión con objeto cortante,4,2,2,13,X99
Extranjero,Edema pulmonar,3,1,2,13,J81
Extranjero,"Envenenamiento accidental por, y exposición a otros productos químicos y sustancias nocivas, y los no especificados",3,0,3,13,X49
Extranjero,"Agresión por ahorcamiento, estrangulamiento y sofocación",3,2,1,13,X91
Extranjero,"Enfermedad por virus de la inmunodeficiencia humana [VIH], sin otra especificación",2,2,0,13,B24
Extranjero,Tumor maligno del hígado y de las vías biliares intrahepáticas,2,1,1,13,C22
Extranjero,Fibrosis y cirrosis del hígado,2,1,1,13,K74
Extranjero,Ahogamiento y sumersión no especificados,2,2,0,13,W74
Extranjero,Agresión por medios no especificados,2,1,1,13,Y09
Extranjero,"Síntomas, signos y hallazgos anormales clínicos y de laboratorio, no clasificados en otra parte",4,2,2,13,R00 - R99
Extranjero,Otras causas,34,19,15,13,Otras causas
Ignorado,Todas las causas,6663,3933,2730,13,Todas las causas
Ignorado,"Neumonía, organismo no especificado",1397,751,646,13,J18
Ignorado,Diarrea y gastroenteritis de presunto origen infeccioso,564,290,274,13,A09
Ignorado,"Agresión con disparo de otras armas de fuego, y las no especificadas",318,273,45,13,X95
Ignorado,Exposición a factores no especificados,288,222,66,13,X59
Ignorado,Dificultad respiratoria del recién nacido,222,132,90,13,P22
Ignorado,Sepsis bacteriana del recién nacido,221,131,90,13,P36
Ignorado,Neumonía congénita,188,103,85,13,P23
Ignorado,Síndromes de aspiración neonatal,177,90,87,13,P24
Ignorado,Otras septicemias,132,78,54,13,A41
Ignorado,Otras malformaciones congénitas del corazón,119,62,57,13,Q24
Ignorado,"Otras malformaciones congénitas, no clasificadas en otra parte",119,57,62,13,Q89
Ignorado,"Desnutrición proteicocalórica, no especificada",101,53,48,13,E46
Ignorado,Asfixia del nacimiento,94,58,36,13,P21
Ignorado,Obstrucción no especificada de la respiración,89,55,34,13,W84
Ignorado,"Disparo de otras armas de fuego, y las no especificadas",84,70,14,13,W34
Ignorado,"Síntomas, signos y hallazgos anormales clínicos y de laboratorio, no clasificados en otra parte",473,279,194,13,R00 - R99
Ignorado,Otras causas,2077,1229,848,13,Otras causas
Todos los departamentos,Todas las causas,77807,43810,33997,14,Todas las causas
Todos los departamentos,"Neumonía, organismo no especificado",6898,3649,3249,14,J18
Todos los departamentos,Infarto agudo del miocardio,5432,2917,2515,14,I21
Todos los departamentos,"Diabetes mellitus, no especificada",4349,1811,2538,14,E14
Todos los departamentos,"Agresión con disparo de otras armas de fuego, y las no especificadas",3397,3005,392,14,X95
Todos los departamentos,Exposición a factores no especificados,2909,2330,579,14,X59
Todos los departamentos,Fibrosis y cirrosis del hígado,2159,1392,767,14,K74
Todos los departamentos,Diarrea y gastroenteritis de presunto origen infeccioso,2156,1142,1014,14,A09
Todos los departamentos,"Accidente vascular encefálico agudo, no especificado como hemorrágico o isquémico",1952,987,965,14,I64
Todos los departamentos,Diabetes mellitus no insulinodependiente,1505,593,912,14,E11
Todos los departamentos,Insuficiencia cardíaca,1501,693,808,14,I50
Todos los departamentos,Tumor maligno del estómago,1426,617,809,14,C16
Todos los departamentos,Tumor maligno del hígado y de las vías biliares intrahepáticas,1337,589,748,14,C22
Todos los departamentos,Insuficiencia renal crónica,1270,714,556,14,N18
Todos los departamentos,"Desnutrición proteicocalórica, no especificada",1255,574,681,14,E46
Todos los departamentos,"Accidente de vehículo de motor o sin motor, tipo de vehículo no especificado",1247,1030,217,14,V89
Todos los departamentos,"Síntomas, signos y hallazgos anormales clínicos y de laboratorio, no clasificados en otra parte",5010,2533,2477,14,R00 - R99
Todos los departamentos,Otras causas,34004,19234,14770,14,Otras causas
Guatemala,Todas las causas,18123,9920,8203,14,Todas las causas
Guatemala,"Diabetes mellitus, no especificada",1284,559,725,14,E14
Guatemala,Infarto agudo del miocardio,1284,636,648,14,I21
Guatemala,"Agresión con disparo de otras armas de fuego, y las no especificadas",1115,963,152,14,X95
Guatemala,Exposición a factores no especificados,800,627,173,14,X59
Guatemala,"Neumonía, organismo no especificado",709,352,357,14,J18
Guatemala,Fibrosis y cirrosis del hígado,690,469,221,14,K74
Guatemala,Diabetes mellitus no insulinodependiente,467,195,272,14,E11
Guatemala,Insuficiencia renal crónica,379,193,186,14,N18
Guatemala,Tumor maligno del hígado y de las vías biliares intrahepáticas,349,160,189,14,C22
Guatemala,"Desnutrición proteicocalórica, no especificada",336,137,199,14,E46
Guatemala,"Disparo de otras armas de fuego, y las no especificadas",330,287,43,14,W34
Guatemala,Insuficiencia cardíaca,315,128,187,14,I50
Guatemala,Tumor maligno del estómago,298,125,173,14,C16
Guatemala,"Accidente vascular encefálico agudo, no especificado como hemorrágico o isquémico",298,154,144,14,I64
Guatemala,Otras septicemias,296,134,162,14,A41
Guatemala,"Síntomas, signos y hallazgos anormales clínicos y de laboratorio, no clasificados en otra parte",1164,524,640,14,R00 - R99
Guatemala,Otras causas,8009,4277,3732,14,Otras causas
El Progreso,Todas las causas,1004,565,439,14,Todas las causas
El Progreso,Infarto agudo del miocardio,179,94,85,14,I21
El Progreso,"Diabetes mellitus, no especificada",70,25,45,14,E14
El Progreso,"Agresión con disparo de otras armas de fuego, y las no especificadas",51,45,6,14,X95
El Progreso,"Accidente vascular encefálico agudo, no especificado como hemorrágico o isquémico",50,30,20,14,I64
El Progreso,"Neumonía, organismo no especificado",44,26,18,14,J18
El Progreso,Tumor maligno del estómago,29,12,17,14,C16
El Progreso,"Accidente de vehículo de motor o sin motor, tipo de vehículo no especificado",29,23,6,14,V89
El Progreso,Tumor maligno del hígado y de las vías biliares intrahepáticas,28,16,12,14,C22
El Progreso,Exposición a factores no especificados,27,24,3,14,X59
El Progreso,Diabetes mellitus no insulinodependiente,21,3,18,14,E11
El Progreso,Otras enfermedades pulmonares obstructivas crónicas,21,10,11,14,J44
El Progreso,Fibrosis y cirrosis del hígado,18,16,2,14,K74
El Progreso,Insuficiencia renal crónica,16,9,7,14,N18
El Progreso,Otras enfermedades cerebrovasculares,15,7,8,14,I67
El Progreso,Otras septicemias,13,6,7,14,A41
El Progreso,"Síntomas, signos y hallazgos anormales clínicos y de laboratorio, no clasificados en otra parte",24,15,9,14,R00 - R99
El Progreso,Otras causas,369,204,165,14,Otras causas
Sacatepequez,Todas las causas,1546,875,671,14,Todas las causas
Sacatepequez,"Neumonía, organismo no especificado",143,74,69,14,J18
Sacatepequez,"Diabetes mellitus, no especificada",116,49,67,14,E14
Sacatepequez,Infarto agudo del miocardio,84,46,38,14,I21
Sacatepequez,Exposición a factores no especificados,82,65,17,14,X59
Sacatepequez,Diabetes mellitus no insulinodependiente,72,32,40,14,E11
Sacatepequez,"Accidente vascular encefálico agudo, no especificado como hemorrágico o isquémico",55,30,25,14,I64
Sacatepequez,Enfermedad alcohólica del hígado,53,43,10,14,K70
Sacatepequez,Fibrosis y cirrosis del hígado,45,30,15,14,K74
Sacatepequez,"Desnutrición proteicocalórica, no especificada",42,18,24,14,E46
Sacatepequez,Tumor maligno del estómago,35,15,20,14,C16
Sacatepequez,Tumor maligno del hígado y de las vías biliares intrahepáticas,33,8,25,14,C22
Sacatepequez,"Agresión con disparo de otras armas de fuego, y las no especificadas",27,25,2,14,X95
Sacatepequez,Trastornos mentales y del comportamiento debidos al uso de alcohol,21,21,0,14,F10
Sacatepequez,Hipertensión esencial (primaria),21,9,12,14,I10
Sacatepequez,Insuficiencia cardíaca,21,9,12,14,I50
Sacatepequez,"Síntomas, signos y hallazgos anormales clínicos y de laboratorio, no clasificados en otra parte",86,44,42,14,R00 - R99
Sacatepequez,Otras causas,610,357,253,14,Otras causas
Chimaltenango,Todas las causas,2642,1483,1159,14,Todas las causas
Chimaltenango,"Neumonía, organismo no especificado",314,167,147,14,J18
Chimaltenango,Infarto agudo del miocardio,172,86,86,14,I21
Chimaltenango,"Diabetes mellitus, no especificada",151,54,97,14,E14
Chimaltenango,Enfermedad alcohólica del hígado,99,86,13,14,K70
Chimaltenango,Exposición a factores no especificados,99,87,12,14,X59
Chimaltenango,Insuficiencia cardíaca,98,35,63,14,I50
Chimaltenango,Fibrosis y cirrosis del hígado,90,52,38,14,K74
Chimaltenango,Tumor maligno del estómago,71,27,44,14,C16
Chimaltenango,"Accidente vascular encefálico agudo, no especificado como hemorrágico o isquémico",69,41,28,14,I64
Chimaltenango,Otras enfermedades pulmonares obstructivas crónicas,69,39,30,14,J44
Chimaltenango,Diabetes mellitus no insulinodependiente,58,24,34,14,E11
Chimaltenango,"Agresión con disparo de otras armas de fuego, y las no especificadas",57,46,11,14,X95
Chimaltenango,Tumor maligno del hígado y de las vías biliares intrahepáticas,55,27,28,14,C22
Chimaltenango,"Accidente de vehículo de motor o sin motor, tipo de vehículo no especificado",50,44,6,14,V89
Chimaltenango,Insuficiencia renal crónica,46,22,24,14,N18
Chimaltenango,"Síntomas, signos y hallazgos anormales clínicos y de laboratorio, no clasificados en otra parte",98,63,35,14,R00 - R99
Chimaltenango,Otras causas,1046,583,463,14,Otras causas
Escuintla,Todas las causas,4245,2545,1700,14,Todas las causas
Escuintla,"Agresión con disparo de otras armas de fuego, y las no especificadas",339,302,37,14,X95
Escuintla,Infarto agudo del miocardio,309,165,144,14,I21
Escuintla,"Diabetes mellitus, no especificada",298,121,177,14,E14
Escuintla,"Neumonía, organismo no especificado",226,132,94,14,J18
Escuintla,Exposición a factores no especificados,188,151,37,14,X59
Escuintla,Insuficiencia renal crónica,152,85,67,14,N18
Escuintla,Diabetes mellitus no insulinodependiente,117,45,72,14,E11
Escuintla,Fibrosis y cirrosis del hígado,116,79,37,14,K74
Escuintla,"Accidente vascular encefálico agudo, no especificado como hemorrágico o isquémico",103,54,49,14,I64
Escuintla,Tumor maligno del hígado y de las vías biliares intrahepáticas,100,32,68,14,C22
Escuintla,"Accidente de vehículo de motor o sin motor, tipo de vehículo no especificado",94,86,8,14,V89
Escuintla,"Desnutrición proteicocalórica, no especificada",76,41,35,14,E46
Escuintla,Tumor maligno del estómago,74,38,36,14,C16
Escuintla,Insuficiencia renal no especificada,62,37,25,14,N19
Escuintla,Otras septicemias,55,30,25,14,A41
Escuintla,"Síntomas, signos y hallazgos anormales clínicos y de laboratorio, no clasificados en otra parte",306,172,134,14,R00 - R99
Escuintla,Otras causas,1630,975,655,14,Otras causas
Santa Rosa,Todas las causas,2061,1253,808,14,Todas las causas
Santa Rosa,Infarto agudo del miocardio,189,100,89,14,I21
Santa Rosa,"Agresión con disparo de otras armas de fuego, y las no especificadas",128,114,14,14,X95
Santa Rosa,"Diabetes mellitus, no especificada",101,42,59,14,E14
Santa Rosa,"Neumonía, organismo no especificado",87,51,36,14,J18
Santa Rosa,"Accidente de vehículo de motor o sin motor, tipo de vehículo no especificado",81,75,6,14,V89
Santa Rosa,Insuficiencia cardíaca,78,43,35,14,I50
Santa Rosa,"Accidente vascular encefálico agudo, no especificado como hemorrágico o isquémico",71,34,37,14,I64
Santa Rosa,Exposición a factores no especificados,64,52,12,14,X59
Santa Rosa,Otras septicemias,49,24,25,14,A41
Santa Rosa,Insuficiencia renal crónica,40,24,16,14,N18
Santa Rosa,Insuficiencia renal no especificada,39,29,10,14,N19
Santa Rosa,Fibrosis y cirrosis del hígado,37,23,14,14,K74
Santa Rosa,Tumor maligno del estómago,36,21,15,14,C16
Santa Rosa,Otras enfermedades cerebrovasculares,33,14,19,14,I67
Santa Rosa,Diabetes mellitus no insulinodependiente,32,16,16,14,E11
Santa Rosa,"Síntomas, signos y hallazgos anormales clínicos y de laboratorio, no clasificados en otra parte",125,77,48,14,R00 - R99
Santa Rosa,Otras causas,871,514,357,14,Otras causas
Solola,Todas las causas,1683,925,758,14,Todas las causas
Solola,"Neumonía, organismo no especificado",292,154,138,14,J18
Solola,"Diabetes mellitus, no especificada",91,45,46,14,E14
Solola,Exposición a factores no especificados,67,51,16,14,X59
Solola,Fibrosis y cirrosis del hígado,60,35,25,14,K74
Solola,Diarrea y gastroenteritis de presunto origen infeccioso,54,27,27,14,A09
Solola,Infarto agudo del miocardio,54,26,28,14,I21
Solola,"Desnutrición proteicocalórica, no especificada",48,18,30,14,E46
Solola,"Envenenamiento accidental por, y exposición al alcohol",43,38,5,14,X45
Solola,"Accidente vascular encefálico agudo, no especificado como hemorrágico o isquémico",40,23,17,14,I64
Solola,Otras septicemias,36,10,26,14,A41
Solola,Enfermedad alcohólica del hígado,34,31,3,14,K70
Solola,Tumor maligno del estómago,28,11,17,14,C16
Solola,Diabetes mellitus no insulinodependiente,27,13,14,14,E11
Solola,Insuficiencia cardíaca,26,8,18,14,I50
Solola,Insuficiencia renal no especificada,24,10,14,14,N19
Solola,"Síntomas, signos y hallazgos anormales clínicos y de laboratorio, no clasificados en otra parte",215,108,107,14,R00 - R99
Solola,Otras causas,544,317,227,14,Otras causas
Totonicapan,Todas las causas,2067,1124,943,14,Todas las causas
Totonicapan,"Neumonía, organismo no especificado",376,217,159,14,J18
Totonicapan,"Diabetes mellitus, no especificada",112,54,58,14,E14
Totonicapan,Infarto agudo del miocardio,109,55,54,14,I21
Totonicapan,Diarrea y gastroenteritis de presunto origen infeccioso,97,47,50,14,A09
Totonicapan,"Envenenamiento accidental por, y exposición al alcohol",96,88,8,14,X45
Totonicapan,Fibrosis y cirrosis del hígado,80,51,29,14,K74
Totonicapan,Exposición a factores no especificados,52,35,17,14,X59
Totonicapan,Enfermedad alcohólica del hígado,51,41,10,14,K70
Totonicapan,Diabetes mellitus no insulinodependiente,33,17,16,14,E11
Totonicapan,Insuficiencia cardíaca,32,14,18,14,I50
Totonicapan,Insuficiencia renal crónica,26,9,17,14,N18
Totonicapan,Hipertensión esencial (primaria),25,15,10,14,I10
Totonicapan,"Accidente vascular encefálico agudo, no especificado como hemorrágico o isquémico",25,12,13,14,I64
Totonicapan,Tumor maligno del hígado y de las vías biliares intrahepáticas,24,8,16,14,C22
Totonicapan,Tumor maligno del estómago,22,6,16,14,C16
Totonicapan,"Síntomas, signos y hallazgos anormales clínicos y de laboratorio, no clasificados en otra parte",298,130,168,14,R00 - R99
Totonicapan,Otras causas,609,325,284,14,Otras causas
Quetzaltenango,Todas las causas,3940,2159,1781,14,Todas las causas
Quetzaltenango,"Diabetes mellitus, no especificada",333,142,191,14,E14
Quetzaltenango,"Neumonía, organismo no especificado",243,118,125,14,J18
Quetzaltenango,Infarto agudo del miocardio,214,121,93,14,I21
Quetzaltenango,Exposición a factores no especificados,140,109,31,14,X59
Quetzaltenango,Enfermedad alcohólica del hígado,139,110,29,14,K70
Quetzaltenango,Insuficiencia cardíaca,121,53,68,14,I50
Quetzaltenango,"Accidente vascular encefálico agudo, no especificado como hemorrágico o isquémico",111,50,61,14,I64
Quetzaltenango,Diabetes mellitus no insulinodependiente,109,45,64,14,E11
Quetzaltenango,"Envenenamiento accidental por, y exposición al alcohol",103,88,15,14,X45
Quetzaltenango,Fibrosis y cirrosis del hígado,90,62,28,14,K74
Quetzaltenango,"Agresión con disparo de otras armas de fuego, y las no especificadas",89,76,13,14,X95
Quetzaltenango,Tumor maligno del hígado y de las vías biliares intrahepáticas,76,37,39,14,C22
Quetzaltenango,"Desnutrición proteicocalórica, no especificada",75,34,41,14,E46
Quetzaltenango,"Accidente de vehículo de motor o sin motor, tipo de vehículo no especificado",72,54,18,14,V89
Quetzaltenango,Tumor maligno del estómago,71,25,46,14,C16
Quetzaltenango,"Síntomas, signos y hallazgos anormales clínicos y de laboratorio, no clasificados en otra parte",118,58,60,14,R00 - R99
Quetzaltenango,Otras causas,1836,977,859,14,Otras causas
Suchitepequez,Todas las causas,2792,1644,1148,14,Todas las causas
Suchitepequez,"Diabetes mellitus, no especificada",186,72,114,14,E14
Suchitepequez,"Neumonía, organismo no especificado",184,96,88,14,J18
Suchitepequez,Infarto agudo del miocardio,139,72,67,14,I21
Suchitepequez,Exposición a factores no especificados,121,110,11,14,X59
Suchitepequez,Insuficiencia renal crónica,92,67,25,14,N18
Suchitepequez,Fibrosis y cirrosis del hígado,82,55,27,14,K74
Suchitepequez,"Disparo de otras armas de fuego, y las no especificadas",64,57,7,14,W34
Suchitepequez,"Desnutrición proteicocalórica, no especificada",62,34,28,14,E46
Suchitepequez,Insuficiencia renal no especificada,57,37,20,14,N19
Suchitepequez,"Agresión con disparo de otras armas de fuego, y las no especificadas",55,52,3,14,X95
Suchitepequez,Diabetes mellitus no insulinodependiente,53,29,24,14,E11
Suchitepequez,Tumor maligno del hígado y de las vías biliares intrahepáticas,43,19,24,14,C22
Suchitepequez,Insuficiencia cardíaca,40,24,16,14,I50
Suchitepequez,"Accidente vascular encefálico agudo, no especificado como hemorrágico o isquémico",38,24,14,14,I64
Suchitepequez,Tumor maligno del estómago,37,16,21,14,C16
Suchitepequez,"Síntomas, signos y hallazgos anormales clínicos y de laboratorio, no clasificados en otra parte",559,288,271,14,R00 - R99
Suchitepequez,Otras causas,980,592,388,14,Otras causas
Retalhuleu,Todas las causas,1729,974,755,14,Todas las causas
Retalhuleu,"Diabetes mellitus, no especificada",163,58,105,14,E14
Retalhuleu,Infarto agudo del miocardio,112,71,41,14,I21
Retalhuleu,"Neumonía, organismo no especificado",92,54,38,14,J18
Retalhuleu,Insuficiencia cardíaca,81,37,44,14,I50
Retalhuleu,"Agresión con disparo de otras armas de fuego, y las no especificadas",74,67,7,14,X95
Retalhuleu,Fibrosis y cirrosis del hígado,67,29,38,14,K74
Retalhuleu,Insuficiencia renal no especificada,63,36,27,14,N19
Retalhuleu,Exposición a factores no especificados,60,48,12,14,X59
Retalhuleu,Insuficiencia renal crónica,54,38,16,14,N18
Retalhuleu,"Accidente vascular encefálico agudo, no especificado como hemorrágico o isquémico",51,23,28,14,I64
Retalhuleu,Tumor maligno del hígado y de las vías biliares intrahepáticas,35,16,19,14,C22
Retalhuleu,"Accidente de vehículo de motor o sin motor, tipo de vehículo no especificado",35,30,5,14,V89
Retalhuleu,Tumor maligno del estómago,30,10,20,14,C16
Retalhuleu,Diarrea y gastroenteritis de presunto origen infeccioso,27,14,13,14,A09
Retalhuleu,Otras septicemias,26,15,11,14,A41
Retalhuleu,"Síntomas, signos y hallazgos anormales clínicos y de laboratorio, no clasificados en otra parte",84,42,42,14,R00 - R99
Retalhuleu,Otras causas,675,386,289,14,Otras causas
San Marcos,Todas las causas,4362,2477,1885,14,Todas las causas
San Marcos,"Neumonía, organismo no especificado",567,313,254,14,J18
San Marcos,Infarto agudo del miocardio,370,213,157,14,I21
San Marcos,"Diabetes mellitus, no especificada",187,68,119,14,E14
San Marcos,Exposición a factores no especificados,161,133,28,14,X59
San Marcos,Fibrosis y cirrosis del hígado,155,108,47,14,K74
San Marcos,Diarrea y gastroenteritis de presunto origen infeccioso,138,88,50,14,A09
San Marcos,"Accidente vascular encefálico agudo, no especificado como hemorrágico o isquémico",138,70,68,14,I64
San Marcos,Insuficiencia cardíaca,110,55,55,14,I50
San Marcos,"Agresión con disparo de otras armas de fuego, y las no especificadas",104,97,7,14,X95
San Marcos,Tumor maligno del estómago,96,42,54,14,C16
San Marcos,Tumor maligno del hígado y de las vías biliares intrahepáticas,91,43,48,14,C22
San Marcos,Diabetes mellitus no insulinodependiente,86,25,61,14,E11
San Marcos,Úlcera gástrica,85,34,51,14,K25
San Marcos,"Desnutrición proteicocalórica, no especificada",77,40,37,14,E46
San Marcos,Insuficiencia renal crónica,67,39,28,14,N18
San Marcos,"Síntomas, signos y hallazgos anormales clínicos y de laboratorio, no clasificados en otra parte",264,134,130,14,R00 - R99
San Marcos,Otras causas,1666,975,691,14,Otras causas
Huehuetenango,Todas las causas,3949,2163,1786,14,Todas las causas
Huehuetenango,"Neumonía, organismo no especificado",600,314,286,14,J18
Huehuetenango,Infarto agudo del miocardio,234,132,102,14,I21
Huehuetenango,"Diabetes mellitus, no especificada",229,108,121,14,E14
Huehuetenango,Diarrea y gastroenteritis de presunto origen infeccioso,197,115,82,14,A09
Huehuetenango,"Accidente vascular encefálico agudo, no especificado como hemorrágico o isquémico",150,81,69,14,I64
Huehuetenango,Exposición a factores no especificados,131,103,28,14,X59
Huehuetenango,Tumor maligno del estómago,121,53,68,14,C16
Huehuetenango,Fibrosis y cirrosis del hígado,111,70,41,14,K74
Huehuetenango,Insuficiencia cardíaca,102,46,56,14,I50
Huehuetenango,Tumor maligno del hígado y de las vías biliares intrahepáticas,85,34,51,14,C22
Huehuetenango,"Envenenamiento accidental por, y exposición al alcohol",84,78,6,14,X45
Huehuetenango,Insuficiencia renal crónica,66,36,30,14,N18
Huehuetenango,"Accidente de vehículo de motor o sin motor, tipo de vehículo no especificado",65,53,12,14,V89
Huehuetenango,Otras enfermedades cerebrovasculares,55,30,25,14,I67
Huehuetenango,Úlcera gástrica,55,30,25,14,K25
Huehuetenango,"Síntomas, signos y hallazgos anormales clínicos y de laboratorio, no clasificados en otra parte",191,101,90,14,R00 - R99
Huehuetenango,Otras causas,1473,779,694,14,Otras causas
Quiche,Todas las causas,3551,1928,1623,14,Todas las causas
Quiche,"Neumonía, organismo no especificado",501,268,233,14,J18
Quiche,Diarrea y gastroenteritis de presunto origen infeccioso,195,105,90,14,A09
Quiche,"Diabetes mellitus, no especificada",159,71,88,14,E14
Quiche,Infarto agudo del miocardio,152,76,76,14,I21
Quiche,Exposición a factores no especificados,95,81,14,14,X59
Quiche,Enfermedad alcohólica del hígado,76,63,13,14,K70
Quiche,Insuficiencia cardíaca,75,38,37,14,I50
Quiche,"Envenenamiento accidental por, y exposición al alcohol",73,67,6,14,X45
Quiche,Tumor maligno del estómago,72,35,37,14,C16
Quiche,Fibrosis y cirrosis del hígado,70,44,26,14,K74
Quiche,Diabetes mellitus no insulinodependiente,69,26,43,14,E11
Quiche,"Accidente vascular encefálico agudo, no especificado como hemorrágico o isquémico",61,28,33,14,I64
Quiche,"Accidente de vehículo de motor o sin motor, tipo de vehículo no especificado",55,43,12,14,V89
Quiche,"Agresión con disparo de otras armas de fuego, y las no especificadas",54,50,4,14,X95
Quiche,Otras septicemias,50,27,23,14,A41
Quiche,"Síntomas, signos y hallazgos anormales clínicos y de laboratorio, no clasificados en otra parte",450,215,235,14,R00 - R99
Quiche,Otras causas,1344,691,653,14,Otras causas
Baja Verapaz,Todas las causas,1174,612,562,14,Todas las causas
Baja Verapaz,Infarto agudo del miocardio,129,60,69,14,I21
Baja Verapaz,"Neumonía, organismo no especificado",122,68,54,14,J18
Baja Verapaz,"Accidente vascular encefálico agudo, no especificado como hemorrágico o isquémico",86,41,45,14,I64
Baja Verapaz,"Diabetes mellitus, no especificada",49,17,32,14,E14
Baja Verapaz,Exposición a factores no especificados,43,32,11,14,X59
Baja Verapaz,Tumor maligno del estómago,41,15,26,14,C16
Baja Verapaz,Diarrea y gastroenteritis de presunto origen infeccioso,38,14,24,14,A09
Baja Verapaz,"Agresión con disparo de otras armas de fuego, y las no especificadas",37,30,7,14,X95
Baja Verapaz,Hipertensión esencial (primaria),25,10,15,14,I10
Baja Verapaz,Insuficiencia cardíaca,24,12,12,14,I50
Baja Verapaz,Tumor maligno del hígado y de las vías biliares intrahepáticas,22,9,13,14,C22
Baja Verapaz,Otras enfermedades cerebrovasculares,21,10,11,14,I67
Baja Verapaz,Fibrosis y cirrosis del hígado,21,10,11,14,K74
Baja Verapaz,"Accidente de vehículo de motor o sin motor, tipo de vehículo no especificado",20,18,2,14,V89
Baja Verapaz,Úlcera gástrica,17,5,12,14,K25
Baja Verapaz,"Síntomas, signos y hallazgos anormales clínicos y de laboratorio, no clasificados en otra parte",44,18,26,14,R00 - R99
Baja Verapaz,Otras causas,435,243,192,14,Otras causas
Alta Verapaz,Todas las causas,4406,2265,2141,14,Todas las causas
Alta Verapaz,"Neumonía, organismo no especificado",724,349,375,14,J18
Alta Verapaz,Diarrea y gastroenteritis de presunto origen infeccioso,314,152,162,14,A09
Alta Verapaz,Infarto agudo del miocardio,274,132,142,14,I21
Alta Verapaz,"Desnutrición proteicocalórica, no especificada",220,101,119,14,E46
Alta Verapaz,Fibrosis y cirrosis del hígado,145,84,61,14,K74
Alta Verapaz,"Diabetes mellitus, no especificada",138,43,95,14,E14
Alta Verapaz,Exposición a factores no especificados,129,108,21,14,X59
Alta Verapaz,Otras septicemias,106,60,46,14,A41
Alta Verapaz,Tumor maligno del hígado y de las vías biliares intrahepáticas,93,46,47,14,C22
Alta Verapaz,Tumor maligno del estómago,85,29,56,14,C16
Alta Verapaz,"Accidente vascular encefálico agudo, no especificado como hemorrágico o isquémico",77,37,40,14,I64
Alta Verapaz,Úlcera gástrica,72,28,44,14,K25
Alta Verapaz,Síndromes de aspiración neonatal,63,34,29,14,P24
Alta Verapaz,Otras anemias,57,21,36,14,D64
Alta Verapaz,Dificultad respiratoria del recién nacido,55,33,22,14,P22
Alta Verapaz,"Síntomas, signos y hallazgos anormales clínicos y de laboratorio, no clasificados en otra parte",116,60,56,14,R00 - R99
Alta Verapaz,Otras causas,1738,948,790,14,Otras causas
Peten,Todas las causas,1833,1111,722,14,Todas las causas
Peten,"Agresión con disparo de otras armas de fuego, y las no especificadas",190,177,13,14,X95
Peten,Infarto agudo del miocardio,105,64,41,14,I21
Peten,"Diabetes mellitus, no especificada",88,40,48,14,E14
Peten,"Neumonía, organismo no especificado",83,48,35,14,J18
Peten,Diabetes mellitus no insulinodependiente,79,28,51,14,E11
Peten,"Accidente de vehículo de motor o sin motor, tipo de vehículo no especificado",74,61,13,14,V89
Peten,Diarrea y gastroenteritis de presunto origen infeccioso,64,34,30,14,A09
Peten,Exposición a factores no especificados,62,47,15,14,X59
Peten,Fibrosis y cirrosis del hígado,44,22,22,14,K74
Peten,Agresión con objeto cortante,39,36,3,14,X99
Peten,"Accidente vascular encefálico agudo, no especificado como hemorrágico o isquémico",38,17,21,14,I64
Peten,Tumor maligno del hígado y de las vías biliares intrahepáticas,37,18,19,14,C22
Peten,Tumor maligno del estómago,33,23,10,14,C16
Peten,Insuficiencia cardíaca,27,16,11,14,I50
Peten,"Neumonía bacteriana, no clasificada en otra parte",24,12,12,14,J15
Peten,"Síntomas, signos y hallazgos anormales clínicos y de laboratorio, no clasificados en otra parte",58,41,17,14,R00 - R99
Peten,Otras causas,788,427,361,14,Otras causas
Izabal,Todas las causas,1990,1171,819,14,Todas las causas
Izabal,Infarto agudo del miocardio,182,112,70,14,I21
Izabal,"Agresión con disparo de otras armas de fuego, y las no especificadas",145,134,11,14,X95
Izabal,"Diabetes mellitus, no especificada",120,46,74,14,E14
Izabal,"Accidente de vehículo de motor o sin motor, tipo de vehículo no especificado",94,77,17,14,V89
Izabal,"Neumonía, organismo no especificado",78,46,32,14,J18
Izabal,"Accidente vascular encefálico agudo, no especificado como hemorrágico o isquémico",66,30,36,14,I64
Izabal,Insuficiencia renal no especificada,58,30,28,14,N19
Izabal,Exposición a factores no especificados,51,41,10,14,X59
Izabal,Diarrea y gastroenteritis de presunto origen infeccioso,45,26,19,14,A09
Izabal,Diabetes mellitus no insulinodependiente,39,12,27,14,E11
Izabal,Tumor maligno del estómago,32,17,15,14,C16
Izabal,Fibrosis y cirrosis del hígado,31,16,15,14,K74
Izabal,Tumor maligno del hígado y de las vías biliares intrahepáticas,30,14,16,14,C22
Izabal,"Disparo de otras armas de fuego, y las no especificadas",30,29,1,14,W34
Izabal,Otras enfermedades del sistema digestivo,26,15,11,14,K92
Izabal,"Síntomas, signos y hallazgos anormales clínicos y de laboratorio, no clasificados en otra parte",201,121,80,14,R00 - R99
Izabal,Otras causas,762,405,357,14,Otras causas
Zacapa,Todas las causas,1400,814,586,14,Todas las causas
Zacapa,Infarto agudo del miocardio,240,134,106,14,I21
Zacapa,"Agresión con disparo de otras armas de fuego, y las no especificadas",127,115,12,14,X95
Zacapa,"Diabetes mellitus, no especificada",83,28,55,14,E14
Zacapa,"Neumonía, organismo no especificado",54,30,24,14,J18
Zacapa,"Accidente vascular encefálico agudo, no especificado como hemorrágico o isquémico",46,23,23,14,I64
Zacapa,Otras enfermedades cerebrovasculares,39,18,21,14,I67
Zacapa,Exposición a factores no especificados,39,30,9,14,X59
Zacapa,Diabetes mellitus no insulinodependiente,34,12,22,14,E11
Zacapa,"Accidente de vehículo de motor o sin motor, tipo de vehículo no especificado",31,29,2,14,V89
Zacapa,Otras enfermedades pulmonares obstructivas crónicas,30,21,9,14,J44
Zacapa,Insuficiencia cardíaca,29,15,14,14,I50
Zacapa,Tumor maligno del hígado y de las vías biliares intrahepáticas,27,16,11,14,C22
Zacapa,Tumor maligno del estómago,25,11,14,14,C16
Zacapa,Fibrosis y cirrosis del hígado,25,15,10,14,K74
Zacapa,Insuficiencia renal crónica,18,11,7,14,N18
Zacapa,"Síntomas, signos y hallazgos anormales clínicos y de laboratorio, no clasificados en otra parte",16,12,4,14,R00 - R99
Zacapa,Otras causas,537,294,243,14,Otras causas
Chiquimula,Todas las causas,1920,1138,782,14,Todas las causas
Chiquimula,Infarto agudo del miocardio,237,145,92,14,I21
Chiquimula,"Neumonía, organismo no especificado",178,80,98,14,J18
Chiquimula,"Accidente vascular encefálico agudo, no especificado como hemorrágico o isquémico",91,47,44,14,I64
Chiquimula,Insuficiencia cardíaca,88,55,33,14,I50
Chiquimula,"Diabetes mellitus, no especificada",84,39,45,14,E14
Chiquimula,"Agresión con disparo de otras armas de fuego, y las no especificadas",81,78,3,14,X95
Chiquimula,"Disparo de otras armas de fuego, y las no especificadas",71,65,6,14,W34
Chiquimula,Tumor maligno del estómago,64,27,37,14,C16
Chiquimula,Exposición a factores no especificados,61,55,6,14,X59
Chiquimula,Fibrosis y cirrosis del hígado,57,37,20,14,K74
Chiquimula,Insuficiencia renal crónica,27,18,9,14,N18
Chiquimula,Tumor maligno del hígado y de las vías biliares intrahepáticas,26,11,15,14,C22
Chiquimula,Tumor maligno de la próstata,26,26,0,14,C61
Chiquimula,Otras septicemias,25,14,11,14,A41
Chiquimula,Otras enfermedades cerebrovasculares,25,12,13,14,I67
Chiquimula,"Síntomas, signos y hallazgos anormales clínicos y de laboratorio, no clasificados en otra parte",59,28,31,14,R00 - R99
Chiquimula,Otras causas,720,401,319,14,Otras causas
Jalapa,Todas las causas,1611,913,698,14,Todas las causas
Jalapa,Infarto agudo del miocardio,173,101,72,14,I21
Jalapa,"Neumonía, organismo no especificado",145,78,67,14,J18
Jalapa,"Accidente vascular encefálico agudo, no especificado como hemorrágico o isquémico",133,62,71,14,I64
Jalapa,"Diabetes mellitus, no especificada",70,29,41,14,E14
Jalapa,Diarrea y gastroenteritis de presunto origen infeccioso,66,39,27,14,A09
Jalapa,"Disparo de otras armas de fuego, y las no especificadas",61,55,6,14,W34
Jalapa,"Agresión con disparo de otras armas de fuego, y las no especificadas",60,55,5,14,X95
Jalapa,Exposición a factores no especificados,46,36,10,14,X59
Jalapa,Tumor maligno del estómago,41,20,21,14,C16
Jalapa,Otras enfermedades pulmonares obstructivas crónicas,36,15,21,14,J44
Jalapa,Tumor maligno del hígado y de las vías biliares intrahepáticas,32,10,22,14,C22
Jalapa,Fibrosis y cirrosis del hígado,32,21,11,14,K74
Jalapa,Otras septicemias,29,12,17,14,A41
Jalapa,Insuficiencia renal no especificada,29,12,17,14,N19
Jalapa,Insuficiencia cardíaca,28,14,14,14,I50
Jalapa,"Síntomas, signos y hallazgos anormales clínicos y de laboratorio, no clasificados en otra parte",63,27,36,14,R00 - R99
Jalapa,Otras causas,567,327,240,14,Otras causas
Jutiapa,Todas las causas,2588,1522,1066,14,Todas las causas
Jutiapa,Infarto agudo del miocardio,417,235,182,14,I21
Jutiapa,"Diabetes mellitus, no especificada",186,80,106,14,E14
Jutiapa,"Agresión con disparo de otras armas de fuego, y las no especificadas",180,164,16,14,X95
Jutiapa,"Accidente vascular encefálico agudo, no especificado como hemorrágico o isquémico",140,70,70,14,I64
Jutiapa,"Neumonía, organismo no especificado",97,63,34,14,J18
Jutiapa,Otras enfermedades cerebrovasculares,82,40,42,14,I67
Jutiapa,Tumor maligno del estómago,78,37,41,14,C16
Jutiapa,Exposición a factores no especificados,73,64,9,14,X59
Jutiapa,"Accidente de vehículo de motor o sin motor, tipo de vehículo no especificado",69,59,10,14,V89
Jutiapa,Insuficiencia cardíaca,59,29,30,14,I50
Jutiapa,Diabetes mellitus no insulinodependiente,50,11,39,14,E11
Jutiapa,Tumor maligno del hígado y de las vías biliares intrahepáticas,45,19,26,14,C22
Jutiapa,Fibrosis y cirrosis del hígado,41,23,18,14,K74
Jutiapa,Insuficiencia renal crónica,40,22,18,14,N18
Jutiapa,Tumor maligno de la próstata,38,38,0,14,C61
Jutiapa,"Síntomas, signos y hallazgos anormales clínicos y de laboratorio, no clasificados en otra parte",68,33,35,14,R00 - R99
Jutiapa,Otras causas,925,535,390,14,Otras causas
Extranjero,Todas las causas,213,141,72,14,Todas las causas
Extranjero,"Agresión con disparo de otras armas de fuego, y las no especificadas",50,45,5,14,X95
Extranjero,Exposición a factores no especificados,20,16,4,14,X59
Extranjero,Infarto agudo del miocardio,15,5,10,14,I21
Extranjero,"Neumonía, organismo no especificado",12,9,3,14,J18
Extranjero,"Accidente de vehículo de motor o sin motor, tipo de vehículo no especificado",8,3,5,14,V89
Extranjero,"Disparo de otras armas de fuego, y las no especificadas",8,7,1,14,W34
Extranjero,Otras septicemias,5,2,3,14,A41
Extranjero,"Diabetes mellitus, no especificada",5,2,3,14,E14
Extranjero,Tumor maligno del hígado y de las vías biliares intrahepáticas,4,2,2,14,C22
Extranjero,"Desnutrición proteicocalórica, no especificada",4,3,1,14,E46
Extranjero,"Enfermedad por virus de la inmunodeficiencia humana [VIH], sin otra especificación",3,2,1,14,B24
Extranjero,Otras enfermedades cerebrovasculares,3,2,1,14,I67
Extranjero,Fibrosis y cirrosis del hígado,3,3,0,14,K74
Extranjero,Ahogamiento y sumersión no especificados,3,2,1,14,W74
Extranjero,Otros estrangulamientos y ahorcamientos accidentales,3,2,1,14,W76
Extranjero,"Síntomas, signos y hallazgos anormales clínicos y de laboratorio, no clasificados en otra parte",11,6,5,14,R00 - R99
Extranjero,Otras causas,56,30,26,14,Otras causas
Ignorado,Todas las causas,6978,4088,2890,14,Todas las causas
Ignorado,"Neumonía, organismo no especificado",1027,542,485,14,J18
Ignorado,Diarrea y gastroenteritis de presunto origen infeccioso,543,290,253,14,A09
Ignorado,Dificultad respiratoria del recién nacido,348,212,136,14,P22
Ignorado,"Agresión con disparo de otras armas de fuego, y las no especificadas",327,272,55,14,X95
Ignorado,Exposición a factores no especificados,298,225,73,14,X59
Ignorado,Sepsis bacteriana del recién nacido,258,155,103,14,P36
Ignorado,Síndromes de aspiración neonatal,233,122,111,14,P24
Ignorado,Otras septicemias,206,115,91,14,A41
Ignorado,Otras malformaciones congénitas del corazón,158,82,76,14,Q24
Ignorado,"Otras malformaciones congénitas, no clasificadas en otra parte",155,86,69,14,Q89
Ignorado,Neumonía congénita,130,71,59,14,P23
Ignorado,Asfixia del nacimiento,112,65,47,14,P21
Ignorado,"Disparo de otras armas de fuego, y las no especificadas",111,92,19,14,W34
Ignorado,"Desnutrición proteicocalórica, no especificada",86,37,49,14,E46
Ignorado,Obstrucción no especificada de la respiración,83,50,33,14,W84
Ignorado,"Síntomas, signos y hallazgos anormales clínicos y de laboratorio, no clasificados en otra parte",392,216,176,14,R00 - R99
Ignorado,Otras causas,2511,1456,1055,14,Otras causas
Todos los departamentos,Todas las causas,80876,45513,35363,15,Todas las causas
Todos los departamentos,"Neumonía, organismo no especificado",6911,3748,3163,15,J18
Todos los departamentos,Infarto agudo del miocardio,5564,2940,2624,15,I21
Todos los departamentos,"Diabetes mellitus, no especificada",4282,1743,2539,15,E14
Todos los departamentos,"Agresión con disparo de otras armas de fuego, y las no especificadas",3278,2875,403,15,X95
Todos los departamentos,Exposición a factores no especificados,3060,2477,583,15,X59
Todos los departamentos,Fibrosis y cirrosis del hígado,2371,1556,815,15,K74
Todos los departamentos,Otras gastroenteritis y colitis de origen infeccioso y no especificado,2056,1036,1020,15,A09
Todos los departamentos,"Accidente vascular encefálico agudo, no especificado como hemorrágico o isquémico",1739,853,886,15,I64
Todos los departamentos,Diabetes mellitus no insulinodependiente,1598,671,927,15,E11
Todos los departamentos,Insuficiencia cardíaca,1431,670,761,15,I50
Todos los departamentos,Tumor maligno del hígado y de las vías biliares intrahepáticas,1357,638,719,15,C22
Todos los departamentos,Enfermedad renal crónica,1357,760,597,15,N18
Todos los departamentos,Tumor maligno del estómago,1348,641,707,15,C16
Todos los departamentos,"Accidente de vehículo de motor o sin motor, tipo de vehículo no especificado",1208,1012,196,15,V89
Todos los departamentos,Enfermedad renal crónica,937,496,441,15,N19
Todos los departamentos,"Síntomas, signos y hallazgos anormales clínicos y de laboratorio, no clasificados en otra parte",7510,3862,3648,15,R00 - R99
Todos los departamentos,Otras causas,34869,19535,15334,15,Otras causas
Guatemala,Todas las causas,18734,10392,8342,15,Todas las causas
Guatemala,Infarto agudo del miocardio,1305,683,622,15,I21
Guatemala,"Diabetes mellitus, no especificada",1244,551,693,15,E14
Guatemala,"Agresión con disparo de otras armas de fuego, y las no especificadas",973,826,147,15,X95
Guatemala,Exposición a factores no especificados,886,708,178,15,X59
Guatemala,Fibrosis y cirrosis del hígado,814,590,224,15,K74
Guatemala,"Neumonía, organismo no especificado",771,436,335,15,J18
Guatemala,Diabetes mellitus no insulinodependiente,472,204,268,15,E11
Guatemala,Enfermedad renal crónica,415,228,187,15,N18
Guatemala,Tumor maligno del hígado y de las vías biliares intrahepáticas,375,197,178,15,C22
Guatemala,Tumor maligno del estómago,328,148,180,15,C16
Guatemala,Insuficiencia cardíaca,304,123,181,15,I50
Guatemala,"Accidente vascular encefálico agudo, no especificado como hemorrágico o isquémico",299,146,153,15,I64
Guatemala,"Disparo de otras armas de fuego, y las no especificadas",259,225,34,15,W34
Guatemala,Hipertensión esencial (primaria),257,102,155,15,I10
Guatemala,"Desnutrición proteicocalórica, no especificada",247,110,137,15,E46
Guatemala,"Síntomas, signos y hallazgos anormales clínicos y de laboratorio, no clasificados en otra parte",1500,720,780,15,R00 - R99
Guatemala,Otras causas,8285,4395,3890,15,Otras causas
El Progreso,Todas las causas,1088,624,464,15,Todas las causas
El Progreso,Infarto agudo del miocardio,155,93,62,15,I21
El Progreso,"Diabetes mellitus, no especificada",70,23,47,15,E14
El Progreso,"Neumonía, organismo no especificado",70,43,27,15,J18
El Progreso,"Agresión con disparo de otras armas de fuego, y las no especificadas",48,42,6,15,X95
El Progreso,"Accidente vascular encefálico agudo, no especificado como hemorrágico o isquémico",47,18,29,15,I64
El Progreso,Exposición a factores no especificados,38,32,6,15,X59
El Progreso,Tumor maligno del hígado y de las vías biliares intrahepáticas,32,15,17,15,C22
El Progreso,Tumor maligno del estómago,30,20,10,15,C16
El Progreso,Diabetes mellitus no insulinodependiente,29,13,16,15,E11
El Progreso,Fibrosis y cirrosis del hígado,29,20,9,15,K74
El Progreso,Otras enfermedades pulmonares obstructivas crónicas,25,14,11,15,J44
El Progreso,Insuficiencia cardíaca,23,14,9,15,I50
El Progreso,"Accidente de vehículo de motor o sin motor, tipo de vehículo no especificado",20,17,3,15,V89
El Progreso,Tumor maligno de la próstata,13,13,0,15,C61
El Progreso,Tumor maligno del cuello del útero,12,0,12,15,C53
El Progreso,"Síntomas, signos y hallazgos anormales clínicos y de laboratorio, no clasificados en otra parte",34,19,15,15,R00 - R99
El Progreso,Otras causas,413,228,185,15,Otras causas
Sacatepequez,Todas las causas,1594,899,695,15,Todas las causas
Sacatepequez,"Neumonía, organismo no especificado",97,67,30,15,J18
Sacatepequez,Infarto agudo del miocardio,89,51,38,15,I21
Sacatepequez,"Diabetes mellitus, no especificada",78,35,43,15,E14
Sacatepequez,Exposición a factores no especificados,74,55,19,15,X59
Sacatepequez,Diabetes mellitus no insulinodependiente,67,26,41,15,E11
Sacatepequez,Fibrosis y cirrosis del hígado,56,35,21,15,K74
Sacatepequez,"Desnutrición proteicocalórica, no especificada",54,28,26,15,E46
Sacatepequez,"Accidente vascular encefálico agudo, no especificado como hemorrágico o isquémico",47,23,24,15,I64
Sacatepequez,"Agresión con disparo de otras armas de fuego, y las no especificadas",45,40,5,15,X95
Sacatepequez,Enfermedad alcohólica del hígado,43,35,8,15,K70
Sacatepequez,Tumor maligno del hígado y de las vías biliares intrahepáticas,39,19,20,15,C22
Sacatepequez,Insuficiencia cardíaca,35,15,20,15,I50
Sacatepequez,Trastornos mentales y del comportamiento debidos al uso de alcohol,31,26,5,15,F10
Sacatepequez,Enfermedad renal crónica,28,15,13,15,N18
Sacatepequez,Tumor maligno del estómago,23,11,12,15,C16
Sacatepequez,"Síntomas, signos y hallazgos anormales clínicos y de laboratorio, no clasificados en otra parte",96,51,45,15,R00 - R99
Sacatepequez,Otras causas,692,367,325,15,Otras causas
Chimaltenango,Todas las causas,2703,1460,1243,15,Todas las causas
Chimaltenango,"Neumonía, organismo no especificado",317,166,151,15,J18
Chimaltenango,Infarto agudo del miocardio,156,75,81,15,I21
Chimaltenango,"Diabetes mellitus, no especificada",147,50,97,15,E14
Chimaltenango,Fibrosis y cirrosis del hígado,119,67,52,15,K74
Chimaltenango,Exposición a factores no especificados,110,90,20,15,X59
Chimaltenango,Enfermedad alcohólica del hígado,107,80,27,15,K70
Chimaltenango,Insuficiencia cardíaca,94,33,61,15,I50
Chimaltenango,Tumor maligno del estómago,74,26,48,15,C16
Chimaltenango,"Accidente vascular encefálico agudo, no especificado como hemorrágico o isquémico",73,34,39,15,I64
Chimaltenango,Diabetes mellitus no insulinodependiente,62,25,37,15,E11
Chimaltenango,Enfermedad renal crónica,50,21,29,15,N18
Chimaltenango,"Agresión con disparo de otras armas de fuego, y las no especificadas",50,39,11,15,X95
Chimaltenango,Tumor maligno del hígado y de las vías biliares intrahepáticas,49,18,31,15,C22
Chimaltenango,Trastornos mentales y del comportamiento debidos al uso de alcohol,45,41,4,15,F10
Chimaltenango,Otras enfermedades pulmonares obstructivas crónicas,42,26,16,15,J44
Chimaltenango,"Síntomas, signos y hallazgos anormales clínicos y de laboratorio, no clasificados en otra parte",143,72,71,15,R00 - R99
Chimaltenango,Otras causas,1065,597,468,15,Otras causas
Escuintla,Todas las causas,4558,2771,1787,15,Todas las causas
Escuintla,Infarto agudo del miocardio,405,226,179,15,I21
Escuintla,"Agresión con disparo de otras armas de fuego, y las no especificadas",359,315,44,15,X95
Escuintla,"Diabetes mellitus, no especificada",355,138,217,15,E14
Escuintla,"Neumonía, organismo no especificado",287,179,108,15,J18
Escuintla,Exposición a factores no especificados,173,152,21,15,X59
Escuintla,Enfermedad renal crónica,153,89,64,15,N18
Escuintla,Fibrosis y cirrosis del hígado,135,89,46,15,K74
Escuintla,"Accidente de vehículo de motor o sin motor, tipo de vehículo no especificado",123,111,12,15,V89
Escuintla,Diabetes mellitus no insulinodependiente,92,45,47,15,E11
Escuintla,"Accidente vascular encefálico agudo, no especificado como hemorrágico o isquémico",74,36,38,15,I64
Escuintla,Tumor maligno del hígado y de las vías biliares intrahepáticas,72,30,42,15,C22
Escuintla,Agresión por medios no especificados,71,66,5,15,Y09
Escuintla,Hipertensión esencial (primaria),61,35,26,15,I10
Escuintla,"Otros trastornos de los líquidos, de los electrólitos y del equilibrio ácido-básico",60,34,26,15,E87
Escuintla,Tumor maligno del estómago,55,25,30,15,C16
Escuintla,"Síntomas, signos y hallazgos anormales clínicos y de laboratorio, no clasificados en otra parte",377,232,145,15,R00 - R99
Escuintla,Otras causas,1706,969,737,15,Otras causas
Santa Rosa,Todas las causas,2246,1298,948,15,Todas las causas
Santa Rosa,Infarto agudo del miocardio,219,122,97,15,I21
Santa Rosa,"Agresión con disparo de otras armas de fuego, y las no especificadas",137,131,6,15,X95
Santa Rosa,"Diabetes mellitus, no especificada",118,47,71,15,E14
Santa Rosa,"Neumonía, organismo no especificado",106,55,51,15,J18
Santa Rosa,Exposición a factores no especificados,83,69,14,15,X59
Santa Rosa,Insuficiencia cardíaca,67,35,32,15,I50
Santa Rosa,"Accidente vascular encefálico agudo, no especificado como hemorrágico o isquémico",62,28,34,15,I64
Santa Rosa,Enfermedad renal crónica,58,34,24,15,N18
Santa Rosa,Diabetes mellitus no insulinodependiente,55,25,30,15,E11
Santa Rosa,Fibrosis y cirrosis del hígado,53,34,19,15,K74
Santa Rosa,"Accidente de vehículo de motor o sin motor, tipo de vehículo no especificado",45,39,6,15,V89
Santa Rosa,Tumor maligno del hígado y de las vías biliares intrahepáticas,39,13,26,15,C22
Santa Rosa,Tumor maligno del estómago,36,18,18,15,C16
Santa Rosa,Tumor maligno de la próstata,32,32,0,15,C61
Santa Rosa,Otras enfermedades pulmonares obstructivas crónicas,29,22,7,15,J44
Santa Rosa,"Síntomas, signos y hallazgos anormales clínicos y de laboratorio, no clasificados en otra parte",190,98,92,15,R00 - R99
Santa Rosa,Otras causas,917,496,421,15,Otras causas
Solola,Todas las causas,1760,980,780,15,Todas las causas
Solola,"Neumonía, organismo no especificado",267,133,134,15,J18
Solola,"Diabetes mellitus, no especificada",88,38,50,15,E14
Solola,Exposición a factores no especificados,64,51,13,15,X59
Solola,Otras gastroenteritis y colitis de origen infeccioso y no especificado,54,26,28,15,A09
Solola,Infarto agudo del miocardio,51,31,20,15,I21
Solola,Fibrosis y cirrosis del hígado,51,33,18,15,K74
Solola,"Envenenamiento accidental por, y exposición al alcohol",49,48,1,15,X45
Solola,"Desnutrición proteicocalórica, no especificada",38,14,24,15,E46
Solola,"Accidente de vehículo de motor o sin motor, tipo de vehículo no especificado",37,32,5,15,V89
Solola,Otras enfermedades pulmonares obstructivas crónicas,33,17,16,15,J44
Solola,Tumor maligno del estómago,32,20,12,15,C16
Solola,Insuficiencia cardíaca,32,13,19,15,I50
Solola,Tumor maligno del hígado y de las vías biliares intrahepáticas,27,14,13,15,C22
Solola,Diabetes mellitus no insulinodependiente,25,10,15,15,E11
Solola,Trastornos mentales y del comportamiento debidos al uso de alcohol,25,22,3,15,F10
Solola,"Síntomas, signos y hallazgos anormales clínicos y de laboratorio, no clasificados en otra parte",252,118,134,15,R00 - R99
Solola,Otras causas,635,360,275,15,Otras causas
Totonicapan,Todas las causas,2305,1257,1048,15,Todas las causas
Totonicapan,"Neumonía, organismo no especificado",377,191,186,15,J18
Totonicapan,"Diabetes mellitus, no especificada",117,65,52,15,E14
Totonicapan,Otras gastroenteritis y colitis de origen infeccioso y no especificado,112,54,58,15,A09
Totonicapan,"Envenenamiento accidental por, y exposición al alcohol",86,72,14,15,X45
Totonicapan,Infarto agudo del miocardio,82,44,38,15,I21
Totonicapan,Fibrosis y cirrosis del hígado,68,45,23,15,K74
Totonicapan,Enfermedad alcohólica del hígado,59,42,17,15,K70
Totonicapan,Diabetes mellitus no insulinodependiente,55,31,24,15,E11
Totonicapan,Exposición a factores no especificados,46,36,10,15,X59
Totonicapan,"Accidente vascular encefálico agudo, no especificado como hemorrágico o isquémico",32,18,14,15,I64
Totonicapan,Insuficiencia cardíaca,31,16,15,15,I50
Totonicapan,Otras sepsis,26,11,15,15,A41
Totonicapan,Otros trastornos del encéfalo,26,10,16,15,G93
Totonicapan,Enfermedad renal crónica,24,15,9,15,N18
Totonicapan,Trastornos mentales y del comportamiento debidos al uso de alcohol,22,19,3,15,F10
Totonicapan,"Síntomas, signos y hallazgos anormales clínicos y de laboratorio, no clasificados en otra parte",433,209,224,15,R00 - R99
Totonicapan,Otras causas,709,379,330,15,Otras causas
Quetzaltenango,Todas las causas,4210,2326,1884,15,Todas las causas
Quetzaltenango,"Diabetes mellitus, no especificada",305,129,176,15,E14
Quetzaltenango,Infarto agudo del miocardio,288,148,140,15,I21
Quetzaltenango,"Neumonía, organismo no especificado",248,123,125,15,J18
Quetzaltenango,Enfermedad alcohólica del hígado,144,121,23,15,K70
Quetzaltenango,Insuficiencia cardíaca,119,60,59,15,I50
Quetzaltenango,Exposición a factores no especificados,118,93,25,15,X59
Quetzaltenango,"Agresión con disparo de otras armas de fuego, y las no especificadas",111,100,11,15,X95
Quetzaltenango,Diabetes mellitus no insulinodependiente,97,41,56,15,E11
Quetzaltenango,Fibrosis y cirrosis del hígado,93,51,42,15,K74
Quetzaltenango,"Accidente de vehículo de motor o sin motor, tipo de vehículo no especificado",92,73,19,15,V89
Quetzaltenango,"Accidente vascular encefálico agudo, no especificado como hemorrágico o isquémico",90,42,48,15,I64
Quetzaltenango,Trastornos mentales y del comportamiento debidos al uso de alcohol,78,74,4,15,F10
Quetzaltenango,"Desnutrición proteicocalórica, no especificada",73,27,46,15,E46
Quetzaltenango,"Envenenamiento accidental por, y exposición al alcohol",72,63,9,15,X45
Quetzaltenango,Enfermedad renal crónica,64,33,31,15,N18
Quetzaltenango,"Síntomas, signos y hallazgos anormales clínicos y de laboratorio, no clasificados en otra parte",233,122,111,15,R00 - R99
Quetzaltenango,Otras causas,1985,1026,959,15,Otras causas
Suchitepequez,Todas las causas,3046,1717,1329,15,Todas las causas
Suchitepequez,"Diabetes mellitus, no especificada",160,62,98,15,E14
Suchitepequez,"Neumonía, organismo no especificado",128,73,55,15,J18
Suchitepequez,Exposición a factores no especificados,125,104,21,15,X59
Suchitepequez,Infarto agudo del miocardio,101,56,45,15,I21
Suchitepequez,Enfermedad renal crónica,74,47,27,15,N19
Suchitepequez,Fibrosis y cirrosis del hígado,67,38,29,15,K74
Suchitepequez,Enfermedad renal crónica,61,44,17,15,N18
Suchitepequez,Tumor maligno del hígado y de las vías biliares intrahepáticas,55,29,26,15,C22
Suchitepequez,"Agresión con disparo de otras armas de fuego, y las no especificadas",54,52,2,15,X95
Suchitepequez,"Disparo de otras armas de fuego, y las no especificadas",50,48,2,15,W34
Suchitepequez,Otros trastornos del encéfalo,36,21,15,15,G93
Suchitepequez,"Desnutrición proteicocalórica, no especificada",30,15,15,15,E46
Suchitepequez,"Accidente de vehículo de motor o sin motor, tipo de vehículo no especificado",28,23,5,15,V89
Suchitepequez,Diabetes mellitus no insulinodependiente,27,10,17,15,E11
Suchitepequez,Otras gastroenteritis y colitis de origen infeccioso y no especificado,26,14,12,15,A09
Suchitepequez,"Síntomas, signos y hallazgos anormales clínicos y de laboratorio, no clasificados en otra parte",1163,570,593,15,R00 - R99
Suchitepequez,Otras causas,861,511,350,15,Otras causas
Retalhuleu,Todas las causas,1910,1134,776,15,Todas las causas
Retalhuleu,"Diabetes mellitus, no especificada",134,50,84,15,E14
Retalhuleu,"Neumonía, organismo no especificado",112,61,51,15,J18
Retalhuleu,Infarto agudo del miocardio,95,48,47,15,I21
Retalhuleu,"Agresión con disparo de otras armas de fuego, y las no especificadas",82,75,7,15,X95
Retalhuleu,Enfermedad renal crónica,80,52,28,15,N19
Retalhuleu,Fibrosis y cirrosis del hígado,76,44,32,15,K74
Retalhuleu,Enfermedad renal crónica,61,40,21,15,N18
Retalhuleu,Exposición a factores no especificados,59,51,8,15,X59
Retalhuleu,"Accidente de vehículo de motor o sin motor, tipo de vehículo no especificado",48,42,6,15,V89
Retalhuleu,Insuficiencia cardíaca,44,26,18,15,I50
Retalhuleu,"Accidente vascular encefálico agudo, no especificado como hemorrágico o isquémico",35,19,16,15,I64
Retalhuleu,Tumor maligno del hígado y de las vías biliares intrahepáticas,26,12,14,15,C22
Retalhuleu,Diabetes mellitus no insulinodependiente,24,11,13,15,E11
Retalhuleu,Otros trastornos del encéfalo,24,13,11,15,G93
Retalhuleu,"Disparo de otras armas de fuego, y las no especificadas",23,20,3,15,W34
Retalhuleu,"Síntomas, signos y hallazgos anormales clínicos y de laboratorio, no clasificados en otra parte",388,207,181,15,R00 - R99
Retalhuleu,Otras causas,599,363,236,15,Otras causas
San Marcos,Todas las causas,4872,2796,2076,15,Todas las causas
San Marcos,"Neumonía, organismo no especificado",683,367,316,15,J18
San Marcos,Infarto agudo del miocardio,380,197,183,15,I21
San Marcos,Otras gastroenteritis y colitis de origen infeccioso y no especificado,241,129,112,15,A09
San Marcos,"Diabetes mellitus, no especificada",215,80,135,15,E14
San Marcos,Fibrosis y cirrosis del hígado,161,121,40,15,K74
San Marcos,Exposición a factores no especificados,155,131,24,15,X59
San Marcos,"Accidente vascular encefálico agudo, no especificado como hemorrágico o isquémico",144,81,63,15,I64
San Marcos,"Agresión con disparo de otras armas de fuego, y las no especificadas",115,102,13,15,X95
San Marcos,Diabetes mellitus no insulinodependiente,106,60,46,15,E11
San Marcos,Tumor maligno del hígado y de las vías biliares intrahepáticas,104,55,49,15,C22
San Marcos,Insuficiencia cardíaca,97,48,49,15,I50
San Marcos,"Desnutrición proteicocalórica, no especificada",87,46,41,15,E46
San Marcos,Enfermedad renal crónica,87,55,32,15,N18
San Marcos,Tumor maligno del estómago,81,33,48,15,C16
San Marcos,"Envenenamiento accidental por, y exposición al alcohol",75,72,3,15,X45
San Marcos,"Síntomas, signos y hallazgos anormales clínicos y de laboratorio, no clasificados en otra parte",321,187,134,15,R00 - R99
San Marcos,Otras causas,1820,1032,788,15,Otras causas
Huehuetenango,Todas las causas,4231,2280,1951,15,Todas las causas
Huehuetenango,"Neumonía, organismo no especificado",627,355,272,15,J18
Huehuetenango,Otras gastroenteritis y colitis de origen infeccioso y no especificado,275,142,133,15,A09
Huehuetenango,Infarto agudo del miocardio,268,137,131,15,I21
Huehuetenango,"Diabetes mellitus, no especificada",236,92,144,15,E14
Huehuetenango,Exposición a factores no especificados,126,94,32,15,X59
Huehuetenango,Tumor maligno del estómago,115,65,50,15,C16
Huehuetenango,"Accidente vascular encefálico agudo, no especificado como hemorrágico o isquémico",112,55,57,15,I64
Huehuetenango,Tumor maligno del hígado y de las vías biliares intrahepáticas,99,36,63,15,C22
Huehuetenango,Fibrosis y cirrosis del hígado,99,64,35,15,K74
Huehuetenango,"Envenenamiento accidental por, y exposición al alcohol",87,80,7,15,X45
Huehuetenango,Insuficiencia cardíaca,81,36,45,15,I50
Huehuetenango,Diabetes mellitus no insulinodependiente,80,35,45,15,E11
Huehuetenango,Otras enfermedades cerebrovasculares,69,38,31,15,I67
Huehuetenango,Enfermedad renal crónica,64,33,31,15,N18
Huehuetenango,Úlcera gástrica,62,30,32,15,K25
Huehuetenango,"Síntomas, signos y hallazgos anormales clínicos y de laboratorio, no clasificados en otra parte",201,100,101,15,R00 - R99
Huehuetenango,Otras causas,1630,888,742,15,Otras causas
Quiche,Todas las causas,3836,1998,1838,15,Todas las causas
Quiche,"Neumonía, organismo no especificado",521,258,263,15,J18
Quiche,Otras gastroenteritis y colitis de origen infeccioso y no especificado,199,104,95,15,A09
Quiche,Infarto agudo del miocardio,139,62,77,15,I21
Quiche,"Diabetes mellitus, no especificada",113,45,68,15,E14
Quiche,Exposición a factores no especificados,106,81,25,15,X59
Quiche,Fibrosis y cirrosis del hígado,81,50,31,15,K74
Quiche,Insuficiencia cardíaca,64,25,39,15,I50
Quiche,"Envenenamiento accidental por, y exposición al alcohol",64,60,4,15,X45
Quiche,Tumor maligno del estómago,62,23,39,15,C16
Quiche,Diabetes mellitus no insulinodependiente,56,26,30,15,E11
Quiche,Enfermedad renal crónica,47,19,28,15,N18
Quiche,Tumor maligno del hígado y de las vías biliares intrahepáticas,46,21,25,15,C22
Quiche,"Accidente de vehículo de motor o sin motor, tipo de vehículo no especificado",46,34,12,15,V89
Quiche,"Accidente vascular encefálico agudo, no especificado como hemorrágico o isquémico",44,19,25,15,I64
Quiche,Otras sepsis,43,23,20,15,A41
Quiche,"Síntomas, signos y hallazgos anormales clínicos y de laboratorio, no clasificados en otra parte",830,401,429,15,R00 - R99
Quiche,Otras causas,1375,747,628,15,Otras causas
Baja Verapaz,Todas las causas,1322,699,623,15,Todas las causas
Baja Verapaz,"Neumonía, organismo no especificado",151,83,68,15,J18
Baja Verapaz,Infarto agudo del miocardio,129,59,70,15,I21
Baja Verapaz,"Accidente vascular encefálico agudo, no especificado como hemorrágico o isquémico",88,43,45,15,I64
Baja Verapaz,Tumor maligno del estómago,55,28,27,15,C16
Baja Verapaz,"Diabetes mellitus, no especificada",52,19,33,15,E14
Baja Verapaz,Exposición a factores no especificados,40,36,4,15,X59
Baja Verapaz,Hipertensión esencial (primaria),38,14,24,15,I10
Baja Verapaz,Fibrosis y cirrosis del hígado,34,19,15,15,K74
Baja Verapaz,Otras gastroenteritis y colitis de origen infeccioso y no especificado,33,15,18,15,A09
Baja Verapaz,Diabetes mellitus no insulinodependiente,28,8,20,15,E11
Baja Verapaz,Tumor maligno del hígado y de las vías biliares intrahepáticas,26,10,16,15,C22
Baja Verapaz,"Agresión con disparo de otras armas de fuego, y las no especificadas",26,21,5,15,X95
Baja Verapaz,Insuficiencia cardíaca,22,10,12,15,I50
Baja Verapaz,Enfermedad renal crónica,20,7,13,15,N18
Baja Verapaz,Tumor maligno de la próstata,19,19,0,15,C61
Baja Verapaz,"Síntomas, signos y hallazgos anormales clínicos y de laboratorio, no clasificados en otra parte",114,63,51,15,R00 - R99
Baja Verapaz,Otras causas,447,245,202,15,Otras causas
Alta Verapaz,Todas las causas,4668,2444,2224,15,Todas las causas
Alta Verapaz,"Neumonía, organismo no especificado",872,418,454,15,J18
Alta Verapaz,Otras gastroenteritis y colitis de origen infeccioso y no especificado,418,218,200,15,A09
Alta Verapaz,Infarto agudo del miocardio,265,125,140,15,I21
Alta Verapaz,"Diabetes mellitus, no especificada",149,58,91,15,E14
Alta Verapaz,Fibrosis y cirrosis del hígado,135,74,61,15,K74
Alta Verapaz,Exposición a factores no especificados,135,109,26,15,X59
Alta Verapaz,"Desnutrición proteicocalórica, no especificada",108,59,49,15,E46
Alta Verapaz,"Accidente vascular encefálico agudo, no especificado como hemorrágico o isquémico",89,47,42,15,I64
Alta Verapaz,Tumor maligno del hígado y de las vías biliares intrahepáticas,85,38,47,15,C22
Alta Verapaz,Tumor maligno del estómago,76,34,42,15,C16
Alta Verapaz,Úlcera gástrica,57,22,35,15,K25
Alta Verapaz,Policitemia vera,56,25,31,15,D64
Alta Verapaz,"Agresión con disparo de otras armas de fuego, y las no especificadas",55,52,3,15,X95
Alta Verapaz,Otras enfermedades pulmonares obstructivas crónicas,54,23,31,15,J44
Alta Verapaz,Diabetes mellitus no insulinodependiente,52,14,38,15,E11
Alta Verapaz,"Síntomas, signos y hallazgos anormales clínicos y de laboratorio, no clasificados en otra parte",157,86,71,15,R00 - R99
Alta Verapaz,Otras causas,1905,1042,863,15,Otras causas
Peten,Todas las causas,2005,1209,796,15,Todas las causas
Peten,"Agresión con disparo de otras armas de fuego, y las no especificadas",224,213,11,15,X95
Peten,"Neumonía, organismo no especificado",119,66,53,15,J18
Peten,"Diabetes mellitus, no especificada",108,43,65,15,E14
Peten,Infarto agudo del miocardio,95,58,37,15,I21
Peten,Diabetes mellitus no insulinodependiente,90,27,63,15,E11
Peten,Exposición a factores no especificados,73,66,7,15,X59
Peten,"Accidente de vehículo de motor o sin motor, tipo de vehículo no especificado",69,57,12,15,V89
Peten,Fibrosis y cirrosis del hígado,57,30,27,15,K74
Peten,Otras gastroenteritis y colitis de origen infeccioso y no especificado,41,11,30,15,A09
Peten,"Accidente vascular encefálico agudo, no especificado como hemorrágico o isquémico",36,16,20,15,I64
Peten,Tumor maligno del hígado y de las vías biliares intrahepáticas,34,17,17,15,C22
Peten,Agresión por medios no especificados,34,28,6,15,Y09
Peten,Tumor maligno del estómago,32,13,19,15,C16
Peten,Tumor maligno de la próstata,31,31,0,15,C61
Peten,Insuficiencia cardíaca,30,16,14,15,I50
Peten,"Síntomas, signos y hallazgos anormales clínicos y de laboratorio, no clasificados en otra parte",142,81,61,15,R00 - R99
Peten,Otras causas,790,436,354,15,Otras causas
Izabal,Todas las causas,2121,1234,887,15,Todas las causas
Izabal,Infarto agudo del miocardio,190,117,73,15,I21
Izabal,"Agresión con disparo de otras armas de fuego, y las no especificadas",174,151,23,15,X95
Izabal,"Diabetes mellitus, no especificada",116,44,72,15,E14
Izabal,Enfermedad renal crónica,94,43,51,15,N19
Izabal,"Neumonía, organismo no especificado",91,50,41,15,J18
Izabal,"Accidente de vehículo de motor o sin motor, tipo de vehículo no especificado",89,70,19,15,V89
Izabal,"Accidente vascular encefálico agudo, no especificado como hemorrágico o isquémico",59,25,34,15,I64
Izabal,Fibrosis y cirrosis del hígado,46,24,22,15,K74
Izabal,Otras gastroenteritis y colitis de origen infeccioso y no especificado,45,26,19,15,A09
Izabal,Exposición a factores no especificados,45,34,11,15,X59
Izabal,Insuficiencia cardíaca,41,19,22,15,I50
Izabal,Diabetes mellitus no insulinodependiente,35,12,23,15,E11
Izabal,Tumor maligno del estómago,33,20,13,15,C16
Izabal,"Otros trastornos de los líquidos, de los electrólitos y del equilibrio ácido-básico",27,14,13,15,E87
Izabal,Tumor maligno del hígado y de las vías biliares intrahepáticas,26,13,13,15,C22
Izabal,"Síntomas, signos y hallazgos anormales clínicos y de laboratorio, no clasificados en otra parte",214,119,95,15,R00 - R99
Izabal,Otras causas,796,453,343,15,Otras causas
Zacapa,Todas las causas,1446,829,617,15,Todas las causas
Zacapa,Infarto agudo del miocardio,260,138,122,15,I21
Zacapa,"Agresión con disparo de otras armas de fuego, y las no especificadas",128,113,15,15,X95
Zacapa,"Neumonía, organismo no especificado",71,37,34,15,J18
Zacapa,"Diabetes mellitus, no especificada",70,23,47,15,E14
Zacapa,Exposición a factores no especificados,43,26,17,15,X59
Zacapa,Diabetes mellitus no insulinodependiente,41,19,22,15,E11
Zacapa,"Accidente vascular encefálico agudo, no especificado como hemorrágico o isquémico",39,15,24,15,I64
Zacapa,"Accidente de vehículo de motor o sin motor, tipo de vehículo no especificado",39,37,2,15,V89
Zacapa,Insuficiencia cardíaca,38,22,16,15,I50
Zacapa,Otras enfermedades cerebrovasculares,37,14,23,15,I67
Zacapa,Tumor maligno del estómago,34,17,17,15,C16
Zacapa,Tumor maligno del hígado y de las vías biliares intrahepáticas,32,14,18,15,C22
Zacapa,Otras enfermedades pulmonares obstructivas crónicas,30,15,15,15,J44
Zacapa,Hemorragia intraencefálica,23,13,10,15,I61
Zacapa,Fibrosis y cirrosis del hígado,21,12,9,15,K74
Zacapa,"Síntomas, signos y hallazgos anormales clínicos y de laboratorio, no clasificados en otra parte",33,16,17,15,R00 - R99
Zacapa,Otras causas,507,298,209,15,Otras causas
Chiquimula,Todas las causas,2134,1231,903,15,Todas las causas
Chiquimula,Infarto agudo del miocardio,228,123,105,15,I21
Chiquimula,"Neumonía, organismo no especificado",197,109,88,15,J18
Chiquimula,"Diabetes mellitus, no especificada",121,48,73,15,E14
Chiquimula,Insuficiencia cardíaca,112,55,57,15,I50
Chiquimula,"Disparo de otras armas de fuego, y las no especificadas",103,95,8,15,W34
Chiquimula,"Accidente vascular encefálico agudo, no especificado como hemorrágico o isquémico",93,46,47,15,I64
Chiquimula,Exposición a factores no especificados,88,70,18,15,X59
Chiquimula,"Agresión con disparo de otras armas de fuego, y las no especificadas",78,70,8,15,X95
Chiquimula,Tumor maligno del estómago,55,28,27,15,C16
Chiquimula,Fibrosis y cirrosis del hígado,42,23,19,15,K74
Chiquimula,Otras sepsis,35,18,17,15,A41
Chiquimula,"Contacto traumático con cuchillo, espada, daga o puñal",30,24,6,15,W26
Chiquimula,Otras enfermedades pulmonares obstructivas crónicas,28,15,13,15,J44
Chiquimula,Otras enfermedades cerebrovasculares,25,8,17,15,I67
Chiquimula,Tumor maligno del hígado y de las vías biliares intrahepáticas,24,10,14,15,C22
Chiquimula,"Síntomas, signos y hallazgos anormales clínicos y de laboratorio, no clasificados en otra parte",84,43,41,15,R00 - R99
Chiquimula,Otras causas,791,446,345,15,Otras causas
Jalapa,Todas las causas,1731,970,761,15,Todas las causas
Jalapa,Infarto agudo del miocardio,166,82,84,15,I21
Jalapa,"Neumonía, organismo no especificado",138,76,62,15,J18
Jalapa,"Accidente vascular encefálico agudo, no especificado como hemorrágico o isquémico",93,47,46,15,I64
Jalapa,"Diabetes mellitus, no especificada",73,31,42,15,E14
Jalapa,"Disparo de otras armas de fuego, y las no especificadas",60,54,6,15,W34
Jalapa,Exposición a factores no especificados,58,50,8,15,X59
Jalapa,Otras gastroenteritis y colitis de origen infeccioso y no especificado,54,27,27,15,A09
Jalapa,"Agresión con disparo de otras armas de fuego, y las no especificadas",53,46,7,15,X95
Jalapa,Fibrosis y cirrosis del hígado,35,24,11,15,K74
Jalapa,Tumor maligno del estómago,32,14,18,15,C16
Jalapa,Otras enfermedades pulmonares obstructivas crónicas,30,16,14,15,J44
Jalapa,Diabetes mellitus no insulinodependiente,26,7,19,15,E11
Jalapa,Tumor maligno del hígado y de las vías biliares intrahepáticas,25,7,18,15,C22
Jalapa,Otros trastornos del encéfalo,24,13,11,15,G93
Jalapa,Insuficiencia cardíaca,24,9,15,15,I50
Jalapa,"Síntomas, signos y hallazgos anormales clínicos y de laboratorio, no clasificados en otra parte",178,92,86,15,R00 - R99
Jalapa,Otras causas,662,375,287,15,Otras causas
Jutiapa,Todas las causas,2784,1563,1221,15,Todas las causas
Jutiapa,Infarto agudo del miocardio,463,242,221,15,I21
Jutiapa,"Diabetes mellitus, no especificada",177,62,115,15,E14
Jutiapa,"Agresión con disparo de otras armas de fuego, y las no especificadas",163,151,12,15,X95
Jutiapa,"Accidente vascular encefálico agudo, no especificado como hemorrágico o isquémico",130,61,69,15,I64
Jutiapa,"Neumonía, organismo no especificado",129,82,47,15,J18
Jutiapa,Exposición a factores no especificados,96,86,10,15,X59
Jutiapa,Insuficiencia cardíaca,69,44,25,15,I50
Jutiapa,Tumor maligno del estómago,66,36,30,15,C16
Jutiapa,Fibrosis y cirrosis del hígado,61,42,19,15,K74
Jutiapa,Otras enfermedades cerebrovasculares,57,28,29,15,I67
Jutiapa,Enfermedad renal crónica,57,34,23,15,N18
Jutiapa,Tumor maligno del hígado y de las vías biliares intrahepáticas,55,26,29,15,C22
Jutiapa,Diabetes mellitus no insulinodependiente,50,14,36,15,E11
Jutiapa,"Accidente de vehículo de motor o sin motor, tipo de vehículo no especificado",50,44,6,15,V89
Jutiapa,Tumor maligno de la próstata,41,41,0,15,C61
Jutiapa,"Síntomas, signos y hallazgos anormales clínicos y de laboratorio, no clasificados en otra parte",102,53,49,15,R00 - R99
Jutiapa,Otras causas,1018,517,501,15,Otras causas
Extranjero,Todas las causas,85,52,33,15,Todas las causas
Extranjero,"Agresión con disparo de otras armas de fuego, y las no especificadas",19,16,3,15,X95
Extranjero,Exposición a factores no especificados,10,5,5,15,X59
Extranjero,"Accidente de vehículo de motor o sin motor, tipo de vehículo no especificado",6,4,2,15,V89
Extranjero,Infarto agudo del miocardio,4,3,1,15,I21
Extranjero,"Diabetes mellitus, no especificada",3,1,2,15,E14
Extranjero,"Disparo de otras armas de fuego, y las no especificadas",3,2,1,15,W34
Extranjero,Otras sepsis,2,0,2,15,A41
Extranjero,"Enfermedad por virus de la inmunodeficiencia humana [VIH], resultante en enfermedades infecciosas y parasitarias",2,0,2,15,B20
Extranjero,Tumor maligno del estómago,2,1,1,15,C16
Extranjero,Agresión por medios no especificados,2,1,1,15,Y09
Extranjero,"Enfermedad por virus de la inmunodeficiencia humana [VIH], sin otra especificación",1,0,1,15,B24
Extranjero,Tumor maligno del colon,1,1,0,15,C18
Extranjero,Tumor maligno del hígado y de las vías biliares intrahepáticas,1,1,0,15,C22
Extranjero,Tumor maligno de la mama,1,0,1,15,C50
Extranjero,Tumor maligno de la próstata,1,1,0,15,C61
Extranjero,"Síntomas, signos y hallazgos anormales clínicos y de laboratorio, no clasificados en otra parte",1,1,0,15,R00 - R99
Extranjero,Otras causas,26,15,11,15,Otras causas
Ignorado,Todas las causas,5487,3350,2137,15,Todas las causas
Ignorado,"Neumonía, organismo no especificado",531,320,211,15,J18
Ignorado,Exposición a factores no especificados,309,248,61,15,X59
Ignorado,Dificultad respiratoria del recién nacido,302,171,131,15,P22
Ignorado,"Agresión con disparo de otras armas de fuego, y las no especificadas",290,238,52,15,X95
Ignorado,Neumonía congénita,162,101,61,15,P23
Ignorado,"Trastornos relacionados con duración corta de la gestación y con bajo peso al nacer, no clasificados en otra parte",159,93,66,15,P07
Ignorado,Otras gastroenteritis y colitis de origen infeccioso y no especificado,156,81,75,15,A09
Ignorado,Otras malformaciones congénitas del corazón,152,79,73,15,Q24
Ignorado,Síndromes de aspiración neonatal,139,86,53,15,P24
Ignorado,Sepsis bacteriana del recién nacido,126,83,43,15,P36
Ignorado,"Otras malformaciones congénitas, no clasificadas en otra parte",124,62,62,15,Q89
Ignorado,Asfixia del nacimiento,103,62,41,15,P21
Ignorado,Otras sepsis,100,60,40,15,A41
Ignorado,"Accidente de vehículo de motor o sin motor, tipo de vehículo no especificado",82,66,16,15,V89
Ignorado,Trastornos cardiovasculares originados en el período perinatal,79,45,34,15,P29
Ignorado,"Síntomas, signos y hallazgos anormales clínicos y de laboratorio, no clasificados en otra parte",324,202,122,15,R00 - R99
Ignorado,Otras causas,2349,1353,996,15,Otras causas
Todos los departamentos,Todas las causas,82565,46267,36298,16,Todas las causas
Todos los departamentos,"Neumonía, organismo no especificado",6851,3652,3199,16,J18
Todos los departamentos,Infarto agudo del miocardio,5498,2955,2543,16,I21
Todos los departamentos,"Diabetes mellitus, no especificada",4400,1792,2608,16,E14
Todos los departamentos,"Agresión con disparo de otras armas de fuego, y las no especificadas",3111,2727,384,16,X95
Todos los departamentos,Exposición a factores no especificados,2941,2387,554,16,X59
Todos los departamentos,Fibrosis y cirrosis del hígado,2647,1711,936,16,K74
Todos los departamentos,Otras gastroenteritis y colitis de origen infeccioso y no especificado,2308,1224,1084,16,A09
Todos los departamentos,"Accidente vascular encefálico agudo, no especificado como hemorrágico o isquémico",1716,872,844,16,I64
Todos los departamentos,"Accidente de vehículo de motor o sin motor, tipo de vehículo no especificado",1567,1310,257,16,V89
Todos los departamentos,Insuficiencia cardíaca,1520,709,811,16,I50
Todos los departamentos,Diabetes mellitus no insulinodependiente,1438,578,860,16,E11
Todos los departamentos,Tumor maligno del hígado y de las vías biliares intrahepáticas,1389,683,706,16,C22
Todos los departamentos,Enfermedad renal crónica,1389,690,699,16,N18
Todos los departamentos,Tumor maligno del estómago,1264,586,678,16,C16
Todos los departamentos,Insuficiencia renal no especificada,1007,540,467,16,N19
Todos los departamentos,"Síntomas, signos y hallazgos anormales clínicos y de laboratorio, no clasificados en otra parte",8901,4531,4370,16,R00 - R99
Todos los departamentos,Otras causas,34618,19320,15298,16,Otras causas
Guatemala,Todas las causas,18540,10224,8316,16,Todas las causas
Guatemala,"Diabetes mellitus, no especificada",1293,542,751,16,E14
Guatemala,Infarto agudo del miocardio,1264,672,592,16,I21
Guatemala,"Agresión con disparo de otras armas de fuego, y las no especificadas",1070,914,156,16,X95
Guatemala,Fibrosis y cirrosis del hígado,896,639,257,16,K74
Guatemala,Exposición a factores no especificados,878,705,173,16,X59
Guatemala,"Neumonía, organismo no especificado",775,429,346,16,J18
Guatemala,Enfermedad renal crónica,458,213,245,16,N18
Guatemala,Diabetes mellitus no insulinodependiente,443,201,242,16,E11
Guatemala,Tumor maligno del hígado y de las vías biliares intrahepáticas,415,209,206,16,C22
Guatemala,"Accidente vascular encefálico agudo, no especificado como hemorrágico o isquémico",286,143,143,16,I64
Guatemala,Tumor maligno del estómago,279,113,166,16,C16
Guatemala,Insuficiencia cardíaca,264,118,146,16,I50
Guatemala,Hipertensión esencial (primaria),261,117,144,16,I10
Guatemala,"Disparo de otras armas de fuego, y las no especificadas",245,217,28,16,W34
Guatemala,Otras sepsis,228,108,120,16,A41
Guatemala,"Síntomas, signos y hallazgos anormales clínicos y de laboratorio, no clasificados en otra parte",1690,820,870,16,R00 - R99
Guatemala,Otras causas,7795,4064,3731,16,Otras causas
El Progreso,Todas las causas,1043,589,454,16,Todas las causas
El Progreso,Infarto agudo del miocardio,140,73,67,16,I21
El Progreso,"Agresión con disparo de otras armas de fuego, y las no especificadas",74,66,8,16,X95
El Progreso,"Neumonía, organismo no especificado",65,32,33,16,J18
El Progreso,"Diabetes mellitus, no especificada",64,23,41,16,E14
El Progreso,"Accidente vascular encefálico agudo, no especificado como hemorrágico o isquémico",47,26,21,16,I64
El Progreso,Tumor maligno del hígado y de las vías biliares intrahepáticas,32,21,11,16,C22
El Progreso,Diabetes mellitus no insulinodependiente,30,12,18,16,E11
El Progreso,Exposición a factores no especificados,29,21,8,16,X59
El Progreso,Fibrosis y cirrosis del hígado,26,13,13,16,K74
El Progreso,"Accidente de vehículo de motor o sin motor, tipo de vehículo no especificado",25,22,3,16,V89
El Progreso,Tumor maligno del estómago,24,12,12,16,C16
El Progreso,Otras enfermedades pulmonares obstructivas crónicas,19,9,10,16,J44
El Progreso,Enfermedad renal crónica,18,10,8,16,N18
El Progreso,Otras enfermedades cerebrovasculares,15,7,8,16,I67
El Progreso,Insuficiencia cardíaca,13,6,7,16,I50
El Progreso,"Síntomas, signos y hallazgos anormales clínicos y de laboratorio, no clasificados en otra parte",58,33,25,16,R00 - R99
El Progreso,Otras causas,364,203,161,16,Otras causas
Sacatepequez,Todas las causas,1657,918,739,16,Todas las causas
Sacatepequez,"Diabetes mellitus, no especificada",136,60,76,16,E14
Sacatepequez,Infarto agudo del miocardio,114,64,50,16,I21
Sacatepequez,"Neumonía, organismo no especificado",92,49,43,16,J18
Sacatepequez,Exposición a factores no especificados,79,65,14,16,X59
Sacatepequez,Fibrosis y cirrosis del hígado,73,44,29,16,K74
Sacatepequez,Diabetes mellitus no insulinodependiente,56,22,34,16,E11
Sacatepequez,Enfermedad alcohólica del hígado,49,44,5,16,K70
Sacatepequez,"Desnutrición proteicocalórica, no especificada",40,10,30,16,E46
Sacatepequez,Tumor maligno del hígado y de las vías biliares intrahepáticas,37,13,24,16,C22
Sacatepequez,"Accidente de vehículo de motor o sin motor, tipo de vehículo no especificado",37,34,3,16,V89
Sacatepequez,Tumor maligno del estómago,30,15,15,16,C16
Sacatepequez,"Accidente vascular encefálico agudo, no especificado como hemorrágico o isquémico",29,14,15,16,I64
Sacatepequez,Trastornos mentales y del comportamiento debidos al uso de alcohol,26,24,2,16,F10
Sacatepequez,Enfermedad renal crónica,26,13,13,16,N18
Sacatepequez,Otras gastroenteritis y colitis de origen infeccioso y no especificado,25,16,9,16,A09
Sacatepequez,"Síntomas, signos y hallazgos anormales clínicos y de laboratorio, no clasificados en otra parte",114,61,53,16,R00 - R99
Sacatepequez,Otras causas,694,370,324,16,Otras causas
Chimaltenango,Todas las causas,2883,1565,1318,16,Todas las causas
Chimaltenango,"Neumonía, organismo no especificado",306,157,149,16,J18
Chimaltenango,"Diabetes mellitus, no especificada",174,70,104,16,E14
Chimaltenango,Infarto agudo del miocardio,157,84,73,16,I21
Chimaltenango,Fibrosis y cirrosis del hígado,128,72,56,16,K74
Chimaltenango,Exposición a factores no especificados,116,90,26,16,X59
Chimaltenango,Enfermedad alcohólica del hígado,93,73,20,16,K70
Chimaltenango,Insuficiencia cardíaca,86,38,48,16,I50
Chimaltenango,"Accidente vascular encefálico agudo, no especificado como hemorrágico o isquémico",75,40,35,16,I64
Chimaltenango,Tumor maligno del hígado y de las vías biliares intrahepáticas,64,33,31,16,C22
Chimaltenango,Tumor maligno del estómago,62,24,38,16,C16
Chimaltenango,Otras gastroenteritis y colitis de origen infeccioso y no especificado,61,35,26,16,A09
Chimaltenango,Diabetes mellitus no insulinodependiente,60,20,40,16,E11
Chimaltenango,Otras enfermedades pulmonares obstructivas crónicas,55,32,23,16,J44
Chimaltenango,Enfermedad renal crónica,52,24,28,16,N18
Chimaltenango,"Agresión con disparo de otras armas de fuego, y las no especificadas",47,44,3,16,X95
Chimaltenango,"Síntomas, signos y hallazgos anormales clínicos y de laboratorio, no clasificados en otra parte",190,108,82,16,R00 - R99
Chimaltenango,Otras causas,1157,621,536,16,Otras causas
Escuintla,Todas las causas,4294,2550,1744,16,Todas las causas
Escuintla,Infarto agudo del miocardio,403,224,179,16,I21
Escuintla,"Agresión con disparo de otras armas de fuego, y las no especificadas",340,310,30,16,X95
Escuintla,"Diabetes mellitus, no especificada",315,123,192,16,E14
Escuintla,"Neumonía, organismo no especificado",263,162,101,16,J18
Escuintla,"Accidente de vehículo de motor o sin motor, tipo de vehículo no especificado",201,169,32,16,V89
Escuintla,Enfermedad renal crónica,154,85,69,16,N18
Escuintla,Exposición a factores no especificados,150,130,20,16,X59
Escuintla,Fibrosis y cirrosis del hígado,125,82,43,16,K74
Escuintla,Diabetes mellitus no insulinodependiente,105,36,69,16,E11
Escuintla,Tumor maligno del hígado y de las vías biliares intrahepáticas,83,40,43,16,C22
Escuintla,"Accidente vascular encefálico agudo, no especificado como hemorrágico o isquémico",73,38,35,16,I64
Escuintla,"Otros trastornos de los líquidos, de los electrólitos y del equilibrio ácido-básico",65,40,25,16,E87
Escuintla,Tumor maligno del estómago,58,22,36,16,C16
Escuintla,Insuficiencia renal no especificada,55,31,24,16,N19
Escuintla,Otras enfermedades pulmonares obstructivas crónicas,48,25,23,16,J44
Escuintla,"Síntomas, signos y hallazgos anormales clínicos y de laboratorio, no clasificados en otra parte",335,174,161,16,R00 - R99
Escuintla,Otras causas,1521,859,662,16,Otras causas
Santa Rosa,Todas las causas,1974,1134,840,16,Todas las causas
Santa Rosa,Infarto agudo del miocardio,206,113,93,16,I21
Santa Rosa,"Diabetes mellitus, no especificada",114,48,66,16,E14
Santa Rosa,"Agresión con disparo de otras armas de fuego, y las no especificadas",102,92,10,16,X95
Santa Rosa,"Neumonía, organismo no especificado",96,48,48,16,J18
Santa Rosa,"Accidente de vehículo de motor o sin motor, tipo de vehículo no especificado",81,73,8,16,V89
Santa Rosa,Exposición a factores no especificados,69,54,15,16,X59
Santa Rosa,Insuficiencia cardíaca,65,28,37,16,I50
Santa Rosa,Enfermedad renal crónica,57,34,23,16,N18
Santa Rosa,"Accidente vascular encefálico agudo, no especificado como hemorrágico o isquémico",45,22,23,16,I64
Santa Rosa,Fibrosis y cirrosis del hígado,37,27,10,16,K74
Santa Rosa,Otras sepsis,34,15,19,16,A41
Santa Rosa,Tumor maligno del hígado y de las vías biliares intrahepáticas,32,18,14,16,C22
Santa Rosa,Otras enfermedades pulmonares obstructivas crónicas,31,19,12,16,J44
Santa Rosa,Diabetes mellitus no insulinodependiente,30,16,14,16,E11
Santa Rosa,Tumor maligno del cuello del útero,28,0,28,16,C53
Santa Rosa,"Síntomas, signos y hallazgos anormales clínicos y de laboratorio, no clasificados en otra parte",184,91,93,16,R00 - R99
Santa Rosa,Otras causas,763,436,327,16,Otras causas
Solola,Todas las causas,1746,915,831,16,Todas las causas
Solola,"Neumonía, organismo no especificado",239,105,134,16,J18
Solola,"Diabetes mellitus, no especificada",83,26,57,16,E14
Solola,Otras gastroenteritis y colitis de origen infeccioso y no especificado,68,27,41,16,A09
Solola,Exposición a factores no especificados,56,42,14,16,X59
Solola,Infarto agudo del miocardio,55,29,26,16,I21
Solola,Fibrosis y cirrosis del hígado,50,31,19,16,K74
Solola,"Envenenamiento accidental por, y exposición al alcohol",48,47,1,16,X45
Solola,Diabetes mellitus no insulinodependiente,47,22,25,16,E11
Solola,"Desnutrición proteicocalórica, no especificada",37,15,22,16,E46
Solola,Enfermedad alcohólica del hígado,36,34,2,16,K70
Solola,"Accidente vascular encefálico agudo, no especificado como hemorrágico o isquémico",35,17,18,16,I64
Solola,Enfermedad renal crónica,32,13,19,16,N18
Solola,"Accidente de vehículo de motor o sin motor, tipo de vehículo no especificado",31,24,7,16,V89
Solola,Tumor maligno del hígado y de las vías biliares intrahepáticas,28,12,16,16,C22
Solola,Tumor maligno del estómago,27,13,14,16,C16
Solola,"Síntomas, signos y hallazgos anormales clínicos y de laboratorio, no clasificados en otra parte",234,116,118,16,R00 - R99
Solola,Otras causas,640,342,298,16,Otras causas
Totonicapan,Todas las causas,2331,1260,1071,16,Todas las causas
Totonicapan,"Neumonía, organismo no especificado",217,109,108,16,J18
Totonicapan,"Diabetes mellitus, no especificada",127,76,51,16,E14
Totonicapan,Fibrosis y cirrosis del hígado,126,75,51,16,K74
Totonicapan,Otras gastroenteritis y colitis de origen infeccioso y no especificado,89,45,44,16,A09
Totonicapan,Exposición a factores no especificados,49,36,13,16,X59
Totonicapan,"Envenenamiento accidental por, y exposición al alcohol",45,41,4,16,X45
Totonicapan,"Accidente de vehículo de motor o sin motor, tipo de vehículo no especificado",40,32,8,16,V89
Totonicapan,Infarto agudo del miocardio,37,20,17,16,I21
Totonicapan,Enfermedad alcohólica del hígado,35,30,5,16,K70
Totonicapan,Diabetes mellitus no insulinodependiente,31,17,14,16,E11
Totonicapan,Tumor maligno de sitios no especificados,29,13,16,16,C80
Totonicapan,Otros trastornos del encéfalo,28,16,12,16,G93
Totonicapan,Hipertensión esencial (primaria),28,10,18,16,I10
Totonicapan,"Lesión autoinfligida intencionalmente por ahorcamiento, estrangulamiento o sofocación",24,22,2,16,X70
Totonicapan,Úlcera gástrica,22,9,13,16,K25
Totonicapan,"Síntomas, signos y hallazgos anormales clínicos y de laboratorio, no clasificados en otra parte",771,366,405,16,R00 - R99
Totonicapan,Otras causas,633,343,290,16,Otras causas
Quetzaltenango,Todas las causas,4476,2450,2026,16,Todas las causas
Quetzaltenango,"Diabetes mellitus, no especificada",321,137,184,16,E14
Quetzaltenango,"Neumonía, organismo no especificado",280,136,144,16,J18
Quetzaltenango,Infarto agudo del miocardio,253,150,103,16,I21
Quetzaltenango,Insuficiencia cardíaca,208,87,121,16,I50
Quetzaltenango,Fibrosis y cirrosis del hígado,145,97,48,16,K74
Quetzaltenango,Exposición a factores no especificados,139,108,31,16,X59
Quetzaltenango,Enfermedad alcohólica del hígado,138,106,32,16,K70
Quetzaltenango,"Accidente de vehículo de motor o sin motor, tipo de vehículo no especificado",107,91,16,16,V89
Quetzaltenango,Diabetes mellitus no insulinodependiente,97,43,54,16,E11
Quetzaltenango,"Envenenamiento accidental por, y exposición al alcohol",90,76,14,16,X45
Quetzaltenango,Trastornos mentales y del comportamiento debidos al uso de alcohol,89,80,9,16,F10
Quetzaltenango,Tumor maligno del estómago,87,42,45,16,C16
Quetzaltenango,"Accidente vascular encefálico agudo, no especificado como hemorrágico o isquémico",87,37,50,16,I64
Quetzaltenango,"Agresión con disparo de otras armas de fuego, y las no especificadas",79,64,15,16,X95
Quetzaltenango,Tumor maligno del hígado y de las vías biliares intrahepáticas,74,42,32,16,C22
Quetzaltenango,"Síntomas, signos y hallazgos anormales clínicos y de laboratorio, no clasificados en otra parte",301,129,172,16,R00 - R99
Quetzaltenango,Otras causas,1981,1025,956,16,Otras causas
Suchitepequez,Todas las causas,2831,1612,1219,16,Todas las causas
Suchitepequez,"Diabetes mellitus, no especificada",146,61,85,16,E14
Suchitepequez,Exposición a factores no especificados,128,108,20,16,X59
Suchitepequez,"Neumonía, organismo no especificado",114,61,53,16,J18
Suchitepequez,Insuficiencia renal no especificada,96,68,28,16,N19
Suchitepequez,Infarto agudo del miocardio,88,48,40,16,I21
Suchitepequez,Fibrosis y cirrosis del hígado,78,44,34,16,K74
Suchitepequez,Enfermedad renal crónica,61,37,24,16,N18
Suchitepequez,"Disparo de otras armas de fuego, y las no especificadas",42,35,7,16,W34
Suchitepequez,Tumor maligno del hígado y de las vías biliares intrahepáticas,41,21,20,16,C22
Suchitepequez,Otras gastroenteritis y colitis de origen infeccioso y no especificado,32,22,10,16,A09
Suchitepequez,"Accidente de vehículo de motor o sin motor, tipo de vehículo no especificado",32,26,6,16,V89
Suchitepequez,"Agresión con disparo de otras armas de fuego, y las no especificadas",31,31,0,16,X95
Suchitepequez,Tumor maligno del estómago,27,14,13,16,C16
Suchitepequez,Otras sepsis,24,10,14,16,A41
Suchitepequez,"Accidente vascular encefálico agudo, no especificado como hemorrágico o isquémico",23,13,10,16,I64
Suchitepequez,"Síntomas, signos y hallazgos anormales clínicos y de laboratorio, no clasificados en otra parte",1151,612,539,16,R00 - R99
Suchitepequez,Otras causas,717,401,316,16,Otras causas
Retalhuleu,Todas las causas,1874,1088,786,16,Todas las causas
Retalhuleu,"Diabetes mellitus, no especificada",106,48,58,16,E14
Retalhuleu,Insuficiencia renal no especificada,105,71,34,16,N19
Retalhuleu,"Neumonía, organismo no especificado",81,43,38,16,J18
Retalhuleu,Infarto agudo del miocardio,74,48,26,16,I21
Retalhuleu,"Agresión con disparo de otras armas de fuego, y las no especificadas",69,62,7,16,X95
Retalhuleu,Fibrosis y cirrosis del hígado,56,34,22,16,K74
Retalhuleu,"Accidente de vehículo de motor o sin motor, tipo de vehículo no especificado",48,42,6,16,V89
Retalhuleu,Exposición a factores no especificados,41,35,6,16,X59
Retalhuleu,Enfermedad renal crónica,32,22,10,16,N18
Retalhuleu,Otras gastroenteritis y colitis de origen infeccioso y no especificado,24,18,6,16,A09
Retalhuleu,Insuficiencia cardíaca,23,14,9,16,I50
Retalhuleu,Tumor maligno de sitios no especificados,22,6,16,16,C80
Retalhuleu,Otras anemias,21,13,8,16,D64
Retalhuleu,Otros trastornos del encéfalo,21,12,9,16,G93
Retalhuleu,Otros trastornos y los no especificados del sistema circulatorio,18,6,12,16,I99
Retalhuleu,"Síntomas, signos y hallazgos anormales clínicos y de laboratorio, no clasificados en otra parte",629,333,296,16,R00 - R99
Retalhuleu,Otras causas,504,281,223,16,Otras causas
San Marcos,Todas las causas,4508,2538,1970,16,Todas las causas
San Marcos,"Neumonía, organismo no especificado",651,356,295,16,J18
San Marcos,Infarto agudo del miocardio,362,199,163,16,I21
San Marcos,"Diabetes mellitus, no especificada",197,79,118,16,E14
San Marcos,Otras gastroenteritis y colitis de origen infeccioso y no especificado,186,112,74,16,A09
San Marcos,Fibrosis y cirrosis del hígado,176,117,59,16,K74
San Marcos,"Accidente vascular encefálico agudo, no especificado como hemorrágico o isquémico",133,74,59,16,I64
San Marcos,Exposición a factores no especificados,118,97,21,16,X59
San Marcos,Insuficiencia cardíaca,109,53,56,16,I50
San Marcos,Tumor maligno del hígado y de las vías biliares intrahepáticas,90,45,45,16,C22
San Marcos,"Envenenamiento accidental por, y exposición al alcohol",90,83,7,16,X45
San Marcos,Diabetes mellitus no insulinodependiente,84,24,60,16,E11
San Marcos,Enfermedad renal crónica,84,37,47,16,N18
San Marcos,"Desnutrición proteicocalórica, no especificada",81,42,39,16,E46
San Marcos,"Agresión con disparo de otras armas de fuego, y las no especificadas",81,70,11,16,X95
San Marcos,Tumor maligno del estómago,79,41,38,16,C16
San Marcos,"Síntomas, signos y hallazgos anormales clínicos y de laboratorio, no clasificados en otra parte",325,169,156,16,R00 - R99
San Marcos,Otras causas,1662,940,722,16,Otras causas
Huehuetenango,Todas las causas,4324,2344,1980,16,Todas las causas
Huehuetenango,"Neumonía, organismo no especificado",587,339,248,16,J18
Huehuetenango,Infarto agudo del miocardio,278,146,132,16,I21
Huehuetenango,"Diabetes mellitus, no especificada",236,97,139,16,E14
Huehuetenango,Otras gastroenteritis y colitis de origen infeccioso y no especificado,231,118,113,16,A09
Huehuetenango,"Accidente vascular encefálico agudo, no especificado como hemorrágico o isquémico",147,79,68,16,I64
Huehuetenango,Tumor maligno del estómago,135,75,60,16,C16
Huehuetenango,Exposición a factores no especificados,133,109,24,16,X59
Huehuetenango,Insuficiencia cardíaca,115,56,59,16,I50
Huehuetenango,Fibrosis y cirrosis del hígado,107,69,38,16,K74
Huehuetenango,Tumor maligno del hígado y de las vías biliares intrahepáticas,93,43,50,16,C22
Huehuetenango,"Envenenamiento accidental por, y exposición al alcohol",71,71,0,16,X45
Huehuetenango,"Accidente de vehículo de motor o sin motor, tipo de vehículo no especificado",68,59,9,16,V89
Huehuetenango,Diabetes mellitus no insulinodependiente,67,28,39,16,E11
Huehuetenango,Otras enfermedades cerebrovasculares,66,26,40,16,I67
Huehuetenango,Enfermedad renal crónica,63,25,38,16,N18
Huehuetenango,"Síntomas, signos y hallazgos anormales clínicos y de laboratorio, no clasificados en otra parte",200,107,93,16,R00 - R99
Huehuetenango,Otras causas,1727,897,830,16,Otras causas
Quiche,Todas las causas,3670,1941,1729,16,Todas las causas
Quiche,"Neumonía, organismo no especificado",415,206,209,16,J18
Quiche,Otras gastroenteritis y colitis de origen infeccioso y no especificado,188,88,100,16,A09
Quiche,Infarto agudo del miocardio,140,59,81,16,I21
Quiche,"Diabetes mellitus, no especificada",120,50,70,16,E14
Quiche,Exposición a factores no especificados,90,80,10,16,X59
Quiche,"Envenenamiento accidental por, y exposición al alcohol",70,69,1,16,X45
Quiche,Fibrosis y cirrosis del hígado,65,40,25,16,K74
Quiche,Tumor maligno del estómago,63,32,31,16,C16
Quiche,"Accidente de vehículo de motor o sin motor, tipo de vehículo no especificado",59,48,11,16,V89
Quiche,Enfermedad alcohólica del hígado,58,47,11,16,K70
Quiche,Insuficiencia cardíaca,56,26,30,16,I50
Quiche,"Accidente vascular encefálico agudo, no especificado como hemorrágico o isquémico",54,24,30,16,I64
Quiche,Diabetes mellitus no insulinodependiente,51,20,31,16,E11
Quiche,Tumor maligno del hígado y de las vías biliares intrahepáticas,50,21,29,16,C22
Quiche,Enfermedad renal crónica,43,16,27,16,N18
Quiche,"Síntomas, signos y hallazgos anormales clínicos y de laboratorio, no clasificados en otra parte",905,456,449,16,R00 - R99
Quiche,Otras causas,1243,659,584,16,Otras causas
Baja Verapaz,Todas las causas,1363,728,635,16,Todas las causas
Baja Verapaz,Infarto agudo del miocardio,153,72,81,16,I21
Baja Verapaz,"Neumonía, organismo no especificado",147,72,75,16,J18
Baja Verapaz,"Accidente vascular encefálico agudo, no especificado como hemorrágico o isquémico",88,38,50,16,I64
Baja Verapaz,"Diabetes mellitus, no especificada",68,30,38,16,E14
Baja Verapaz,Exposición a factores no especificados,41,27,14,16,X59
Baja Verapaz,Hipertensión esencial (primaria),40,19,21,16,I10
Baja Verapaz,Fibrosis y cirrosis del hígado,37,21,16,16,K74
Baja Verapaz,"Accidente de vehículo de motor o sin motor, tipo de vehículo no especificado",35,34,1,16,V89
Baja Verapaz,Tumor maligno del estómago,30,10,20,16,C16
Baja Verapaz,Tumor maligno del hígado y de las vías biliares intrahepáticas,29,14,15,16,C22
Baja Verapaz,Diabetes mellitus no insulinodependiente,26,7,19,16,E11
Baja Verapaz,Insuficiencia cardíaca,25,12,13,16,I50
Baja Verapaz,"Agresión con disparo de otras armas de fuego, y las no especificadas",25,23,2,16,X95
Baja Verapaz,Otras enfermedades pulmonares obstructivas crónicas,23,14,9,16,J44
Baja Verapaz,Otras gastroenteritis y colitis de origen infeccioso y no especificado,20,10,10,16,A09
Baja Verapaz,"Síntomas, signos y hallazgos anormales clínicos y de laboratorio, no clasificados en otra parte",95,45,50,16,R00 - R99
Baja Verapaz,Otras causas,481,280,201,16,Otras causas
Alta Verapaz,Todas las causas,4822,2485,2337,16,Todas las causas
Alta Verapaz,"Neumonía, organismo no especificado",775,379,396,16,J18
Alta Verapaz,Otras gastroenteritis y colitis de origen infeccioso y no especificado,368,175,193,16,A09
Alta Verapaz,Infarto agudo del miocardio,267,133,134,16,I21
Alta Verapaz,"Diabetes mellitus, no especificada",208,70,138,16,E14
Alta Verapaz,Fibrosis y cirrosis del hígado,172,86,86,16,K74
Alta Verapaz,Exposición a factores no especificados,118,101,17,16,X59
Alta Verapaz,"Accidente vascular encefálico agudo, no especificado como hemorrágico o isquémico",114,59,55,16,I64
Alta Verapaz,"Desnutrición proteicocalórica, no especificada",113,52,61,16,E46
Alta Verapaz,Tumor maligno del hígado y de las vías biliares intrahepáticas,110,43,67,16,C22
Alta Verapaz,Otras enfermedades pulmonares obstructivas crónicas,80,35,45,16,J44
Alta Verapaz,Otras sepsis,69,34,35,16,A41
Alta Verapaz,Tumor maligno del estómago,68,31,37,16,C16
Alta Verapaz,Otras anemias,67,27,40,16,D64
Alta Verapaz,Dificultad respiratoria del recién nacido,61,38,23,16,P22
Alta Verapaz,Úlcera gástrica,60,33,27,16,K25
Alta Verapaz,"Síntomas, signos y hallazgos anormales clínicos y de laboratorio, no clasificados en otra parte",179,92,87,16,R00 - R99
Alta Verapaz,Otras causas,1993,1097,896,16,Otras causas
Peten,Todas las causas,2074,1277,797,16,Todas las causas
Peten,"Agresión con disparo de otras armas de fuego, y las no especificadas",168,145,23,16,X95
Peten,Infarto agudo del miocardio,146,90,56,16,I21
Peten,"Diabetes mellitus, no especificada",121,40,81,16,E14
Peten,"Neumonía, organismo no especificado",118,71,47,16,J18
Peten,Exposición a factores no especificados,93,83,10,16,X59
Peten,"Accidente de vehículo de motor o sin motor, tipo de vehículo no especificado",80,69,11,16,V89
Peten,Fibrosis y cirrosis del hígado,72,36,36,16,K74
Peten,Agresión por medios no especificados,66,64,2,16,Y09
Peten,Diabetes mellitus no insulinodependiente,63,20,43,16,E11
Peten,Otras gastroenteritis y colitis de origen infeccioso y no especificado,53,33,20,16,A09
Peten,"Neumonía bacteriana, no clasificada en otra parte",42,19,23,16,J15
Peten,"Accidente vascular encefálico agudo, no especificado como hemorrágico o isquémico",39,18,21,16,I64
Peten,Insuficiencia cardíaca,30,18,12,16,I50
Peten,Otras enfermedades pulmonares obstructivas crónicas,30,18,12,16,J44
Peten,Tumor maligno del hígado y de las vías biliares intrahepáticas,27,16,11,16,C22
Peten,"Síntomas, signos y hallazgos anormales clínicos y de laboratorio, no clasificados en otra parte",83,50,33,16,R00 - R99
Peten,Otras causas,843,487,356,16,Otras causas
Izabal,Todas las causas,2219,1288,931,16,Todas las causas
Izabal,Infarto agudo del miocardio,214,111,103,16,I21
Izabal,"Agresión con disparo de otras armas de fuego, y las no especificadas",170,147,23,16,X95
Izabal,"Neumonía, organismo no especificado",115,68,47,16,J18
Izabal,"Diabetes mellitus, no especificada",110,45,65,16,E14
Izabal,"Accidente de vehículo de motor o sin motor, tipo de vehículo no especificado",107,95,12,16,V89
Izabal,Insuficiencia renal no especificada,92,49,43,16,N19
Izabal,Otras gastroenteritis y colitis de origen infeccioso y no especificado,72,35,37,16,A09
Izabal,"Accidente vascular encefálico agudo, no especificado como hemorrágico o isquémico",58,28,30,16,I64
Izabal,Exposición a factores no especificados,53,40,13,16,X59
Izabal,Fibrosis y cirrosis del hígado,43,27,16,16,K74
Izabal,Insuficiencia cardíaca,40,12,28,16,I50
Izabal,Otros trastornos y los no especificados del sistema circulatorio,39,19,20,16,I99
Izabal,Otras sepsis,35,20,15,16,A41
Izabal,"Otros trastornos de los líquidos, de los electrólitos y del equilibrio ácido-básico",28,15,13,16,E87
Izabal,Enfermedad renal crónica,28,15,13,16,N18
Izabal,"Síntomas, signos y hallazgos anormales clínicos y de laboratorio, no clasificados en otra parte",202,102,100,16,R00 - R99
Izabal,Otras causas,813,460,353,16,Otras causas
Zacapa,Todas las causas,1545,900,645,16,Todas las causas
Zacapa,Infarto agudo del miocardio,296,158,138,16,I21
Zacapa,"Agresión con disparo de otras armas de fuego, y las no especificadas",109,100,9,16,X95
Zacapa,"Diabetes mellitus, no especificada",73,28,45,16,E14
Zacapa,"Neumonía, organismo no especificado",67,28,39,16,J18
Zacapa,"Accidente de vehículo de motor o sin motor, tipo de vehículo no especificado",58,44,14,16,V89
Zacapa,Exposición a factores no especificados,58,47,11,16,X59
Zacapa,Diabetes mellitus no insulinodependiente,46,18,28,16,E11
Zacapa,Insuficiencia cardíaca,41,22,19,16,I50
Zacapa,Fibrosis y cirrosis del hígado,40,25,15,16,K74
Zacapa,"Accidente vascular encefálico agudo, no especificado como hemorrágico o isquémico",36,19,17,16,I64
Zacapa,Otras enfermedades cerebrovasculares,32,17,15,16,I67
Zacapa,Tumor maligno del estómago,31,15,16,16,C16
Zacapa,Otras enfermedades pulmonares obstructivas crónicas,26,12,14,16,J44
Zacapa,Otras gastroenteritis y colitis de origen infeccioso y no especificado,22,15,7,16,A09
Zacapa,Tumor maligno del hígado y de las vías biliares intrahepáticas,19,7,12,16,C22
Zacapa,"Síntomas, signos y hallazgos anormales clínicos y de laboratorio, no clasificados en otra parte",32,16,16,16,R00 - R99
Zacapa,Otras causas,559,329,230,16,Otras causas
Chiquimula,Todas las causas,2022,1190,832,16,Todas las causas
Chiquimula,Infarto agudo del miocardio,239,135,104,16,I21
Chiquimula,"Neumonía, organismo no especificado",165,87,78,16,J18
Chiquimula,Insuficiencia cardíaca,134,76,58,16,I50
Chiquimula,"Diabetes mellitus, no especificada",107,41,66,16,E14
Chiquimula,"Disparo de otras armas de fuego, y las no especificadas",91,80,11,16,W34
Chiquimula,Exposición a factores no especificados,86,73,13,16,X59
Chiquimula,"Accidente vascular encefálico agudo, no especificado como hemorrágico o isquémico",83,47,36,16,I64
Chiquimula,Tumor maligno del estómago,60,28,32,16,C16
Chiquimula,Fibrosis y cirrosis del hígado,50,37,13,16,K74
Chiquimula,"Agresión con disparo de otras armas de fuego, y las no especificadas",42,39,3,16,X95
Chiquimula,Otras enfermedades cerebrovasculares,34,9,25,16,I67
Chiquimula,Otras enfermedades pulmonares obstructivas crónicas,34,16,18,16,J44
Chiquimula,Otras gastroenteritis y colitis de origen infeccioso y no especificado,33,20,13,16,A09
Chiquimula,Diabetes mellitus no insulinodependiente,32,11,21,16,E11
Chiquimula,Tumor maligno del hígado y de las vías biliares intrahepáticas,28,17,11,16,C22
Chiquimula,"Síntomas, signos y hallazgos anormales clínicos y de laboratorio, no clasificados en otra parte",78,33,45,16,R00 - R99
Chiquimula,Otras causas,726,441,285,16,Otras causas
Jalapa,Todas las causas,1767,993,774,16,Todas las causas
Jalapa,"Neumonía, organismo no especificado",125,64,61,16,J18
Jalapa,Infarto agudo del miocardio,90,51,39,16,I21
Jalapa,"Diabetes mellitus, no especificada",86,33,53,16,E14
Jalapa,Otros trastornos del encéfalo,69,29,40,16,G93
Jalapa,"Agresión con disparo de otras armas de fuego, y las no especificadas",64,59,5,16,X95
Jalapa,Otras gastroenteritis y colitis de origen infeccioso y no especificado,50,25,25,16,A09
Jalapa,Exposición a factores no especificados,46,35,11,16,X59
Jalapa,"Disparo de otras armas de fuego, y las no especificadas",41,38,3,16,W34
Jalapa,Insuficiencia cardíaca,39,22,17,16,I50
Jalapa,"Accidente vascular encefálico agudo, no especificado como hemorrágico o isquémico",37,18,19,16,I64
Jalapa,Otras enfermedades pulmonares obstructivas crónicas,36,16,20,16,J44
Jalapa,Otros trastornos y los no especificados del sistema circulatorio,29,15,14,16,I99
Jalapa,Fibrosis y cirrosis del hígado,29,16,13,16,K74
Jalapa,Tumor maligno del hígado y de las vías biliares intrahepáticas,27,15,12,16,C22
Jalapa,Tumor maligno del estómago,25,10,15,16,C16
Jalapa,"Síntomas, signos y hallazgos anormales clínicos y de laboratorio, no clasificados en otra parte",281,150,131,16,R00 - R99
Jalapa,Otras causas,693,397,296,16,Otras causas
Jutiapa,Todas las causas,2708,1582,1126,16,Todas las causas
Jutiapa,Infarto agudo del miocardio,466,247,219,16,I21
Jutiapa,"Accidente vascular encefálico agudo, no especificado como hemorrágico o isquémico",180,99,81,16,I64
Jutiapa,"Agresión con disparo de otras armas de fuego, y las no especificadas",166,158,8,16,X95
Jutiapa,"Diabetes mellitus, no especificada",165,54,111,16,E14
Jutiapa,"Neumonía, organismo no especificado",132,78,54,16,J18
Jutiapa,Exposición a factores no especificados,81,64,17,16,X59
Jutiapa,Tumor maligno del estómago,70,35,35,16,C16
Jutiapa,Insuficiencia cardíaca,68,33,35,16,I50
Jutiapa,Fibrosis y cirrosis del hígado,65,39,26,16,K74
Jutiapa,Enfermedad renal crónica,65,41,24,16,N18
Jutiapa,"Accidente de vehículo de motor o sin motor, tipo de vehículo no especificado",65,55,10,16,V89
Jutiapa,Tumor maligno del hígado y de las vías biliares intrahepáticas,46,16,30,16,C22
Jutiapa,Diabetes mellitus no insulinodependiente,46,16,30,16,E11
Jutiapa,Tumor maligno de la próstata,42,42,0,16,C61
Jutiapa,Hipertensión esencial (primaria),32,20,12,16,I10
Jutiapa,"Síntomas, signos y hallazgos anormales clínicos y de laboratorio, no clasificados en otra parte",113,60,53,16,R00 - R99
Jutiapa,Otras causas,906,525,381,16,Otras causas
Extranjero,Todas las causas,83,53,30,16,Todas las causas
Extranjero,Exposición a factores no especificados,14,10,4,16,X59
Extranjero,"Agresión con disparo de otras armas de fuego, y las no especificadas",9,9,0,16,X95
Extranjero,"Accidente de vehículo de motor o sin motor, tipo de vehículo no especificado",7,5,2,16,V89
Extranjero,Infarto agudo del miocardio,4,2,2,16,I21
Extranjero,"Neumonía, organismo no especificado",3,1,2,16,J18
Extranjero,Tumor maligno del cuello del útero,2,0,2,16,C53
Extranjero,"Diabetes mellitus, no especificada",2,1,1,16,E14
Extranjero,Otros trastornos del encéfalo,2,1,1,16,G93
Extranjero,Fibrosis y cirrosis del hígado,2,0,2,16,K74
Extranjero,Pancreatitis aguda,2,2,0,16,K85
Extranjero,Otras malformaciones congénitas del corazón,2,1,1,16,Q24
Extranjero,Ahogamiento y sumersión no especificados,2,1,1,16,W74
Extranjero,"Tuberculosis respiratoria, no confirmada bacteriológica o histológicamente",1,1,0,16,A16
Extranjero,Otras sepsis,1,0,1,16,A41
Extranjero,"Enfermedad por virus de la inmunodeficiencia humana [VIH], resultante en enfermedades infecciosas y parasitarias",1,1,0,16,B20
Extranjero,"Síntomas, signos y hallazgos anormales clínicos y de laboratorio, no clasificados en otra parte",8,5,3,16,R00 - R99
Extranjero,Otras causas,21,13,8,16,Otras causas
Ignorado,Todas las causas,7811,4643,3168,16,Todas las causas
Ignorado,"Neumonía, organismo no especificado",1023,572,451,16,J18
Ignorado,Otras gastroenteritis y colitis de origen infeccioso y no especificado,504,298,206,16,A09
Ignorado,Dificultad respiratoria del recién nacido,392,244,148,16,P22
Ignorado,"Agresión con disparo de otras armas de fuego, y las no especificadas",324,267,57,16,X95
Ignorado,Exposición a factores no especificados,276,227,49,16,X59
Ignorado,Neumonía congénita,240,137,103,16,P23
Ignorado,Sepsis bacteriana del recién nacido,229,133,96,16,P36
Ignorado,Otras malformaciones congénitas del corazón,181,106,75,16,Q24
Ignorado,"Otras malformaciones congénitas, no clasificadas en otra parte",153,79,74,16,Q89
Ignorado,"Trastornos relacionados con duración corta de la gestación y con bajo peso al nacer, no clasificados en otra parte",133,84,49,16,P07
Ignorado,Otras sepsis,131,77,54,16,A41
Ignorado,Asfixia del nacimiento,126,79,47,16,P21
Ignorado,Síndromes de aspiración neonatal,109,45,64,16,P24
Ignorado,"Accidente de vehículo de motor o sin motor, tipo de vehículo no especificado",96,68,28,16,V89
Ignorado,Trastornos cardiovasculares originados en el período perinatal,83,43,40,16,P29
Ignorado,"Síntomas, signos y hallazgos anormales clínicos y de laboratorio, no clasificados en otra parte",743,403,340,16,R00 - R99
Ignorado,Otras causas,3068,1781,1287,16,Otras causas
Todos los departamentos,Todas las causas,81726,45726,36000,17,Todas las causas
Todos los departamentos,"Neumonía, organismo no especificado",6840,3639,3201,17,J18
Todos los departamentos,Infarto agudo del miocardio,5524,2989,2535,17,I21
Todos los departamentos,"Diabetes mellitus, no especificada",4472,1822,2650,17,E14
Todos los departamentos,"Agresión con disparo de otras armas de fuego, y las no especificadas",2944,2577,367,17,X95
Todos los departamentos,Exposición a factores no especificados,2741,2212,529,17,X59
Todos los departamentos,Fibrosis y cirrosis del hígado,2388,1563,825,17,K74
Todos los departamentos,Otras gastroenteritis y colitis de origen infeccioso y no especificado,1891,976,915,17,A09
Todos los departamentos,"Accidente vascular encefálico agudo, no especificado como hemorrágico o isquémico",1617,767,850,17,I64
Todos los departamentos,Diabetes mellitus no insulinodependiente,1524,609,915,17,E11
Todos los departamentos,"Accidente de vehículo de motor o sin motor, tipo de vehículo no especificado",1516,1277,239,17,V89
Todos los departamentos,Enfermedad renal crónica,1487,780,707,17,N18
Todos los departamentos,Insuficiencia cardíaca,1464,659,805,17,I50
Todos los departamentos,Tumor maligno del hígado y de las vías biliares intrahepáticas,1427,673,754,17,C22
Todos los departamentos,Tumor maligno del estómago,1236,585,651,17,C16
Todos los departamentos,Otras sepsis,1056,563,493,17,A41
Todos los departamentos,"Síntomas, signos y hallazgos anormales clínicos y de laboratorio, no clasificados en otra parte",9295,4839,4456,17,R00 - R99
Todos los departamentos,Otras causas,34304,19196,15108,17,Otras causas
Guatemala,Todas las causas,18182,10129,8053,17,Todas las causas
Guatemala,"Diabetes mellitus, no especificada",1360,605,755,17,E14
Guatemala,Infarto agudo del miocardio,1224,677,547,17,I21
Guatemala,"Agresión con disparo de otras armas de fuego, y las no especificadas",1088,933,155,17,X95
Guatemala,Exposición a factores no especificados,860,706,154,17,X59
Guatemala,"Neumonía, organismo no especificado",819,434,385,17,J18
Guatemala,Fibrosis y cirrosis del hígado,744,541,203,17,K74
Guatemala,Enfermedad renal crónica,479,247,232,17,N18
Guatemala,Tumor maligno del hígado y de las vías biliares intrahepáticas,431,196,235,17,C22
Guatemala,Diabetes mellitus no insulinodependiente,405,159,246,17,E11
Guatemala,Insuficiencia cardíaca,313,128,185,17,I50
Guatemala,Otras sepsis,300,158,142,17,A41
Guatemala,"Disparo de otras armas de fuego, y las no especificadas",291,247,44,17,W34
Guatemala,Tumor maligno del estómago,276,114,162,17,C16
Guatemala,"Accidente vascular encefálico agudo, no especificado como hemorrágico o isquémico",263,116,147,17,I64
Guatemala,Insuficiencia renal no especificada,211,101,110,17,N19
Guatemala,"Síntomas, signos y hallazgos anormales clínicos y de laboratorio, no clasificados en otra parte",1652,807,845,17,R00 - R99
Guatemala,Otras causas,7466,3960,3506,17,Otras causas
El Progreso,Todas las causas,1079,596,483,17,Todas las causas
El Progreso,Infarto agudo del miocardio,158,87,71,17,I21
El Progreso,"Neumonía, organismo no especificado",74,32,42,17,J18
El Progreso,"Diabetes mellitus, no especificada",72,24,48,17,E14
El Progreso,"Accidente vascular encefálico agudo, no especificado como hemorrágico o isquémico",49,20,29,17,I64
El Progreso,"Agresión con disparo de otras armas de fuego, y las no especificadas",37,30,7,17,X95
El Progreso,Tumor maligno del hígado y de las vías biliares intrahepáticas,36,22,14,17,C22
El Progreso,Otras enfermedades cerebrovasculares,31,15,16,17,I67
El Progreso,Tumor maligno del estómago,30,16,14,17,C16
El Progreso,"Accidente de vehículo de motor o sin motor, tipo de vehículo no especificado",30,22,8,17,V89
El Progreso,Otras enfermedades pulmonares obstructivas crónicas,26,13,13,17,J44
El Progreso,Exposición a factores no especificados,26,23,3,17,X59
El Progreso,Fibrosis y cirrosis del hígado,21,12,9,17,K74
El Progreso,Tumor maligno de la próstata,16,16,0,17,C61
El Progreso,Hipertensión esencial (primaria),16,8,8,17,I10
El Progreso,"Desnutrición proteicocalórica, no especificada",15,5,10,17,E46
El Progreso,"Síntomas, signos y hallazgos anormales clínicos y de laboratorio, no clasificados en otra parte",53,32,21,17,R00 - R99
El Progreso,Otras causas,389,219,170,17,Otras causas
Sacatepequez,Todas las causas,1652,901,751,17,Todas las causas
Sacatepequez,"Diabetes mellitus, no especificada",112,42,70,17,E14
Sacatepequez,"Neumonía, organismo no especificado",98,56,42,17,J18
Sacatepequez,Infarto agudo del miocardio,95,49,46,17,I21
Sacatepequez,Diabetes mellitus no insulinodependiente,84,31,53,17,E11
Sacatepequez,Exposición a factores no especificados,67,52,15,17,X59
Sacatepequez,Fibrosis y cirrosis del hígado,59,40,19,17,K74
Sacatepequez,"Desnutrición proteicocalórica, no especificada",41,22,19,17,E46
Sacatepequez,Tumor maligno del hígado y de las vías biliares intrahepáticas,38,17,21,17,C22
Sacatepequez,"Accidente vascular encefálico agudo, no especificado como hemorrágico o isquémico",38,14,24,17,I64
Sacatepequez,Enfermedad renal crónica,35,17,18,17,N18
Sacatepequez,"Accidente de vehículo de motor o sin motor, tipo de vehículo no especificado",30,26,4,17,V89
Sacatepequez,Tumor maligno del estómago,28,12,16,17,C16
Sacatepequez,Enfermedad alcohólica del hígado,24,21,3,17,K70
Sacatepequez,"Agresión con disparo de otras armas de fuego, y las no especificadas",24,20,4,17,X95
Sacatepequez,Otras enfermedades cerebrovasculares,23,11,12,17,I67
Sacatepequez,"Síntomas, signos y hallazgos anormales clínicos y de laboratorio, no clasificados en otra parte",182,102,80,17,R00 - R99
Sacatepequez,Otras causas,674,369,305,17,Otras causas
Chimaltenango,Todas las causas,2893,1557,1336,17,Todas las causas
Chimaltenango,"Neumonía, organismo no especificado",410,210,200,17,J18
Chimaltenango,"Diabetes mellitus, no especificada",177,66,111,17,E14
Chimaltenango,Infarto agudo del miocardio,121,62,59,17,I21
Chimaltenango,Fibrosis y cirrosis del hígado,100,60,40,17,K74
Chimaltenango,Insuficiencia cardíaca,92,34,58,17,I50
Chimaltenango,Exposición a factores no especificados,91,73,18,17,X59
Chimaltenango,"Accidente vascular encefálico agudo, no especificado como hemorrágico o isquémico",81,34,47,17,I64
Chimaltenango,Enfermedad alcohólica del hígado,78,65,13,17,K70
Chimaltenango,Diabetes mellitus no insulinodependiente,70,29,41,17,E11
Chimaltenango,Tumor maligno del estómago,68,31,37,17,C16
Chimaltenango,Otras gastroenteritis y colitis de origen infeccioso y no especificado,63,32,31,17,A09
Chimaltenango,Enfermedad renal crónica,55,27,28,17,N18
Chimaltenango,"Agresión con disparo de otras armas de fuego, y las no especificadas",50,46,4,17,X95
Chimaltenango,"Envenenamiento accidental por, y exposición al alcohol",46,44,2,17,X45
Chimaltenango,Tumor maligno del hígado y de las vías biliares intrahepáticas,45,18,27,17,C22
Chimaltenango,"Síntomas, signos y hallazgos anormales clínicos y de laboratorio, no clasificados en otra parte",199,115,84,17,R00 - R99
Chimaltenango,Otras causas,1147,611,536,17,Otras causas
Escuintla,Todas las causas,4278,2481,1797,17,Todas las causas
Escuintla,Infarto agudo del miocardio,453,269,184,17,I21
Escuintla,"Diabetes mellitus, no especificada",328,120,208,17,E14
Escuintla,"Neumonía, organismo no especificado",302,165,137,17,J18
Escuintla,"Agresión con disparo de otras armas de fuego, y las no especificadas",266,227,39,17,X95
Escuintla,"Accidente de vehículo de motor o sin motor, tipo de vehículo no especificado",164,144,20,17,V89
Escuintla,Enfermedad renal crónica,163,99,64,17,N18
Escuintla,Fibrosis y cirrosis del hígado,133,84,49,17,K74
Escuintla,Exposición a factores no especificados,133,114,19,17,X59
Escuintla,Diabetes mellitus no insulinodependiente,98,34,64,17,E11
Escuintla,"Accidente vascular encefálico agudo, no especificado como hemorrágico o isquémico",83,40,43,17,I64
Escuintla,Tumor maligno del hígado y de las vías biliares intrahepáticas,81,46,35,17,C22
Escuintla,"Otros trastornos de los líquidos, de los electrólitos y del equilibrio ácido-básico",78,36,42,17,E87
Escuintla,Insuficiencia renal no especificada,70,34,36,17,N19
Escuintla,Otras sepsis,50,24,26,17,A41
Escuintla,Tumor maligno del estómago,48,23,25,17,C16
Escuintla,"Síntomas, signos y hallazgos anormales clínicos y de laboratorio, no clasificados en otra parte",371,192,179,17,R00 - R99
Escuintla,Otras causas,1457,830,627,17,Otras causas
Santa Rosa,Todas las causas,2206,1277,929,17,Todas las causas
Santa Rosa,Infarto agudo del miocardio,166,101,65,17,I21
Santa Rosa,"Neumonía, organismo no especificado",134,77,57,17,J18
Santa Rosa,"Agresión con disparo de otras armas de fuego, y las no especificadas",121,114,7,17,X95
Santa Rosa,"Diabetes mellitus, no especificada",116,43,73,17,E14
Santa Rosa,"Accidente de vehículo de motor o sin motor, tipo de vehículo no especificado",87,72,15,17,V89
Santa Rosa,Insuficiencia cardíaca,73,33,40,17,I50
Santa Rosa,Enfermedad renal crónica,65,36,29,17,N18
Santa Rosa,Exposición a factores no especificados,64,55,9,17,X59
Santa Rosa,"Accidente vascular encefálico agudo, no especificado como hemorrágico o isquémico",47,28,19,17,I64
Santa Rosa,Fibrosis y cirrosis del hígado,46,23,23,17,K74
Santa Rosa,Tumor maligno del hígado y de las vías biliares intrahepáticas,42,14,28,17,C22
Santa Rosa,Tumor maligno del estómago,37,19,18,17,C16
Santa Rosa,Insuficiencia renal no especificada,35,15,20,17,N19
Santa Rosa,Diabetes mellitus no insulinodependiente,34,9,25,17,E11
Santa Rosa,Otras sepsis,33,17,16,17,A41
Santa Rosa,"Síntomas, signos y hallazgos anormales clínicos y de laboratorio, no clasificados en otra parte",332,176,156,17,R00 - R99
Santa Rosa,Otras causas,774,445,329,17,Otras causas
Solola,Todas las causas,1837,980,857,17,Todas las causas
Solola,"Neumonía, organismo no especificado",219,97,122,17,J18
Solola,"Diabetes mellitus, no especificada",86,35,51,17,E14
Solola,Infarto agudo del miocardio,78,39,39,17,I21
Solola,Otras gastroenteritis y colitis de origen infeccioso y no especificado,58,23,35,17,A09
Solola,Exposición a factores no especificados,52,37,15,17,X59
Solola,Diabetes mellitus no insulinodependiente,50,28,22,17,E11
Solola,"Accidente vascular encefálico agudo, no especificado como hemorrágico o isquémico",44,26,18,17,I64
Solola,"Envenenamiento accidental por, y exposición al alcohol",43,40,3,17,X45
Solola,Enfermedad alcohólica del hígado,42,37,5,17,K70
Solola,Fibrosis y cirrosis del hígado,41,27,14,17,K74
Solola,"Desnutrición proteicocalórica, no especificada",39,19,20,17,E46
Solola,Trastornos mentales y del comportamiento debidos al uso de alcohol,35,31,4,17,F10
Solola,Otras sepsis,34,17,17,17,A41
Solola,Otras enfermedades pulmonares obstructivas crónicas,31,16,15,17,J44
Solola,Insuficiencia cardíaca,27,4,23,17,I50
Solola,"Síntomas, signos y hallazgos anormales clínicos y de laboratorio, no clasificados en otra parte",204,111,93,17,R00 - R99
Solola,Otras causas,754,393,361,17,Otras causas
Totonicapan,Todas las causas,2420,1325,1095,17,Todas las causas
Totonicapan,"Neumonía, organismo no especificado",208,109,99,17,J18
Totonicapan,"Diabetes mellitus, no especificada",114,61,53,17,E14
Totonicapan,Otras gastroenteritis y colitis de origen infeccioso y no especificado,96,48,48,17,A09
Totonicapan,Fibrosis y cirrosis del hígado,83,62,21,17,K74
Totonicapan,"Envenenamiento accidental por, y exposición al alcohol",76,67,9,17,X45
Totonicapan,Infarto agudo del miocardio,48,26,22,17,I21
Totonicapan,Trastornos mentales y del comportamiento debidos al uso de alcohol,47,40,7,17,F10
Totonicapan,Enfermedad alcohólica del hígado,43,33,10,17,K70
Totonicapan,Exposición a factores no especificados,42,36,6,17,X59
Totonicapan,Diabetes mellitus no insulinodependiente,37,21,16,17,E11
Totonicapan,Tumor maligno de sitios no especificados,35,12,23,17,C80
Totonicapan,"Accidente de vehículo de motor o sin motor, tipo de vehículo no especificado",35,29,6,17,V89
Totonicapan,Hipertensión esencial (primaria),33,14,19,17,I10
Totonicapan,Otros trastornos del encéfalo,24,11,13,17,G93
Totonicapan,Insuficiencia cardíaca,24,8,16,17,I50
Totonicapan,"Síntomas, signos y hallazgos anormales clínicos y de laboratorio, no clasificados en otra parte",803,400,403,17,R00 - R99
Totonicapan,Otras causas,672,348,324,17,Otras causas
Quetzaltenango,Todas las causas,4362,2375,1987,17,Todas las causas
Quetzaltenango,"Diabetes mellitus, no especificada",305,142,163,17,E14
Quetzaltenango,"Neumonía, organismo no especificado",251,137,114,17,J18
Quetzaltenango,Infarto agudo del miocardio,218,113,105,17,I21
Quetzaltenango,Insuficiencia cardíaca,168,68,100,17,I50
Quetzaltenango,Fibrosis y cirrosis del hígado,145,89,56,17,K74
Quetzaltenango,Exposición a factores no especificados,111,80,31,17,X59
Quetzaltenango,"Agresión con disparo de otras armas de fuego, y las no especificadas",105,95,10,17,X95
Quetzaltenango,Enfermedad alcohólica del hígado,102,87,15,17,K70
Quetzaltenango,Diabetes mellitus no insulinodependiente,99,43,56,17,E11
Quetzaltenango,"Accidente de vehículo de motor o sin motor, tipo de vehículo no especificado",87,74,13,17,V89
Quetzaltenango,"Envenenamiento accidental por, y exposición al alcohol",78,62,16,17,X45
Quetzaltenango,Tumor maligno del hígado y de las vías biliares intrahepáticas,76,39,37,17,C22
Quetzaltenango,Trastornos mentales y del comportamiento debidos al uso de alcohol,73,64,9,17,F10
Quetzaltenango,"Accidente vascular encefálico agudo, no especificado como hemorrágico o isquémico",70,32,38,17,I64
Quetzaltenango,Insuficiencia renal no especificada,70,40,30,17,N19
Quetzaltenango,"Síntomas, signos y hallazgos anormales clínicos y de laboratorio, no clasificados en otra parte",434,209,225,17,R00 - R99
Quetzaltenango,Otras causas,1970,1001,969,17,Otras causas
Suchitepequez,Todas las causas,2927,1633,1294,17,Todas las causas
Suchitepequez,"Diabetes mellitus, no especificada",133,49,84,17,E14
Suchitepequez,Exposición a factores no especificados,131,108,23,17,X59
Suchitepequez,Infarto agudo del miocardio,120,67,53,17,I21
Suchitepequez,Insuficiencia renal no especificada,98,68,30,17,N19
Suchitepequez,"Neumonía, organismo no especificado",96,53,43,17,J18
Suchitepequez,Enfermedad renal crónica,87,53,34,17,N18
Suchitepequez,Fibrosis y cirrosis del hígado,82,44,38,17,K74
Suchitepequez,Tumor maligno del hígado y de las vías biliares intrahepáticas,54,29,25,17,C22
Suchitepequez,"Accidente de vehículo de motor o sin motor, tipo de vehículo no especificado",40,33,7,17,V89
Suchitepequez,"Agresión con disparo de otras armas de fuego, y las no especificadas",32,29,3,17,X95
Suchitepequez,Tumor maligno del estómago,31,12,19,17,C16
Suchitepequez,Diabetes mellitus no insulinodependiente,30,11,19,17,E11
Suchitepequez,Otros trastornos del encéfalo,29,17,12,17,G93
Suchitepequez,"Disparo de otras armas de fuego, y las no especificadas",28,25,3,17,W34
Suchitepequez,"Accidente vascular encefálico agudo, no especificado como hemorrágico o isquémico",24,15,9,17,I64
Suchitepequez,"Síntomas, signos y hallazgos anormales clínicos y de laboratorio, no clasificados en otra parte",1168,606,562,17,R00 - R99
Suchitepequez,Otras causas,744,414,330,17,Otras causas
Retalhuleu,Todas las causas,1837,1038,799,17,Todas las causas
Retalhuleu,"Diabetes mellitus, no especificada",102,40,62,17,E14
Retalhuleu,Insuficiencia renal no especificada,91,54,37,17,N19
Retalhuleu,Fibrosis y cirrosis del hígado,68,41,27,17,K74
Retalhuleu,"Neumonía, organismo no especificado",63,34,29,17,J18
Retalhuleu,"Agresión con disparo de otras armas de fuego, y las no especificadas",61,59,2,17,X95
Retalhuleu,Infarto agudo del miocardio,48,25,23,17,I21
Retalhuleu,"Accidente de vehículo de motor o sin motor, tipo de vehículo no especificado",46,40,6,17,V89
Retalhuleu,Exposición a factores no especificados,45,37,8,17,X59
Retalhuleu,Otros trastornos y los no especificados del sistema circulatorio,30,20,10,17,I99
Retalhuleu,Enfermedad renal crónica,28,20,8,17,N18
Retalhuleu,Otros trastornos del encéfalo,27,14,13,17,G93
Retalhuleu,Otras sepsis,26,16,10,17,A41
Retalhuleu,Tumor maligno del hígado y de las vías biliares intrahepáticas,22,10,12,17,C22
Retalhuleu,Insuficiencia cardíaca,22,9,13,17,I50
Retalhuleu,Otras anemias,16,10,6,17,D64
Retalhuleu,"Síntomas, signos y hallazgos anormales clínicos y de laboratorio, no clasificados en otra parte",666,355,311,17,R00 - R99
Retalhuleu,Otras causas,476,254,222,17,Otras causas
San Marcos,Todas las causas,4853,2755,2098,17,Todas las causas
San Marcos,"Neumonía, organismo no especificado",663,387,276,17,J18
San Marcos,Infarto agudo del miocardio,431,229,202,17,I21
San Marcos,"Diabetes mellitus, no especificada",238,94,144,17,E14
San Marcos,Fibrosis y cirrosis del hígado,179,120,59,17,K74
San Marcos,Otras gastroenteritis y colitis de origen infeccioso y no especificado,151,86,65,17,A09
San Marcos,Exposición a factores no especificados,138,113,25,17,X59
San Marcos,Diabetes mellitus no insulinodependiente,118,44,74,17,E11
San Marcos,Insuficiencia cardíaca,113,63,50,17,I50
San Marcos,"Accidente vascular encefálico agudo, no especificado como hemorrágico o isquémico",106,41,65,17,I64
San Marcos,Tumor maligno del hígado y de las vías biliares intrahepáticas,91,47,44,17,C22
San Marcos,"Envenenamiento accidental por, y exposición al alcohol",91,87,4,17,X45
San Marcos,"Agresión con disparo de otras armas de fuego, y las no especificadas",90,81,9,17,X95
San Marcos,Tumor maligno del estómago,78,41,37,17,C16
San Marcos,Enfermedad renal crónica,77,34,43,17,N18
San Marcos,Insuficiencia renal no especificada,70,43,27,17,N19
San Marcos,"Síntomas, signos y hallazgos anormales clínicos y de laboratorio, no clasificados en otra parte",450,249,201,17,R00 - R99
San Marcos,Otras causas,1769,996,773,17,Otras causas
Huehuetenango,Todas las causas,4554,2548,2006,17,Todas las causas
Huehuetenango,"Neumonía, organismo no especificado",607,346,261,17,J18
Huehuetenango,Infarto agudo del miocardio,334,189,145,17,I21
Huehuetenango,"Diabetes mellitus, no especificada",265,98,167,17,E14
Huehuetenango,Otras gastroenteritis y colitis de origen infeccioso y no especificado,182,97,85,17,A09
Huehuetenango,"Accidente vascular encefálico agudo, no especificado como hemorrágico o isquémico",154,89,65,17,I64
Huehuetenango,Exposición a factores no especificados,139,112,27,17,X59
Huehuetenango,Tumor maligno del estómago,120,54,66,17,C16
Huehuetenango,Otras enfermedades cerebrovasculares,102,43,59,17,I67
Huehuetenango,Tumor maligno del hígado y de las vías biliares intrahepáticas,101,44,57,17,C22
Huehuetenango,Fibrosis y cirrosis del hígado,98,64,34,17,K74
Huehuetenango,"Envenenamiento accidental por, y exposición al alcohol",92,87,5,17,X45
Huehuetenango,Insuficiencia cardíaca,87,43,44,17,I50
Huehuetenango,Enfermedad renal crónica,77,35,42,17,N18
Huehuetenango,"Accidente de vehículo de motor o sin motor, tipo de vehículo no especificado",73,60,13,17,V89
Huehuetenango,Diabetes mellitus no insulinodependiente,72,38,34,17,E11
Huehuetenango,"Síntomas, signos y hallazgos anormales clínicos y de laboratorio, no clasificados en otra parte",141,77,64,17,R00 - R99
Huehuetenango,Otras causas,1910,1072,838,17,Otras causas
Quiche,Todas las causas,3841,2078,1763,17,Todas las causas
Quiche,"Neumonía, organismo no especificado",423,215,208,17,J18
Quiche,Otras gastroenteritis y colitis de origen infeccioso y no especificado,151,79,72,17,A09
Quiche,Infarto agudo del miocardio,126,65,61,17,I21
Quiche,"Diabetes mellitus, no especificada",121,50,71,17,E14
Quiche,Exposición a factores no especificados,88,72,16,17,X59
Quiche,"Envenenamiento accidental por, y exposición al alcohol",76,72,4,17,X45
Quiche,Fibrosis y cirrosis del hígado,73,50,23,17,K74
Quiche,Diabetes mellitus no insulinodependiente,70,28,42,17,E11
Quiche,Insuficiencia cardíaca,57,24,33,17,I50
Quiche,"Accidente de vehículo de motor o sin motor, tipo de vehículo no especificado",56,49,7,17,V89
Quiche,Enfermedad renal crónica,54,30,24,17,N18
Quiche,Tumor maligno del hígado y de las vías biliares intrahepáticas,53,25,28,17,C22
Quiche,Tumor maligno del estómago,50,22,28,17,C16
Quiche,"Accidente vascular encefálico agudo, no especificado como hemorrágico o isquémico",49,23,26,17,I64
Quiche,Enfermedad alcohólica del hígado,48,40,8,17,K70
Quiche,"Síntomas, signos y hallazgos anormales clínicos y de laboratorio, no clasificados en otra parte",1023,510,513,17,R00 - R99
Quiche,Otras causas,1323,724,599,17,Otras causas
Baja Verapaz,Todas las causas,1352,729,623,17,Todas las causas
Baja Verapaz,Infarto agudo del miocardio,140,74,66,17,I21
Baja Verapaz,"Neumonía, organismo no especificado",131,70,61,17,J18
Baja Verapaz,"Accidente vascular encefálico agudo, no especificado como hemorrágico o isquémico",74,33,41,17,I64
Baja Verapaz,"Diabetes mellitus, no especificada",60,20,40,17,E14
Baja Verapaz,Tumor maligno del estómago,40,23,17,17,C16
Baja Verapaz,"Accidente de vehículo de motor o sin motor, tipo de vehículo no especificado",38,27,11,17,V89
Baja Verapaz,Otras gastroenteritis y colitis de origen infeccioso y no especificado,37,17,20,17,A09
Baja Verapaz,Exposición a factores no especificados,35,20,15,17,X59
Baja Verapaz,Hipertensión esencial (primaria),33,16,17,17,I10
Baja Verapaz,Diabetes mellitus no insulinodependiente,32,11,21,17,E11
Baja Verapaz,Fibrosis y cirrosis del hígado,32,20,12,17,K74
Baja Verapaz,Insuficiencia cardíaca,27,15,12,17,I50
Baja Verapaz,"Agresión con disparo de otras armas de fuego, y las no especificadas",20,19,1,17,X95
Baja Verapaz,Tumor maligno del hígado y de las vías biliares intrahepáticas,18,10,8,17,C22
Baja Verapaz,Tumor maligno de la próstata,16,16,0,17,C61
Baja Verapaz,"Síntomas, signos y hallazgos anormales clínicos y de laboratorio, no clasificados en otra parte",89,46,43,17,R00 - R99
Baja Verapaz,Otras causas,530,292,238,17,Otras causas
Alta Verapaz,Todas las causas,4899,2522,2377,17,Todas las causas
Alta Verapaz,"Neumonía, organismo no especificado",918,423,495,17,J18
Alta Verapaz,Otras gastroenteritis y colitis de origen infeccioso y no especificado,371,185,186,17,A09
Alta Verapaz,Infarto agudo del miocardio,298,135,163,17,I21
Alta Verapaz,"Diabetes mellitus, no especificada",187,59,128,17,E14
Alta Verapaz,Fibrosis y cirrosis del hígado,167,86,81,17,K74
Alta Verapaz,Exposición a factores no especificados,121,91,30,17,X59
Alta Verapaz,Otras sepsis,107,57,50,17,A41
Alta Verapaz,Tumor maligno del hígado y de las vías biliares intrahepáticas,103,43,60,17,C22
Alta Verapaz,Otras enfermedades pulmonares obstructivas crónicas,92,39,53,17,J44
Alta Verapaz,"Accidente vascular encefálico agudo, no especificado como hemorrágico o isquémico",91,41,50,17,I64
Alta Verapaz,"Desnutrición proteicocalórica, no especificada",86,46,40,17,E46
Alta Verapaz,Sepsis bacteriana del recién nacido,73,43,30,17,P36
Alta Verapaz,Tumor maligno del estómago,67,36,31,17,C16
Alta Verapaz,Úlcera gástrica,67,30,37,17,K25
Alta Verapaz,Neumonía congénita,54,25,29,17,P23
Alta Verapaz,"Síntomas, signos y hallazgos anormales clínicos y de laboratorio, no clasificados en otra parte",195,115,80,17,R00 - R99
Alta Verapaz,Otras causas,1902,1068,834,17,Otras causas
Peten,Todas las causas,2095,1280,815,17,Todas las causas
Peten,"Agresión con disparo de otras armas de fuego, y las no especificadas",140,128,12,17,X95
Peten,"Neumonía, organismo no especificado",130,80,50,17,J18
Peten,Infarto agudo del miocardio,127,75,52,17,I21
Peten,"Diabetes mellitus, no especificada",121,54,67,17,E14
Peten,"Accidente de vehículo de motor o sin motor, tipo de vehículo no especificado",118,107,11,17,V89
Peten,Agresión por medios no especificados,72,70,2,17,Y09
Peten,Diabetes mellitus no insulinodependiente,69,31,38,17,E11
Peten,Exposición a factores no especificados,66,55,11,17,X59
Peten,Fibrosis y cirrosis del hígado,61,31,30,17,K74
Peten,Tumor maligno del estómago,44,17,27,17,C16
Peten,Tumor maligno del hígado y de las vías biliares intrahepáticas,40,19,21,17,C22
Peten,Otras gastroenteritis y colitis de origen infeccioso y no especificado,36,13,23,17,A09
Peten,"Accidente vascular encefálico agudo, no especificado como hemorrágico o isquémico",33,13,20,17,I64
Peten,Insuficiencia cardíaca,27,16,11,17,I50
Peten,Otras enfermedades pulmonares obstructivas crónicas,26,16,10,17,J44
Peten,"Síntomas, signos y hallazgos anormales clínicos y de laboratorio, no clasificados en otra parte",122,66,56,17,R00 - R99
Peten,Otras causas,863,489,374,17,Otras causas
Izabal,Todas las causas,2029,1147,882,17,Todas las causas
Izabal,Infarto agudo del miocardio,227,132,95,17,I21
Izabal,"Diabetes mellitus, no especificada",129,47,82,17,E14
Izabal,"Neumonía, organismo no especificado",111,59,52,17,J18
Izabal,"Agresión con disparo de otras armas de fuego, y las no especificadas",108,93,15,17,X95
Izabal,"Accidente de vehículo de motor o sin motor, tipo de vehículo no especificado",99,83,16,17,V89
Izabal,Insuficiencia renal no especificada,62,29,33,17,N19
Izabal,Fibrosis y cirrosis del hígado,53,31,22,17,K74
Izabal,"Accidente vascular encefálico agudo, no especificado como hemorrágico o isquémico",44,21,23,17,I64
Izabal,Exposición a factores no especificados,43,39,4,17,X59
Izabal,Otras gastroenteritis y colitis de origen infeccioso y no especificado,42,18,24,17,A09
Izabal,"Disparo de otras armas de fuego, y las no especificadas",41,38,3,17,W34
Izabal,Insuficiencia cardíaca,33,14,19,17,I50
Izabal,Otras enfermedades pulmonares obstructivas crónicas,31,17,14,17,J44
Izabal,Tumor maligno del hígado y de las vías biliares intrahepáticas,29,15,14,17,C22
Izabal,Tumor maligno del estómago,26,14,12,17,C16
Izabal,"Síntomas, signos y hallazgos anormales clínicos y de laboratorio, no clasificados en otra parte",197,99,98,17,R00 - R99
Izabal,Otras causas,754,398,356,17,Otras causas
Zacapa,Todas las causas,1499,844,655,17,Todas las causas
Zacapa,Infarto agudo del miocardio,253,128,125,17,I21
Zacapa,"Agresión con disparo de otras armas de fuego, y las no especificadas",117,99,18,17,X95
Zacapa,"Diabetes mellitus, no especificada",96,35,61,17,E14
Zacapa,"Neumonía, organismo no especificado",71,32,39,17,J18
Zacapa,"Accidente vascular encefálico agudo, no especificado como hemorrágico o isquémico",45,28,17,17,I64
Zacapa,Exposición a factores no especificados,41,35,6,17,X59
Zacapa,Diabetes mellitus no insulinodependiente,35,9,26,17,E11
Zacapa,Otras enfermedades cerebrovasculares,34,19,15,17,I67
Zacapa,Otras enfermedades pulmonares obstructivas crónicas,33,14,19,17,J44
Zacapa,"Accidente de vehículo de motor o sin motor, tipo de vehículo no especificado",33,31,2,17,V89
Zacapa,Tumor maligno del estómago,26,13,13,17,C16
Zacapa,Tumor maligno del hígado y de las vías biliares intrahepáticas,26,11,15,17,C22
Zacapa,Insuficiencia cardíaca,26,14,12,17,I50
Zacapa,Enfermedad renal crónica,23,13,10,17,N18
Zacapa,Fibrosis y cirrosis del hígado,20,11,9,17,K74
Zacapa,"Síntomas, signos y hallazgos anormales clínicos y de laboratorio, no clasificados en otra parte",34,13,21,17,R00 - R99
Zacapa,Otras causas,586,339,247,17,Otras causas
Chiquimula,Todas las causas,2137,1235,902,17,Todas las causas
Chiquimula,Infarto agudo del miocardio,277,156,121,17,I21
Chiquimula,"Neumonía, organismo no especificado",198,104,94,17,J18
Chiquimula,Exposición a factores no especificados,107,92,15,17,X59
Chiquimula,"Diabetes mellitus, no especificada",93,43,50,17,E14
Chiquimula,Insuficiencia cardíaca,91,43,48,17,I50
Chiquimula,"Disparo de otras armas de fuego, y las no especificadas",83,74,9,17,W34
Chiquimula,"Accidente vascular encefálico agudo, no especificado como hemorrágico o isquémico",68,30,38,17,I64
Chiquimula,"Agresión con disparo de otras armas de fuego, y las no especificadas",62,57,5,17,X95
Chiquimula,Tumor maligno del estómago,51,22,29,17,C16
Chiquimula,Fibrosis y cirrosis del hígado,49,34,15,17,K74
Chiquimula,Otras gastroenteritis y colitis de origen infeccioso y no especificado,39,19,20,17,A09
Chiquimula,Otras enfermedades cerebrovasculares,37,20,17,17,I67
Chiquimula,Diabetes mellitus no insulinodependiente,34,15,19,17,E11
Chiquimula,Otras enfermedades pulmonares obstructivas crónicas,32,19,13,17,J44
Chiquimula,Otras sepsis,29,16,13,17,A41
Chiquimula,"Síntomas, signos y hallazgos anormales clínicos y de laboratorio, no clasificados en otra parte",81,48,33,17,R00 - R99
Chiquimula,Otras causas,806,443,363,17,Otras causas
Jalapa,Todas las causas,1819,1030,789,17,Todas las causas
Jalapa,"Neumonía, organismo no especificado",130,70,60,17,J18
Jalapa,Infarto agudo del miocardio,101,58,43,17,I21
Jalapa,"Diabetes mellitus, no especificada",78,26,52,17,E14
Jalapa,Otros trastornos y los no especificados del sistema circulatorio,73,31,42,17,I99
Jalapa,Otros trastornos del encéfalo,66,31,35,17,G93
Jalapa,Otras gastroenteritis y colitis de origen infeccioso y no especificado,50,35,15,17,A09
Jalapa,"Accidente vascular encefálico agudo, no especificado como hemorrágico o isquémico",45,20,25,17,I64
Jalapa,"Disparo de otras armas de fuego, y las no especificadas",44,40,4,17,W34
Jalapa,Exposición a factores no especificados,40,33,7,17,X59
Jalapa,Otras enfermedades pulmonares obstructivas crónicas,38,26,12,17,J44
Jalapa,"Agresión con disparo de otras armas de fuego, y las no especificadas",38,36,2,17,X95
Jalapa,Fibrosis y cirrosis del hígado,35,22,13,17,K74
Jalapa,Insuficiencia cardíaca,33,15,18,17,I50
Jalapa,Otros trastornos respiratorios,30,15,15,17,J98
Jalapa,Tumor maligno de sitios no especificados,26,10,16,17,C80
Jalapa,"Síntomas, signos y hallazgos anormales clínicos y de laboratorio, no clasificados en otra parte",333,188,145,17,R00 - R99
Jalapa,Otras causas,659,374,285,17,Otras causas
Jutiapa,Todas las causas,2718,1516,1202,17,Todas las causas
Jutiapa,Infarto agudo del miocardio,416,205,211,17,I21
Jutiapa,"Accidente vascular encefálico agudo, no especificado como hemorrágico o isquémico",169,82,87,17,I64
Jutiapa,"Neumonía, organismo no especificado",161,89,72,17,J18
Jutiapa,"Diabetes mellitus, no especificada",147,55,92,17,E14
Jutiapa,"Agresión con disparo de otras armas de fuego, y las no especificadas",137,126,11,17,X95
Jutiapa,Insuficiencia cardíaca,91,51,40,17,I50
Jutiapa,Exposición a factores no especificados,75,57,18,17,X59
Jutiapa,Tumor maligno del estómago,71,44,27,17,C16
Jutiapa,"Accidente de vehículo de motor o sin motor, tipo de vehículo no especificado",68,62,6,17,V89
Jutiapa,Diabetes mellitus no insulinodependiente,66,31,35,17,E11
Jutiapa,Enfermedad renal crónica,51,24,27,17,N18
Jutiapa,Otras enfermedades cerebrovasculares,46,21,25,17,I67
Jutiapa,Fibrosis y cirrosis del hígado,45,26,19,17,K74
Jutiapa,Tumor maligno del hígado y de las vías biliares intrahepáticas,44,22,22,17,C22
Jutiapa,"Envenenamiento accidental por, y exposición a otros productos químicos y sustancias nocivas, y los no especificados",35,27,8,17,X49
Jutiapa,"Síntomas, signos y hallazgos anormales clínicos y de laboratorio, no clasificados en otra parte",95,57,38,17,R00 - R99
Jutiapa,Otras causas,1001,537,464,17,Otras causas
Extranjero,Todas las causas,111,66,45,17,Todas las causas
Extranjero,"Agresión con disparo de otras armas de fuego, y las no especificadas",19,16,3,17,X95
Extranjero,"Accidente de vehículo de motor o sin motor, tipo de vehículo no especificado",10,8,2,17,V89
Extranjero,Exposición a factores no especificados,10,8,2,17,X59
Extranjero,Infarto agudo del miocardio,7,3,4,17,I21
Extranjero,"Diabetes mellitus, no especificada",5,1,4,17,E14
Extranjero,"Neumonía, organismo no especificado",4,1,3,17,J18
Extranjero,Fibrosis y cirrosis del hígado,4,2,2,17,K74
Extranjero,"Disparo de otras armas de fuego, y las no especificadas",4,2,2,17,W34
Extranjero,Tumor maligno del estómago,2,2,0,17,C16
Extranjero,Tumor maligno de la mama,2,0,2,17,C50
Extranjero,Insuficiencia cardíaca,2,0,2,17,I50
Extranjero,Ahogamiento y sumersión no especificados,2,1,1,17,W74
Extranjero,"Exposición a humos, fuegos o llamas no especificados",2,1,1,17,X09
Extranjero,"Tuberculosis respiratoria, no confirmada bacteriológica o histológicamente",1,1,0,17,A16
Extranjero,Otras sepsis,1,0,1,17,A41
Extranjero,"Síntomas, signos y hallazgos anormales clínicos y de laboratorio, no clasificados en otra parte",10,6,4,17,R00 - R99
Extranjero,Otras causas,26,14,12,17,Otras causas
Ignorado,Todas las causas,6146,3684,2462,17,Todas las causas
Ignorado,"Neumonía, organismo no especificado",619,359,260,17,J18
Ignorado,"Agresión con disparo de otras armas de fuego, y las no especificadas",318,273,45,17,X95
Ignorado,Dificultad respiratoria del recién nacido,311,189,122,17,P22
Ignorado,Otras gastroenteritis y colitis de origen infeccioso y no especificado,306,154,152,17,A09
Ignorado,Exposición a factores no especificados,216,164,52,17,X59
Ignorado,Otras malformaciones congénitas del corazón,183,103,80,17,Q24
Ignorado,Neumonía congénita,180,114,66,17,P23
Ignorado,Sepsis bacteriana del recién nacido,171,112,59,17,P36
Ignorado,Otras sepsis,137,79,58,17,A41
Ignorado,"Otras malformaciones congénitas, no clasificadas en otra parte",135,78,57,17,Q89
Ignorado,Síndromes de aspiración neonatal,95,55,40,17,P24
Ignorado,"Accidente de vehículo de motor o sin motor, tipo de vehículo no especificado",94,74,20,17,V89
Ignorado,"Trastornos relacionados con duración corta de la gestación y con bajo peso al nacer, no clasificados en otra parte",90,53,37,17,P07
Ignorado,Trastornos cardiovasculares originados en el período perinatal,84,49,35,17,P29
Ignorado,Asfixia del nacimiento,81,59,22,17,P21
Ignorado,"Síntomas, signos y hallazgos anormales clínicos y de laboratorio, no clasificados en otra parte",461,260,201,17,R00 - R99
Ignorado,Otras causas,2665,1509,1156,17,Otras causas
Todos los departamentos,Todas las causas,83071,45784,37287,18,Todas las causas
Todos los departamentos,"Neumonía, organismo no especificado",6250,3293,2957,18,J18
Todos los departamentos,Infarto agudo del miocardio,5527,2963,2564,18,I21
Todos los departamentos,"Diabetes mellitus, no especificada",4637,1797,2840,18,E14
Todos los departamentos,Exposición a factores no especificados,2728,2175,553,18,X59
Todos los departamentos,Fibrosis y cirrosis del hígado,2601,1649,952,18,K74
Todos los departamentos,"Agresión con disparo de otras armas de fuego, y las no especificadas",2583,2248,335,18,X95
Todos los departamentos,Otras gastroenteritis y colitis de origen infeccioso y no especificado,1816,920,896,18,A09
Todos los departamentos,"Accidente vascular encefálico agudo, no especificado como hemorrágico o isquémico",1670,833,837,18,I64
Todos los departamentos,Diabetes mellitus no insulinodependiente,1657,652,1005,18,E11
Todos los departamentos,"Accidente de vehículo de motor o sin motor, tipo de vehículo no especificado",1616,1327,289,18,V89
Todos los departamentos,Enfermedad renal crónica,1584,823,761,18,N18
Todos los departamentos,Tumor maligno del hígado y de las vías biliares intrahepáticas,1473,717,756,18,C22
Todos los departamentos,Insuficiencia cardíaca,1406,660,746,18,I50
Todos los departamentos,Tumor maligno del estómago,1218,564,654,18,C16
Todos los departamentos,Insuficiencia renal no especificada,1031,530,501,18,N19
Todos los departamentos,"Síntomas, signos y hallazgos anormales clínicos y de laboratorio, no clasificados en otra parte",10695,5561,5134,18,R00 - R99
Todos los departamentos,Otras causas,34579,19072,15507,18,Otras causas
Guatemala,Todas las causas,18247,9916,8331,18,Todas las causas
Guatemala,"Diabetes mellitus, no especificada",1302,533,769,18,E14
Guatemala,Infarto agudo del miocardio,1244,670,574,18,I21
Guatemala,"Agresión con disparo de otras armas de fuego, y las no especificadas",903,744,159,18,X95
Guatemala,Fibrosis y cirrosis del hígado,873,601,272,18,K74
Guatemala,Exposición a factores no especificados,833,671,162,18,X59
Guatemala,"Neumonía, organismo no especificado",770,427,343,18,J18
Guatemala,Enfermedad renal crónica,473,233,240,18,N18
Guatemala,Diabetes mellitus no insulinodependiente,410,176,234,18,E11
Guatemala,Tumor maligno del hígado y de las vías biliares intrahepáticas,406,193,213,18,C22
Guatemala,Insuficiencia cardíaca,308,134,174,18,I50
Guatemala,"Disparo de otras armas de fuego, y las no especificadas",297,256,41,18,W34
Guatemala,"Accidente vascular encefálico agudo, no especificado como hemorrágico o isquémico",280,120,160,18,I64
Guatemala,Tumor maligno del estómago,274,100,174,18,C16
Guatemala,Hipertensión esencial (primaria),233,91,142,18,I10
Guatemala,Otras sepsis,216,113,103,18,A41
Guatemala,"Síntomas, signos y hallazgos anormales clínicos y de laboratorio, no clasificados en otra parte",1926,941,985,18,R00 - R99
Guatemala,Otras causas,7499,3913,3586,18,Otras causas
El Progreso,Todas las causas,1044,557,487,18,Todas las causas
El Progreso,Infarto agudo del miocardio,144,73,71,18,I21
El Progreso,"Diabetes mellitus, no especificada",80,25,55,18,E14
El Progreso,"Neumonía, organismo no especificado",73,36,37,18,J18
El Progreso,"Accidente vascular encefálico agudo, no especificado como hemorrágico o isquémico",49,28,21,18,I64
El Progreso,"Agresión con disparo de otras armas de fuego, y las no especificadas",39,33,6,18,X95
El Progreso,"Accidente de vehículo de motor o sin motor, tipo de vehículo no especificado",32,24,8,18,V89
El Progreso,Fibrosis y cirrosis del hígado,29,19,10,18,K74
El Progreso,Tumor maligno del estómago,28,13,15,18,C16
El Progreso,Exposición a factores no especificados,28,22,6,18,X59
El Progreso,Diabetes mellitus no insulinodependiente,26,10,16,18,E11
El Progreso,Tumor maligno del hígado y de las vías biliares intrahepáticas,22,13,9,18,C22
El Progreso,Otras enfermedades pulmonares obstructivas crónicas,18,12,6,18,J44
El Progreso,Insuficiencia cardíaca,16,8,8,18,I50
El Progreso,Otras enfermedades cerebrovasculares,14,8,6,18,I67
El Progreso,Enfermedad renal crónica,13,6,7,18,N18
El Progreso,"Síntomas, signos y hallazgos anormales clínicos y de laboratorio, no clasificados en otra parte",70,41,29,18,R00 - R99
El Progreso,Otras causas,363,186,177,18,Otras causas
Sacatepequez,Todas las causas,1737,896,841,18,Todas las causas
Sacatepequez,"Diabetes mellitus, no especificada",140,50,90,18,E14
Sacatepequez,Infarto agudo del miocardio,122,63,59,18,I21
Sacatepequez,"Neumonía, organismo no especificado",93,50,43,18,J18
Sacatepequez,Fibrosis y cirrosis del hígado,76,42,34,18,K74
Sacatepequez,Diabetes mellitus no insulinodependiente,74,25,49,18,E11
Sacatepequez,Exposición a factores no especificados,66,52,14,18,X59
Sacatepequez,Tumor maligno del hígado y de las vías biliares intrahepáticas,46,18,28,18,C22
Sacatepequez,Enfermedad alcohólica del hígado,46,38,8,18,K70
Sacatepequez,Enfermedad renal crónica,39,20,19,18,N18
Sacatepequez,"Desnutrición proteicocalórica, no especificada",38,20,18,18,E46
Sacatepequez,"Accidente vascular encefálico agudo, no especificado como hemorrágico o isquémico",35,19,16,18,I64
Sacatepequez,Insuficiencia cardíaca,32,13,19,18,I50
Sacatepequez,"Accidente de vehículo de motor o sin motor, tipo de vehículo no especificado",32,28,4,18,V89
Sacatepequez,Tumor maligno del estómago,28,11,17,18,C16
Sacatepequez,Trastornos mentales y del comportamiento debidos al uso de alcohol,28,26,2,18,F10
Sacatepequez,"Síntomas, signos y hallazgos anormales clínicos y de laboratorio, no clasificados en otra parte",170,87,83,18,R00 - R99
Sacatepequez,Otras causas,672,334,338,18,Otras causas
Chimaltenango,Todas las causas,2857,1512,1345,18,Todas las causas
Chimaltenango,"Neumonía, organismo no especificado",393,178,215,18,J18
Chimaltenango,"Diabetes mellitus, no especificada",173,56,117,18,E14
Chimaltenango,Infarto agudo del miocardio,149,76,73,18,I21
Chimaltenango,Fibrosis y cirrosis del hígado,133,85,48,18,K74
Chimaltenango,Exposición a factores no especificados,97,78,19,18,X59
Chimaltenango,Enfermedad alcohólica del hígado,79,68,11,18,K70
Chimaltenango,Insuficiencia cardíaca,74,34,40,18,I50
Chimaltenango,Diabetes mellitus no insulinodependiente,66,20,46,18,E11
Chimaltenango,Tumor maligno del estómago,64,35,29,18,C16
Chimaltenango,"Accidente de vehículo de motor o sin motor, tipo de vehículo no especificado",58,49,9,18,V89
Chimaltenango,"Accidente vascular encefálico agudo, no especificado como hemorrágico o isquémico",57,32,25,18,I64
Chimaltenango,Enfermedad renal crónica,57,22,35,18,N18
Chimaltenango,Otras gastroenteritis y colitis de origen infeccioso y no especificado,54,21,33,18,A09
Chimaltenango,Tumor maligno del hígado y de las vías biliares intrahepáticas,52,30,22,18,C22
Chimaltenango,Otras enfermedades cerebrovasculares,46,20,26,18,I67
Chimaltenango,"Síntomas, signos y hallazgos anormales clínicos y de laboratorio, no clasificados en otra parte",207,99,108,18,R00 - R99
Chimaltenango,Otras causas,1098,609,489,18,Otras causas
Escuintla,Todas las causas,4416,2564,1852,18,Todas las causas
Escuintla,Infarto agudo del miocardio,369,209,160,18,I21
Escuintla,"Diabetes mellitus, no especificada",351,130,221,18,E14
Escuintla,"Neumonía, organismo no especificado",230,133,97,18,J18
Escuintla,"Agresión con disparo de otras armas de fuego, y las no especificadas",229,210,19,18,X95
Escuintla,"Accidente de vehículo de motor o sin motor, tipo de vehículo no especificado",180,149,31,18,V89
Escuintla,Enfermedad renal crónica,161,113,48,18,N18
Escuintla,Fibrosis y cirrosis del hígado,149,94,55,18,K74
Escuintla,Exposición a factores no especificados,143,120,23,18,X59
Escuintla,"Exposición a humos, fuegos o llamas no especificados",104,40,64,18,X09
Escuintla,Diabetes mellitus no insulinodependiente,82,31,51,18,E11
Escuintla,Insuficiencia renal no especificada,77,45,32,18,N19
Escuintla,Tumor maligno del hígado y de las vías biliares intrahepáticas,69,36,33,18,C22
Escuintla,"Accidente vascular encefálico agudo, no especificado como hemorrágico o isquémico",59,37,22,18,I64
Escuintla,"Desnutrición proteicocalórica, no especificada",52,32,20,18,E46
Escuintla,"Otros trastornos de los líquidos, de los electrólitos y del equilibrio ácido-básico",43,15,28,18,E87
Escuintla,"Síntomas, signos y hallazgos anormales clínicos y de laboratorio, no clasificados en otra parte",571,324,247,18,R00 - R99
Escuintla,Otras causas,1547,846,701,18,Otras causas
Santa Rosa,Todas las causas,2126,1188,938,18,Todas las causas
Santa Rosa,Infarto agudo del miocardio,201,101,100,18,I21
Santa Rosa,"Neumonía, organismo no especificado",113,64,49,18,J18
Santa Rosa,"Diabetes mellitus, no especificada",109,35,74,18,E14
Santa Rosa,"Agresión con disparo de otras armas de fuego, y las no especificadas",98,86,12,18,X95
Santa Rosa,Enfermedad renal crónica,74,45,29,18,N18
Santa Rosa,"Accidente de vehículo de motor o sin motor, tipo de vehículo no especificado",71,63,8,18,V89
Santa Rosa,Exposición a factores no especificados,54,44,10,18,X59
Santa Rosa,Insuficiencia renal no especificada,52,25,27,18,N19
Santa Rosa,"Accidente vascular encefálico agudo, no especificado como hemorrágico o isquémico",40,22,18,18,I64
Santa Rosa,Insuficiencia cardíaca,39,15,24,18,I50
Santa Rosa,Fibrosis y cirrosis del hígado,38,21,17,18,K74
Santa Rosa,Tumor maligno del hígado y de las vías biliares intrahepáticas,35,11,24,18,C22
Santa Rosa,Tumor maligno del estómago,34,22,12,18,C16
Santa Rosa,Otras sepsis,29,13,16,18,A41
Santa Rosa,Otras enfermedades cerebrovasculares,24,9,15,18,I67
Santa Rosa,"Síntomas, signos y hallazgos anormales clínicos y de laboratorio, no clasificados en otra parte",314,165,149,18,R00 - R99
Santa Rosa,Otras causas,801,447,354,18,Otras causas
Solola,Todas las causas,1839,981,858,18,Todas las causas
Solola,"Neumonía, organismo no especificado",194,84,110,18,J18
Solola,"Diabetes mellitus, no especificada",90,44,46,18,E14
Solola,Otras gastroenteritis y colitis de origen infeccioso y no especificado,87,49,38,18,A09
Solola,Infarto agudo del miocardio,76,40,36,18,I21
Solola,Diabetes mellitus no insulinodependiente,74,34,40,18,E11
Solola,Exposición a factores no especificados,73,57,16,18,X59
Solola,"Envenenamiento accidental por, y exposición al alcohol",51,51,0,18,X45
Solola,Fibrosis y cirrosis del hígado,45,31,14,18,K74
Solola,"Accidente vascular encefálico agudo, no especificado como hemorrágico o isquémico",41,18,23,18,I64
Solola,"Desnutrición proteicocalórica, no especificada",38,17,21,18,E46
Solola,Tumor maligno del estómago,32,16,16,18,C16
Solola,Tumor maligno del hígado y de las vías biliares intrahepáticas,31,12,19,18,C22
Solola,Enfermedad alcohólica del hígado,30,27,3,18,K70
Solola,"Neumonía bacteriana, no clasificada en otra parte",29,16,13,18,J15
Solola,Otras sepsis,25,15,10,18,A41
Solola,"Síntomas, signos y hallazgos anormales clínicos y de laboratorio, no clasificados en otra parte",278,131,147,18,R00 - R99
Solola,Otras causas,645,339,306,18,Otras causas
Totonicapan,Todas las causas,2524,1397,1127,18,Todas las causas
Totonicapan,"Neumonía, organismo no especificado",177,93,84,18,J18
Totonicapan,"Diabetes mellitus, no especificada",133,75,58,18,E14
Totonicapan,"Envenenamiento accidental por, y exposición al alcohol",120,100,20,18,X45
Totonicapan,Otras gastroenteritis y colitis de origen infeccioso y no especificado,73,36,37,18,A09
Totonicapan,Fibrosis y cirrosis del hígado,69,43,26,18,K74
Totonicapan,Exposición a factores no especificados,49,38,11,18,X59
Totonicapan,Enfermedad alcohólica del hígado,48,33,15,18,K70
Totonicapan,Hipertensión esencial (primaria),39,16,23,18,I10
Totonicapan,Diabetes mellitus no insulinodependiente,38,20,18,18,E11
Totonicapan,Tumor maligno de sitios no especificados,30,10,20,18,C80
Totonicapan,Infarto agudo del miocardio,30,12,18,18,I21
Totonicapan,Trastornos mentales y del comportamiento debidos al uso de alcohol,28,21,7,18,F10
Totonicapan,"Accidente de vehículo de motor o sin motor, tipo de vehículo no especificado",27,21,6,18,V89
Totonicapan,Otros trastornos del encéfalo,26,12,14,18,G93
Totonicapan,Enfermedad renal crónica,22,10,12,18,N18
Totonicapan,"Síntomas, signos y hallazgos anormales clínicos y de laboratorio, no clasificados en otra parte",898,453,445,18,R00 - R99
Totonicapan,Otras causas,717,404,313,18,Otras causas
Quetzaltenango,Todas las causas,4516,2458,2058,18,Todas las causas
Quetzaltenango,"Diabetes mellitus, no especificada",314,129,185,18,E14
Quetzaltenango,Infarto agudo del miocardio,229,126,103,18,I21
Quetzaltenango,"Neumonía, organismo no especificado",203,107,96,18,J18
Quetzaltenango,Insuficiencia cardíaca,177,81,96,18,I50
Quetzaltenango,Fibrosis y cirrosis del hígado,154,89,65,18,K74
Quetzaltenango,Enfermedad alcohólica del hígado,141,117,24,18,K70
Quetzaltenango,Exposición a factores no especificados,123,93,30,18,X59
Quetzaltenango,"Agresión con disparo de otras armas de fuego, y las no especificadas",114,106,8,18,X95
Quetzaltenango,Diabetes mellitus no insulinodependiente,100,39,61,18,E11
Quetzaltenango,"Envenenamiento accidental por, y exposición al alcohol",93,78,15,18,X45
Quetzaltenango,"Accidente de vehículo de motor o sin motor, tipo de vehículo no especificado",87,66,21,18,V89
Quetzaltenango,Tumor maligno del estómago,83,28,55,18,C16
Quetzaltenango,Tumor maligno del hígado y de las vías biliares intrahepáticas,77,34,43,18,C22
Quetzaltenango,Enfermedad renal crónica,76,37,39,18,N18
Quetzaltenango,"Accidente vascular encefálico agudo, no especificado como hemorrágico o isquémico",73,31,42,18,I64
Quetzaltenango,"Síntomas, signos y hallazgos anormales clínicos y de laboratorio, no clasificados en otra parte",531,290,241,18,R00 - R99
Quetzaltenango,Otras causas,1941,1007,934,18,Otras causas
Suchitepequez,Todas las causas,2989,1641,1348,18,Todas las causas
Suchitepequez,"Diabetes mellitus, no especificada",140,51,89,18,E14
Suchitepequez,Infarto agudo del miocardio,122,78,44,18,I21
Suchitepequez,Exposición a factores no especificados,117,100,17,18,X59
Suchitepequez,Insuficiencia renal no especificada,109,72,37,18,N19
Suchitepequez,"Neumonía, organismo no especificado",84,49,35,18,J18
Suchitepequez,Fibrosis y cirrosis del hígado,82,48,34,18,K74
Suchitepequez,Enfermedad renal crónica,73,42,31,18,N18
Suchitepequez,Tumor maligno del hígado y de las vías biliares intrahepáticas,49,23,26,18,C22
Suchitepequez,"Agresión con disparo de otras armas de fuego, y las no especificadas",39,34,5,18,X95
Suchitepequez,Diabetes mellitus no insulinodependiente,38,15,23,18,E11
Suchitepequez,"Accidente de vehículo de motor o sin motor, tipo de vehículo no especificado",31,28,3,18,V89
Suchitepequez,Otras gastroenteritis y colitis de origen infeccioso y no especificado,26,10,16,18,A09
Suchitepequez,Tumor maligno del estómago,25,9,16,18,C16
Suchitepequez,"Accidente vascular encefálico agudo, no especificado como hemorrágico o isquémico",23,12,11,18,I64
Suchitepequez,"Disparo de otras armas de fuego, y las no especificadas",22,20,2,18,W34
Suchitepequez,"Síntomas, signos y hallazgos anormales clínicos y de laboratorio, no clasificados en otra parte",1301,658,643,18,R00 - R99
Suchitepequez,Otras causas,708,392,316,18,Otras causas
Retalhuleu,Todas las causas,1901,1087,814,18,Todas las causas
Retalhuleu,"Diabetes mellitus, no especificada",90,37,53,18,E14
Retalhuleu,Exposición a factores no especificados,67,52,15,18,X59
Retalhuleu,"Accidente de vehículo de motor o sin motor, tipo de vehículo no especificado",60,51,9,18,V89
Retalhuleu,Insuficiencia renal no especificada,58,46,12,18,N19
Retalhuleu,"Agresión con disparo de otras armas de fuego, y las no especificadas",54,48,6,18,X95
Retalhuleu,"Neumonía, organismo no especificado",45,25,20,18,J18
Retalhuleu,Infarto agudo del miocardio,39,20,19,18,I21
Retalhuleu,Fibrosis y cirrosis del hígado,36,18,18,18,K74
Retalhuleu,Enfermedad renal crónica,34,23,11,18,N18
Retalhuleu,Insuficiencia cardíaca,22,8,14,18,I50
Retalhuleu,Otras enfermedades del sistema digestivo,18,9,9,18,K92
Retalhuleu,Diabetes mellitus no insulinodependiente,17,8,9,18,E11
Retalhuleu,Tumor maligno del hígado y de las vías biliares intrahepáticas,16,9,7,18,C22
Retalhuleu,Otras gastroenteritis y colitis de origen infeccioso y no especificado,15,8,7,18,A09
Retalhuleu,Otros trastornos del encéfalo,14,4,10,18,G93
Retalhuleu,"Síntomas, signos y hallazgos anormales clínicos y de laboratorio, no clasificados en otra parte",890,450,440,18,R00 - R99
Retalhuleu,Otras causas,426,271,155,18,Otras causas
San Marcos,Todas las causas,4920,2800,2120,18,Todas las causas
San Marcos,"Neumonía, organismo no especificado",635,376,259,18,J18
San Marcos,Infarto agudo del miocardio,468,279,189,18,I21
San Marcos,"Diabetes mellitus, no especificada",273,95,178,18,E14
San Marcos,Fibrosis y cirrosis del hígado,202,123,79,18,K74
San Marcos,Otras gastroenteritis y colitis de origen infeccioso y no especificado,148,77,71,18,A09
San Marcos,"Accidente vascular encefálico agudo, no especificado como hemorrágico o isquémico",146,70,76,18,I64
San Marcos,Insuficiencia cardíaca,139,68,71,18,I50
San Marcos,Exposición a factores no especificados,128,103,25,18,X59
San Marcos,Enfermedad renal crónica,118,70,48,18,N18
San Marcos,Diabetes mellitus no insulinodependiente,116,44,72,18,E11
San Marcos,Tumor maligno del hígado y de las vías biliares intrahepáticas,103,50,53,18,C22
San Marcos,Tumor maligno del estómago,83,43,40,18,C16
San Marcos,Trastornos mentales y del comportamiento debidos al uso de alcohol,78,68,10,18,F10
San Marcos,"Accidente de vehículo de motor o sin motor, tipo de vehículo no especificado",74,63,11,18,V89
San Marcos,"Envenenamiento accidental por, y exposición al alcohol",71,66,5,18,X45
San Marcos,"Síntomas, signos y hallazgos anormales clínicos y de laboratorio, no clasificados en otra parte",487,283,204,18,R00 - R99
San Marcos,Otras causas,1651,922,729,18,Otras causas
Huehuetenango,Todas las causas,4511,2391,2120,18,Todas las causas
Huehuetenango,"Neumonía, organismo no especificado",551,296,255,18,J18
Huehuetenango,Infarto agudo del miocardio,340,180,160,18,I21
Huehuetenango,"Diabetes mellitus, no especificada",284,106,178,18,E14
Huehuetenango,Otras gastroenteritis y colitis de origen infeccioso y no especificado,177,95,82,18,A09
Huehuetenango,"Accidente vascular encefálico agudo, no especificado como hemorrágico o isquémico",162,83,79,18,I64
Huehuetenango,Exposición a factores no especificados,154,122,32,18,X59
Huehuetenango,Tumor maligno del hígado y de las vías biliares intrahepáticas,116,60,56,18,C22
Huehuetenango,Tumor maligno del estómago,109,59,50,18,C16
Huehuetenango,Fibrosis y cirrosis del hígado,108,70,38,18,K74
Huehuetenango,Diabetes mellitus no insulinodependiente,95,32,63,18,E11
Huehuetenango,"Envenenamiento accidental por, y exposición al alcohol",84,75,9,18,X45
Huehuetenango,Insuficiencia cardíaca,82,36,46,18,I50
Huehuetenango,Otras enfermedades cerebrovasculares,79,37,42,18,I67
Huehuetenango,Enfermedad renal crónica,74,25,49,18,N18
Huehuetenango,"Accidente de vehículo de motor o sin motor, tipo de vehículo no especificado",66,53,13,18,V89
Huehuetenango,"Síntomas, signos y hallazgos anormales clínicos y de laboratorio, no clasificados en otra parte",165,96,69,18,R00 - R99
Huehuetenango,Otras causas,1865,966,899,18,Otras causas
Quiche,Todas las causas,4050,2179,1871,18,Todas las causas
Quiche,"Neumonía, organismo no especificado",459,217,242,18,J18
Quiche,Otras gastroenteritis y colitis de origen infeccioso y no especificado,140,76,64,18,A09
Quiche,"Diabetes mellitus, no especificada",133,64,69,18,E14
Quiche,Infarto agudo del miocardio,127,74,53,18,I21
Quiche,Diabetes mellitus no insulinodependiente,104,47,57,18,E11
Quiche,"Envenenamiento accidental por, y exposición al alcohol",82,79,3,18,X45
Quiche,Exposición a factores no especificados,80,68,12,18,X59
Quiche,Fibrosis y cirrosis del hígado,78,50,28,18,K74
Quiche,"Accidente vascular encefálico agudo, no especificado como hemorrágico o isquémico",62,27,35,18,I64
Quiche,"Accidente de vehículo de motor o sin motor, tipo de vehículo no especificado",58,50,8,18,V89
Quiche,Insuficiencia cardíaca,57,28,29,18,I50
Quiche,Tumor maligno del estómago,55,20,35,18,C16
Quiche,Tumor maligno del hígado y de las vías biliares intrahepáticas,55,27,28,18,C22
Quiche,Enfermedad renal crónica,51,25,26,18,N18
Quiche,Otros trastornos del encéfalo,44,18,26,18,G93
Quiche,"Síntomas, signos y hallazgos anormales clínicos y de laboratorio, no clasificados en otra parte",1090,552,538,18,R00 - R99
Quiche,Otras causas,1375,757,618,18,Otras causas
Baja Verapaz,Todas las causas,1401,734,667,18,Todas las causas
Baja Verapaz,"Neumonía, organismo no especificado",148,76,72,18,J18
Baja Verapaz,Infarto agudo del miocardio,111,47,64,18,I21
Baja Verapaz,"Accidente vascular encefálico agudo, no especificado como hemorrágico o isquémico",83,37,46,18,I64
Baja Verapaz,"Diabetes mellitus, no especificada",70,25,45,18,E14
Baja Verapaz,"Accidente de vehículo de motor o sin motor, tipo de vehículo no especificado",37,27,10,18,V89
Baja Verapaz,Otras gastroenteritis y colitis de origen infeccioso y no especificado,35,18,17,18,A09
Baja Verapaz,Hipertensión esencial (primaria),33,15,18,18,I10
Baja Verapaz,Exposición a factores no especificados,32,25,7,18,X59
Baja Verapaz,"Agresión con disparo de otras armas de fuego, y las no especificadas",31,25,6,18,X95
Baja Verapaz,Fibrosis y cirrosis del hígado,30,18,12,18,K74
Baja Verapaz,Tumor maligno del estómago,29,14,15,18,C16
Baja Verapaz,Tumor maligno del hígado y de las vías biliares intrahepáticas,27,10,17,18,C22
Baja Verapaz,Otras enfermedades pulmonares obstructivas crónicas,25,13,12,18,J44
Baja Verapaz,Diabetes mellitus no insulinodependiente,24,10,14,18,E11
Baja Verapaz,Otras enfermedades cerebrovasculares,19,10,9,18,I67
Baja Verapaz,"Síntomas, signos y hallazgos anormales clínicos y de laboratorio, no clasificados en otra parte",116,53,63,18,R00 - R99
Baja Verapaz,Otras causas,551,311,240,18,Otras causas
Alta Verapaz,Todas las causas,4957,2527,2430,18,Todas las causas
Alta Verapaz,"Neumonía, organismo no especificado",835,380,455,18,J18
Alta Verapaz,Otras gastroenteritis y colitis de origen infeccioso y no especificado,378,182,196,18,A09
Alta Verapaz,Infarto agudo del miocardio,258,131,127,18,I21
Alta Verapaz,"Diabetes mellitus, no especificada",219,69,150,18,E14
Alta Verapaz,Fibrosis y cirrosis del hígado,143,86,57,18,K74
Alta Verapaz,Tumor maligno del hígado y de las vías biliares intrahepáticas,112,56,56,18,C22
Alta Verapaz,Exposición a factores no especificados,107,92,15,18,X59
Alta Verapaz,"Accidente vascular encefálico agudo, no especificado como hemorrágico o isquémico",106,54,52,18,I64
Alta Verapaz,Otras enfermedades pulmonares obstructivas crónicas,87,40,47,18,J44
Alta Verapaz,"Desnutrición proteicocalórica, no especificada",84,35,49,18,E46
Alta Verapaz,Otras sepsis,79,36,43,18,A41
Alta Verapaz,"Accidente de vehículo de motor o sin motor, tipo de vehículo no especificado",78,64,14,18,V89
Alta Verapaz,Diabetes mellitus no insulinodependiente,75,31,44,18,E11
Alta Verapaz,Tumor maligno del estómago,70,34,36,18,C16
Alta Verapaz,Úlcera gástrica,66,28,38,18,K25
Alta Verapaz,"Síntomas, signos y hallazgos anormales clínicos y de laboratorio, no clasificados en otra parte",205,109,96,18,R00 - R99
Alta Verapaz,Otras causas,2055,1100,955,18,Otras causas
Peten,Todas las causas,2202,1321,881,18,Todas las causas
Peten,"Agresión con disparo de otras armas de fuego, y las no especificadas",157,139,18,18,X95
Peten,"Diabetes mellitus, no especificada",135,49,86,18,E14
Peten,Infarto agudo del miocardio,108,61,47,18,I21
Peten,"Neumonía, organismo no especificado",107,68,39,18,J18
Peten,"Accidente de vehículo de motor o sin motor, tipo de vehículo no especificado",105,92,13,18,V89
Peten,Diabetes mellitus no insulinodependiente,65,21,44,18,E11
Peten,Exposición a factores no especificados,61,43,18,18,X59
Peten,Otras gastroenteritis y colitis de origen infeccioso y no especificado,56,30,26,18,A09
Peten,Fibrosis y cirrosis del hígado,51,27,24,18,K74
Peten,"Neumonía bacteriana, no clasificada en otra parte",48,22,26,18,J15
Peten,Insuficiencia cardíaca,47,29,18,18,I50
Peten,"Accidente vascular encefálico agudo, no especificado como hemorrágico o isquémico",43,27,16,18,I64
Peten,Agresión por medios no especificados,42,36,6,18,Y09
Peten,Tumor maligno del hígado y de las vías biliares intrahepáticas,36,21,15,18,C22
Peten,"Desnutrición proteicocalórica, no especificada",36,19,17,18,E46
Peten,"Síntomas, signos y hallazgos anormales clínicos y de laboratorio, no clasificados en otra parte",153,93,60,18,R00 - R99
Peten,Otras causas,952,544,408,18,Otras causas
Izabal,Todas las causas,2193,1203,990,18,Todas las causas
Izabal,Infarto agudo del miocardio,247,124,123,18,I21
Izabal,"Diabetes mellitus, no especificada",143,55,88,18,E14
Izabal,"Neumonía, organismo no especificado",136,68,68,18,J18
Izabal,Exposición a factores no especificados,88,73,15,18,X59
Izabal,"Accidente de vehículo de motor o sin motor, tipo de vehículo no especificado",86,67,19,18,V89
Izabal,"Agresión con disparo de otras armas de fuego, y las no especificadas",78,69,9,18,X95
Izabal,"Disparo de otras armas de fuego, y las no especificadas",77,66,11,18,W34
Izabal,Insuficiencia renal no especificada,63,26,37,18,N19
Izabal,Otras gastroenteritis y colitis de origen infeccioso y no especificado,50,26,24,18,A09
Izabal,Fibrosis y cirrosis del hígado,45,21,24,18,K74
Izabal,"Accidente vascular encefálico agudo, no especificado como hemorrágico o isquémico",43,26,17,18,I64
Izabal,Enfermedad renal crónica,36,9,27,18,N18
Izabal,Tumor maligno del hígado y de las vías biliares intrahepáticas,33,13,20,18,C22
Izabal,Tumor maligno del estómago,31,14,17,18,C16
Izabal,Otras sepsis,30,13,17,18,A41
Izabal,"Síntomas, signos y hallazgos anormales clínicos y de laboratorio, no clasificados en otra parte",255,136,119,18,R00 - R99
Izabal,Otras causas,752,397,355,18,Otras causas
Zacapa,Todas las causas,1490,838,652,18,Todas las causas
Zacapa,Infarto agudo del miocardio,266,137,129,18,I21
Zacapa,"Agresión con disparo de otras armas de fuego, y las no especificadas",113,107,6,18,X95
Zacapa,"Diabetes mellitus, no especificada",78,26,52,18,E14
Zacapa,"Accidente vascular encefálico agudo, no especificado como hemorrágico o isquémico",53,26,27,18,I64
Zacapa,"Neumonía, organismo no especificado",53,33,20,18,J18
Zacapa,Diabetes mellitus no insulinodependiente,52,15,37,18,E11
Zacapa,"Accidente de vehículo de motor o sin motor, tipo de vehículo no especificado",50,43,7,18,V89
Zacapa,Exposición a factores no especificados,47,35,12,18,X59
Zacapa,Fibrosis y cirrosis del hígado,41,23,18,18,K74
Zacapa,Otras enfermedades cerebrovasculares,33,18,15,18,I67
Zacapa,Tumor maligno del estómago,29,19,10,18,C16
Zacapa,Tumor maligno del hígado y de las vías biliares intrahepáticas,28,14,14,18,C22
Zacapa,Insuficiencia cardíaca,26,13,13,18,I50
Zacapa,Otras enfermedades pulmonares obstructivas crónicas,25,13,12,18,J44
Zacapa,Tumor maligno de la próstata,24,24,0,18,C61
Zacapa,"Síntomas, signos y hallazgos anormales clínicos y de laboratorio, no clasificados en otra parte",56,26,30,18,R00 - R99
Zacapa,Otras causas,516,266,250,18,Otras causas
Chiquimula,Todas las causas,2029,1136,893,18,Todas las causas
Chiquimula,Infarto agudo del miocardio,255,139,116,18,I21
Chiquimula,"Neumonía, organismo no especificado",182,92,90,18,J18
Chiquimula,"Diabetes mellitus, no especificada",95,38,57,18,E14
Chiquimula,"Accidente vascular encefálico agudo, no especificado como hemorrágico o isquémico",89,45,44,18,I64
Chiquimula,Insuficiencia cardíaca,88,49,39,18,I50
Chiquimula,Fibrosis y cirrosis del hígado,78,40,38,18,K74
Chiquimula,Exposición a factores no especificados,61,49,12,18,X59
Chiquimula,"Disparo de otras armas de fuego, y las no especificadas",57,56,1,18,W34
Chiquimula,"Accidente de vehículo de motor o sin motor, tipo de vehículo no especificado",53,50,3,18,V89
Chiquimula,"Agresión con disparo de otras armas de fuego, y las no especificadas",49,45,4,18,X95
Chiquimula,Tumor maligno del hígado y de las vías biliares intrahepáticas,46,30,16,18,C22
Chiquimula,Tumor maligno del estómago,41,25,16,18,C16
Chiquimula,Diabetes mellitus no insulinodependiente,41,15,26,18,E11
Chiquimula,Enfermedad renal crónica,34,13,21,18,N18
Chiquimula,Otras gastroenteritis y colitis de origen infeccioso y no especificado,31,16,15,18,A09
Chiquimula,"Síntomas, signos y hallazgos anormales clínicos y de laboratorio, no clasificados en otra parte",83,46,37,18,R00 - R99
Chiquimula,Otras causas,746,388,358,18,Otras causas
Jalapa,Todas las causas,1747,975,772,18,Todas las causas
Jalapa,Infarto agudo del miocardio,119,62,57,18,I21
Jalapa,"Neumonía, organismo no especificado",114,65,49,18,J18
Jalapa,"Diabetes mellitus, no especificada",90,35,55,18,E14
Jalapa,Otros trastornos y los no especificados del sistema circulatorio,78,45,33,18,I99
Jalapa,"Agresión con disparo de otras armas de fuego, y las no especificadas",62,51,11,18,X95
Jalapa,Otros trastornos del encéfalo,60,27,33,18,G93
Jalapa,Fibrosis y cirrosis del hígado,42,26,16,18,K74
Jalapa,Otras gastroenteritis y colitis de origen infeccioso y no especificado,38,15,23,18,A09
Jalapa,"Disparo de otras armas de fuego, y las no especificadas",38,33,5,18,W34
Jalapa,Exposición a factores no especificados,32,22,10,18,X59
Jalapa,Tumor maligno del hígado y de las vías biliares intrahepáticas,30,13,17,18,C22
Jalapa,"Accidente vascular encefálico agudo, no especificado como hemorrágico o isquémico",28,12,16,18,I64
Jalapa,"Accidente de vehículo de motor o sin motor, tipo de vehículo no especificado",26,25,1,18,V89
Jalapa,Tumor maligno del estómago,24,10,14,18,C16
Jalapa,Insuficiencia cardíaca,24,7,17,18,I50
Jalapa,"Síntomas, signos y hallazgos anormales clínicos y de laboratorio, no clasificados en otra parte",298,171,127,18,R00 - R99
Jalapa,Otras causas,644,356,288,18,Otras causas
Jutiapa,Todas las causas,2688,1517,1171,18,Todas las causas
Jutiapa,Infarto agudo del miocardio,444,234,210,18,I21
Jutiapa,"Diabetes mellitus, no especificada",170,63,107,18,E14
Jutiapa,"Accidente vascular encefálico agudo, no especificado como hemorrágico o isquémico",159,87,72,18,I64
Jutiapa,"Agresión con disparo de otras armas de fuego, y las no especificadas",128,117,11,18,X95
Jutiapa,"Neumonía, organismo no especificado",112,63,49,18,J18
Jutiapa,Diabetes mellitus no insulinodependiente,90,29,61,18,E11
Jutiapa,Insuficiencia cardíaca,76,42,34,18,I50
Jutiapa,Tumor maligno del estómago,70,37,33,18,C16
Jutiapa,"Accidente de vehículo de motor o sin motor, tipo de vehículo no especificado",59,51,8,18,V89
Jutiapa,Enfermedad renal crónica,56,29,27,18,N18
Jutiapa,Exposición a factores no especificados,56,42,14,18,X59
Jutiapa,Fibrosis y cirrosis del hígado,52,35,17,18,K74
Jutiapa,Tumor maligno del hígado y de las vías biliares intrahepáticas,49,25,24,18,C22
Jutiapa,Otras enfermedades cerebrovasculares,47,27,20,18,I67
Jutiapa,Tumor maligno de la próstata,46,46,0,18,C61
Jutiapa,"Síntomas, signos y hallazgos anormales clínicos y de laboratorio, no clasificados en otra parte",134,79,55,18,R00 - R99
Jutiapa,Otras causas,940,511,429,18,Otras causas
Extranjero,Todas las causas,121,81,40,18,Todas las causas
Extranjero,"Agresión con disparo de otras armas de fuego, y las no especificadas",17,15,2,18,X95
Extranjero,"Accidente de vehículo de motor o sin motor, tipo de vehículo no especificado",12,10,2,18,V89
Extranjero,Infarto agudo del miocardio,7,5,2,18,I21
Extranjero,Ahogamiento y sumersión no especificados,6,6,0,18,W74
Extranjero,Exposición a factores no especificados,4,3,1,18,X59
Extranjero,Agresión con objeto cortante,4,2,2,18,X99
Extranjero,Linfoma no Hodgkin de otro tipo y el no especificado,3,2,1,18,C85
Extranjero,Fibrosis y cirrosis del hígado,3,2,1,18,K74
Extranjero,Enfermedad renal crónica,3,2,1,18,N18
Extranjero,"Enfermedad por virus de la inmunodeficiencia humana [VIH], resultante en enfermedades infecciosas y parasitarias",2,1,1,18,B20
Extranjero,Tumor maligno del estómago,2,1,1,18,C16
Extranjero,Tumor maligno del cuello del útero,2,0,2,18,C53
Extranjero,Diabetes mellitus no insulinodependiente,2,1,1,18,E11
Extranjero,"Diabetes mellitus, no especificada",2,1,1,18,E14
Extranjero,Otras hemorragias intracraneales no traumáticas,2,1,1,18,I62
Extranjero,"Síntomas, signos y hallazgos anormales clínicos y de laboratorio, no clasificados en otra parte",11,6,5,18,R00 - R99
Extranjero,Otras causas,39,23,16,18,Otras causas
Ignorado,Todas las causas,6566,3885,2681,18,Todas las causas
Ignorado,"Neumonía, organismo no especificado",541,311,230,18,J18
Ignorado,Dificultad respiratoria del recién nacido,381,233,148,18,P22
Ignorado,"Agresión con disparo de otras armas de fuego, y las no especificadas",258,225,33,18,X95
Ignorado,Otras gastroenteritis y colitis de origen infeccioso y no especificado,256,134,122,18,A09
Ignorado,Exposición a factores no especificados,228,171,57,18,X59
Ignorado,Otras malformaciones congénitas del corazón,226,118,108,18,Q24
Ignorado,Neumonía congénita,191,114,77,18,P23
Ignorado,Sepsis bacteriana del recién nacido,186,111,75,18,P36
Ignorado,Otras sepsis,168,95,73,18,A41
Ignorado,"Otras malformaciones congénitas, no clasificadas en otra parte",144,89,55,18,Q89
Ignorado,Asfixia del nacimiento,114,67,47,18,P21
Ignorado,Síndromes de aspiración neonatal,113,63,50,18,P24
Ignorado,"Accidente de vehículo de motor o sin motor, tipo de vehículo no especificado",107,79,28,18,V89
Ignorado,"Trastornos relacionados con duración corta de la gestación y con bajo peso al nacer, no clasificados en otra parte",96,49,47,18,P07
Ignorado,"Exposición a humos, fuegos o llamas no especificados",92,44,48,18,X09
Ignorado,"Síntomas, signos y hallazgos anormales clínicos y de laboratorio, no clasificados en otra parte",486,272,214,18,R00 - R99
Ignorado,Otras causas,2979,1710,1269,18,Otras causas
Todos los departamentos,Todas las causas,85600,47002,38598,19,Todas las causas
Todos los departamentos,"Neumonía, organismo no especificado",6335,3240,3095,19,J18
Todos los departamentos,Infarto agudo del miocardio,5901,3164,2737,19,I21
Todos los departamentos,"Diabetes mellitus, no especificada",4974,1995,2979,19,E14
Todos los departamentos,Fibrosis y cirrosis del hígado,2730,1750,980,19,K74
Todos los departamentos,Exposición a factores no especificados,2683,2203,480,19,X59
Todos los departamentos,"Agresión con disparo de otras armas de fuego, y las no especificadas",2470,2144,326,19,X95
Todos los departamentos,Otras gastroenteritis y colitis de origen infeccioso y no especificado,2091,1088,1003,19,A09
Todos los departamentos,Enfermedad renal crónica,1821,987,834,19,N18
Todos los departamentos,Diabetes mellitus no insulinodependiente,1773,725,1048,19,E11
Todos los departamentos,"Accidente de vehículo de motor o sin motor, tipo de vehículo no especificado",1711,1405,306,19,V89
Todos los departamentos,"Accidente vascular encefálico agudo, no especificado como hemorrágico o isquémico",1552,735,817,19,I64
Todos los departamentos,Tumor maligno del hígado y de las vías biliares intrahepáticas,1529,717,812,19,C22
Todos los departamentos,Insuficiencia cardíaca,1418,664,754,19,I50
Todos los departamentos,Tumor maligno del estómago,1160,524,636,19,C16
Todos los departamentos,Insuficiencia renal no especificada,1079,578,501,19,N19
Todos los departamentos,"Síntomas, signos y hallazgos anormales clínicos y de laboratorio, no clasificados en otra parte",11350,5760,5590,19,R00 - R99
Todos los departamentos,Otras causas,35023,19323,15700,19,Otras causas
Guatemala,Todas las causas,18820,10132,8688,19,Todas las causas
Guatemala,"Diabetes mellitus, no especificada",1456,628,828,19,E14
Guatemala,Infarto agudo del miocardio,1230,647,583,19,I21
Guatemala,"Agresión con disparo de otras armas de fuego, y las no especificadas",908,762,146,19,X95
Guatemala,Fibrosis y cirrosis del hígado,863,606,257,19,K74
Guatemala,"Neumonía, organismo no especificado",839,418,421,19,J18
Guatemala,Exposición a factores no especificados,807,673,134,19,X59
Guatemala,Enfermedad renal crónica,568,288,280,19,N18
Guatemala,Tumor maligno del hígado y de las vías biliares intrahepáticas,451,224,227,19,C22
Guatemala,Diabetes mellitus no insulinodependiente,451,188,263,19,E11
Guatemala,Insuficiencia cardíaca,281,107,174,19,I50
Guatemala,Tumor maligno del estómago,271,105,166,19,C16
Guatemala,Otras sepsis,270,120,150,19,A41
Guatemala,Hipertensión esencial (primaria),258,105,153,19,I10
Guatemala,"Accidente vascular encefálico agudo, no especificado como hemorrágico o isquémico",248,104,144,19,I64
Guatemala,"Disparo de otras armas de fuego, y las no especificadas",235,201,34,19,W34
Guatemala,"Síntomas, signos y hallazgos anormales clínicos y de laboratorio, no clasificados en otra parte",2233,1041,1192,19,R00 - R99
Guatemala,Otras causas,7451,3915,3536,19,Otras causas
El Progreso,Todas las causas,1126,627,499,19,Todas las causas
El Progreso,Infarto agudo del miocardio,151,79,72,19,I21
El Progreso,"Diabetes mellitus, no especificada",95,40,55,19,E14
El Progreso,"Neumonía, organismo no especificado",57,31,26,19,J18
El Progreso,"Accidente vascular encefálico agudo, no especificado como hemorrágico o isquémico",56,28,28,19,I64
El Progreso,Exposición a factores no especificados,35,23,12,19,X59
El Progreso,"Accidente de vehículo de motor o sin motor, tipo de vehículo no especificado",31,25,6,19,V89
El Progreso,Tumor maligno del hígado y de las vías biliares intrahepáticas,29,16,13,19,C22
El Progreso,Tumor maligno del estómago,28,17,11,19,C16
El Progreso,"Agresión con disparo de otras armas de fuego, y las no especificadas",24,21,3,19,X95
El Progreso,Fibrosis y cirrosis del hígado,23,11,12,19,K74
El Progreso,Otras enfermedades pulmonares obstructivas crónicas,21,14,7,19,J44
El Progreso,Diabetes mellitus no insulinodependiente,20,7,13,19,E11
El Progreso,Insuficiencia cardíaca,16,9,7,19,I50
El Progreso,Hipertensión esencial (primaria),15,7,8,19,I10
El Progreso,Enfermedad renal crónica,15,6,9,19,N18
El Progreso,"Síntomas, signos y hallazgos anormales clínicos y de laboratorio, no clasificados en otra parte",86,49,37,19,R00 - R99
El Progreso,Otras causas,424,244,180,19,Otras causas
Sacatepéquez,Todas las causas,1783,959,824,19,Todas las causas
Sacatepéquez,"Diabetes mellitus, no especificada",136,53,83,19,E14
Sacatepéquez,Infarto agudo del miocardio,120,61,59,19,I21
Sacatepéquez,Fibrosis y cirrosis del hígado,85,58,27,19,K74
Sacatepéquez,Exposición a factores no especificados,83,65,18,19,X59
Sacatepéquez,Diabetes mellitus no insulinodependiente,82,32,50,19,E11
Sacatepéquez,"Neumonía, organismo no especificado",81,39,42,19,J18
Sacatepéquez,Enfermedad alcohólica del hígado,46,40,6,19,K70
Sacatepéquez,Enfermedad renal crónica,46,23,23,19,N18
Sacatepéquez,Tumor maligno del hígado y de las vías biliares intrahepáticas,38,18,20,19,C22
Sacatepéquez,Tumor maligno del estómago,37,14,23,19,C16
Sacatepéquez,"Desnutrición proteicocalórica, no especificada",37,19,18,19,E46
Sacatepéquez,"Accidente vascular encefálico agudo, no especificado como hemorrágico o isquémico",37,12,25,19,I64
Sacatepéquez,"Accidente de vehículo de motor o sin motor, tipo de vehículo no especificado",30,28,2,19,V89
Sacatepéquez,Insuficiencia renal no especificada,29,14,15,19,N19
Sacatepéquez,Hipertensión esencial (primaria),28,13,15,19,I10
Sacatepéquez,"Síntomas, signos y hallazgos anormales clínicos y de laboratorio, no clasificados en otra parte",173,86,87,19,R00 - R99
Sacatepéquez,Otras causas,695,384,311,19,Otras causas
Chimaltenango,Todas las causas,2984,1593,1391,19,Todas las causas
Chimaltenango,"Neumonía, organismo no especificado",369,184,185,19,J18
Chimaltenango,Infarto agudo del miocardio,212,108,104,19,I21
Chimaltenango,"Diabetes mellitus, no especificada",189,88,101,19,E14
Chimaltenango,Fibrosis y cirrosis del hígado,159,97,62,19,K74
Chimaltenango,Exposición a factores no especificados,98,82,16,19,X59
Chimaltenango,Insuficiencia cardíaca,96,42,54,19,I50
Chimaltenango,Enfermedad alcohólica del hígado,87,78,9,19,K70
Chimaltenango,Tumor maligno del hígado y de las vías biliares intrahepáticas,77,40,37,19,C22
Chimaltenango,Diabetes mellitus no insulinodependiente,72,27,45,19,E11
Chimaltenango,"Accidente vascular encefálico agudo, no especificado como hemorrágico o isquémico",65,31,34,19,I64
Chimaltenango,Enfermedad renal crónica,63,32,31,19,N18
Chimaltenango,Tumor maligno del estómago,56,20,36,19,C16
Chimaltenango,Otras enfermedades pulmonares obstructivas crónicas,53,20,33,19,J44
Chimaltenango,Trastornos mentales y del comportamiento debidos al uso de alcohol,52,41,11,19,F10
Chimaltenango,Otras gastroenteritis y colitis de origen infeccioso y no especificado,49,27,22,19,A09
Chimaltenango,"Síntomas, signos y hallazgos anormales clínicos y de laboratorio, no clasificados en otra parte",203,101,102,19,R00 - R99
Chimaltenango,Otras causas,1084,575,509,19,Otras causas
Escuintla,Todas las causas,4540,2579,1961,19,Todas las causas
Escuintla,"Diabetes mellitus, no especificada",379,151,228,19,E14
Escuintla,Infarto agudo del miocardio,372,198,174,19,I21
Escuintla,"Agresión con disparo de otras armas de fuego, y las no especificadas",279,254,25,19,X95
Escuintla,"Neumonía, organismo no especificado",218,113,105,19,J18
Escuintla,"Accidente de vehículo de motor o sin motor, tipo de vehículo no especificado",206,174,32,19,V89
Escuintla,Enfermedad renal crónica,197,119,78,19,N18
Escuintla,Fibrosis y cirrosis del hígado,131,89,42,19,K74
Escuintla,Exposición a factores no especificados,121,89,32,19,X59
Escuintla,Diabetes mellitus no insulinodependiente,106,52,54,19,E11
Escuintla,Tumor maligno del hígado y de las vías biliares intrahepáticas,89,32,57,19,C22
Escuintla,Insuficiencia renal no especificada,89,49,40,19,N19
Escuintla,"Accidente vascular encefálico agudo, no especificado como hemorrágico o isquémico",51,24,27,19,I64
Escuintla,Hipertensión esencial (primaria),50,20,30,19,I10
Escuintla,Otras sepsis,49,23,26,19,A41
Escuintla,"Desnutrición proteicocalórica, no especificada",48,21,27,19,E46
Escuintla,"Síntomas, signos y hallazgos anormales clínicos y de laboratorio, no clasificados en otra parte",688,369,319,19,R00 - R99
Escuintla,Otras causas,1467,802,665,19,Otras causas
Santa Rosa,Todas las causas,2121,1191,930,19,Todas las causas
Santa Rosa,Infarto agudo del miocardio,209,122,87,19,I21
Santa Rosa,"Diabetes mellitus, no especificada",122,42,80,19,E14
Santa Rosa,"Neumonía, organismo no especificado",107,58,49,19,J18
Santa Rosa,"Accidente de vehículo de motor o sin motor, tipo de vehículo no especificado",88,70,18,19,V89
Santa Rosa,Enfermedad renal crónica,78,48,30,19,N18
Santa Rosa,"Agresión con disparo de otras armas de fuego, y las no especificadas",72,68,4,19,X95
Santa Rosa,Insuficiencia cardíaca,51,29,22,19,I50
Santa Rosa,Exposición a factores no especificados,49,39,10,19,X59
Santa Rosa,Fibrosis y cirrosis del hígado,47,29,18,19,K74
Santa Rosa,Insuficiencia renal no especificada,43,21,22,19,N19
Santa Rosa,"Accidente vascular encefálico agudo, no especificado como hemorrágico o isquémico",42,22,20,19,I64
Santa Rosa,Otras enfermedades pulmonares obstructivas crónicas,41,23,18,19,J44
Santa Rosa,Otras sepsis,34,13,21,19,A41
Santa Rosa,Diabetes mellitus no insulinodependiente,29,14,15,19,E11
Santa Rosa,Otros trastornos del encéfalo,29,15,14,19,G93
Santa Rosa,"Síntomas, signos y hallazgos anormales clínicos y de laboratorio, no clasificados en otra parte",370,199,171,19,R00 - R99
Santa Rosa,Otras causas,710,379,331,19,Otras causas
Sololá,Todas las causas,1780,964,816,19,Todas las causas
Sololá,"Neumonía, organismo no especificado",213,92,121,19,J18
Sololá,"Diabetes mellitus, no especificada",107,31,76,19,E14
Sololá,Infarto agudo del miocardio,78,41,37,19,I21
Sololá,Otras gastroenteritis y colitis de origen infeccioso y no especificado,72,32,40,19,A09
Sololá,Fibrosis y cirrosis del hígado,61,42,19,19,K74
Sololá,Exposición a factores no especificados,61,48,13,19,X59
Sololá,Diabetes mellitus no insulinodependiente,54,26,28,19,E11
Sololá,"Desnutrición proteicocalórica, no especificada",44,20,24,19,E46
Sololá,"Accidente de vehículo de motor o sin motor, tipo de vehículo no especificado",43,37,6,19,V89
Sololá,"Envenenamiento accidental por, y exposición al alcohol",42,40,2,19,X45
Sololá,"Accidente vascular encefálico agudo, no especificado como hemorrágico o isquémico",36,20,16,19,I64
Sololá,Otras enfermedades pulmonares obstructivas crónicas,34,16,18,19,J44
Sololá,Enfermedad alcohólica del hígado,32,30,2,19,K70
Sololá,Insuficiencia cardíaca,27,15,12,19,I50
Sololá,Enfermedad renal crónica,25,16,9,19,N18
Sololá,"Síntomas, signos y hallazgos anormales clínicos y de laboratorio, no clasificados en otra parte",218,119,99,19,R00 - R99
Sololá,Otras causas,633,339,294,19,Otras causas
Totonicapán,Todas las causas,2446,1343,1103,19,Todas las causas
Totonicapán,"Diabetes mellitus, no especificada",168,99,69,19,E14
Totonicapán,"Neumonía, organismo no especificado",152,58,94,19,J18
Totonicapán,"Envenenamiento accidental por, y exposición al alcohol",117,96,21,19,X45
Totonicapán,Fibrosis y cirrosis del hígado,87,58,29,19,K74
Totonicapán,Otras gastroenteritis y colitis de origen infeccioso y no especificado,85,41,44,19,A09
Totonicapán,Exposición a factores no especificados,52,45,7,19,X59
Totonicapán,Diabetes mellitus no insulinodependiente,44,19,25,19,E11
Totonicapán,Infarto agudo del miocardio,43,17,26,19,I21
Totonicapán,"Accidente de vehículo de motor o sin motor, tipo de vehículo no especificado",37,29,8,19,V89
Totonicapán,Enfermedad alcohólica del hígado,34,28,6,19,K70
Totonicapán,Trastornos mentales y del comportamiento debidos al uso de alcohol,32,24,8,19,F10
Totonicapán,Hipertensión esencial (primaria),29,12,17,19,I10
Totonicapán,Insuficiencia cardíaca,24,6,18,19,I50
Totonicapán,Otros trastornos del encéfalo,22,15,7,19,G93
Totonicapán,Enfermedad renal crónica,20,9,11,19,N18
Totonicapán,"Síntomas, signos y hallazgos anormales clínicos y de laboratorio, no clasificados en otra parte",854,446,408,19,R00 - R99
Totonicapán,Otras causas,646,341,305,19,Otras causas
Quetzaltenango,Todas las causas,4664,2547,2117,19,Todas las causas
Quetzaltenango,"Diabetes mellitus, no especificada",306,118,188,19,E14
Quetzaltenango,Infarto agudo del miocardio,276,144,132,19,I21
Quetzaltenango,"Neumonía, organismo no especificado",217,109,108,19,J18
Quetzaltenango,Insuficiencia cardíaca,200,90,110,19,I50
Quetzaltenango,Fibrosis y cirrosis del hígado,185,106,79,19,K74
Quetzaltenango,Diabetes mellitus no insulinodependiente,159,72,87,19,E11
Quetzaltenango,Enfermedad alcohólica del hígado,149,122,27,19,K70
Quetzaltenango,Exposición a factores no especificados,144,124,20,19,X59
Quetzaltenango,"Accidente de vehículo de motor o sin motor, tipo de vehículo no especificado",95,73,22,19,V89
Quetzaltenango,Trastornos mentales y del comportamiento debidos al uso de alcohol,84,74,10,19,F10
Quetzaltenango,"Agresión con disparo de otras armas de fuego, y las no especificadas",81,71,10,19,X95
Quetzaltenango,Tumor maligno del hígado y de las vías biliares intrahepáticas,78,38,40,19,C22
Quetzaltenango,Enfermedad renal crónica,77,46,31,19,N18
Quetzaltenango,Insuficiencia renal no especificada,75,46,29,19,N19
Quetzaltenango,"Envenenamiento accidental por, y exposición al alcohol",66,60,6,19,X45
Quetzaltenango,"Síntomas, signos y hallazgos anormales clínicos y de laboratorio, no clasificados en otra parte",567,286,281,19,R00 - R99
Quetzaltenango,Otras causas,1905,968,937,19,Otras causas
Suchitepéquez,Todas las causas,3205,1783,1422,19,Todas las causas
Suchitepéquez,"Diabetes mellitus, no especificada",153,57,96,19,E14
Suchitepéquez,Exposición a factores no especificados,137,114,23,19,X59
Suchitepéquez,Infarto agudo del miocardio,120,64,56,19,I21
Suchitepéquez,Insuficiencia renal no especificada,98,64,34,19,N19
Suchitepéquez,"Neumonía, organismo no especificado",92,47,45,19,J18
Suchitepéquez,Fibrosis y cirrosis del hígado,91,52,39,19,K74
Suchitepéquez,Enfermedad renal crónica,87,57,30,19,N18
Suchitepéquez,Tumor maligno del hígado y de las vías biliares intrahepáticas,47,30,17,19,C22
Suchitepéquez,"Accidente de vehículo de motor o sin motor, tipo de vehículo no especificado",41,32,9,19,V89
Suchitepéquez,"Desnutrición proteicocalórica, no especificada",33,17,16,19,E46
Suchitepéquez,"Agresión con disparo de otras armas de fuego, y las no especificadas",31,28,3,19,X95
Suchitepéquez,"Accidente vascular encefálico agudo, no especificado como hemorrágico o isquémico",27,14,13,19,I64
Suchitepéquez,Diabetes mellitus no insulinodependiente,26,13,13,19,E11
Suchitepéquez,"Disparo de otras armas de fuego, y las no especificadas",25,20,5,19,W34
Suchitepéquez,Otras sepsis,24,13,11,19,A41
Suchitepéquez,"Síntomas, signos y hallazgos anormales clínicos y de laboratorio, no clasificados en otra parte",1445,729,716,19,R00 - R99
Suchitepéquez,Otras causas,728,432,296,19,Otras causas
Retalhuleu,Todas las causas,1871,1084,787,19,Todas las causas
Retalhuleu,"Diabetes mellitus, no especificada",103,46,57,19,E14
Retalhuleu,"Accidente de vehículo de motor o sin motor, tipo de vehículo no especificado",68,61,7,19,V89
Retalhuleu,Insuficiencia renal no especificada,54,45,9,19,N19
Retalhuleu,Exposición a factores no especificados,51,41,10,19,X59
Retalhuleu,Enfermedad renal crónica,50,32,18,19,N18
Retalhuleu,Infarto agudo del miocardio,46,28,18,19,I21
Retalhuleu,Fibrosis y cirrosis del hígado,42,24,18,19,K74
Retalhuleu,"Neumonía, organismo no especificado",39,20,19,19,J18
Retalhuleu,"Agresión con disparo de otras armas de fuego, y las no especificadas",38,36,2,19,X95
Retalhuleu,Diabetes mellitus no insulinodependiente,21,13,8,19,E11
Retalhuleu,Insuficiencia cardíaca,20,8,12,19,I50
Retalhuleu,Otras gastroenteritis y colitis de origen infeccioso y no especificado,18,8,10,19,A09
Retalhuleu,Otros trastornos del encéfalo,13,7,6,19,G93
Retalhuleu,Otras sepsis,12,8,4,19,A41
Retalhuleu,Tumor maligno del hígado y de las vías biliares intrahepáticas,11,6,5,19,C22
Retalhuleu,"Síntomas, signos y hallazgos anormales clínicos y de laboratorio, no clasificados en otra parte",910,481,429,19,R00 - R99
Retalhuleu,Otras causas,375,220,155,19,Otras causas
San Marcos,Todas las causas,4850,2729,2121,19,Todas las causas
San Marcos,"Neumonía, organismo no especificado",624,355,269,19,J18
San Marcos,Infarto agudo del miocardio,470,265,205,19,I21
San Marcos,"Diabetes mellitus, no especificada",224,90,134,19,E14
San Marcos,Fibrosis y cirrosis del hígado,184,116,68,19,K74
San Marcos,Otras gastroenteritis y colitis de origen infeccioso y no especificado,151,88,63,19,A09
San Marcos,Tumor maligno del hígado y de las vías biliares intrahepáticas,136,56,80,19,C22
San Marcos,Insuficiencia cardíaca,135,70,65,19,I50
San Marcos,Exposición a factores no especificados,119,102,17,19,X59
San Marcos,"Accidente vascular encefálico agudo, no especificado como hemorrágico o isquémico",117,58,59,19,I64
San Marcos,Diabetes mellitus no insulinodependiente,116,51,65,19,E11
San Marcos,Enfermedad renal crónica,116,62,54,19,N18
San Marcos,Tumor maligno del estómago,89,42,47,19,C16
San Marcos,"Envenenamiento accidental por, y exposición al alcohol",84,77,7,19,X45
San Marcos,"Agresión con disparo de otras armas de fuego, y las no especificadas",76,65,11,19,X95
San Marcos,Úlcera gástrica,65,25,40,19,K25
San Marcos,"Síntomas, signos y hallazgos anormales clínicos y de laboratorio, no clasificados en otra parte",471,242,229,19,R00 - R99
San Marcos,Otras causas,1673,965,708,19,Otras causas
Huehuetenango,Todas las causas,4225,2250,1975,19,Todas las causas
Huehuetenango,"Neumonía, organismo no especificado",524,266,258,19,J18
Huehuetenango,Infarto agudo del miocardio,395,228,167,19,I21
Huehuetenango,"Diabetes mellitus, no especificada",246,90,156,19,E14
Huehuetenango,Otras gastroenteritis y colitis de origen infeccioso y no especificado,176,96,80,19,A09
Huehuetenango,"Accidente vascular encefálico agudo, no especificado como hemorrágico o isquémico",163,73,90,19,I64
Huehuetenango,Exposición a factores no especificados,141,115,26,19,X59
Huehuetenango,Otras enfermedades cerebrovasculares,118,62,56,19,I67
Huehuetenango,Tumor maligno del hígado y de las vías biliares intrahepáticas,112,51,61,19,C22
Huehuetenango,Tumor maligno del estómago,104,48,56,19,C16
Huehuetenango,Fibrosis y cirrosis del hígado,100,61,39,19,K74
Huehuetenango,Diabetes mellitus no insulinodependiente,93,36,57,19,E11
Huehuetenango,Enfermedad renal crónica,88,38,50,19,N18
Huehuetenango,"Envenenamiento accidental por, y exposición al alcohol",76,72,4,19,X45
Huehuetenango,Insuficiencia cardíaca,75,41,34,19,I50
Huehuetenango,"Accidente de vehículo de motor o sin motor, tipo de vehículo no especificado",62,43,19,19,V89
Huehuetenango,"Síntomas, signos y hallazgos anormales clínicos y de laboratorio, no clasificados en otra parte",134,68,66,19,R00 - R99
Huehuetenango,Otras causas,1618,862,756,19,Otras causas
Quiche,Todas las causas,3859,2054,1805,19,Todas las causas
Quiche,"Neumonía, organismo no especificado",323,160,163,19,J18
Quiche,"Diabetes mellitus, no especificada",185,74,111,19,E14
Quiche,Infarto agudo del miocardio,159,89,70,19,I21
Quiche,Otras gastroenteritis y colitis de origen infeccioso y no especificado,138,66,72,19,A09
Quiche,Exposición a factores no especificados,117,99,18,19,X59
Quiche,Diabetes mellitus no insulinodependiente,116,38,78,19,E11
Quiche,Fibrosis y cirrosis del hígado,86,60,26,19,K74
Quiche,"Envenenamiento accidental por, y exposición al alcohol",76,69,7,19,X45
Quiche,"Accidente vascular encefálico agudo, no especificado como hemorrágico o isquémico",70,35,35,19,I64
Quiche,Tumor maligno del hígado y de las vías biliares intrahepáticas,61,28,33,19,C22
Quiche,Tumor maligno del estómago,49,18,31,19,C16
Quiche,Hipertensión esencial (primaria),47,17,30,19,I10
Quiche,Trastornos mentales y del comportamiento debidos al uso de alcohol,46,42,4,19,F10
Quiche,Enfermedad renal crónica,46,26,20,19,N18
Quiche,"Accidente de vehículo de motor o sin motor, tipo de vehículo no especificado",46,42,4,19,V89
Quiche,"Síntomas, signos y hallazgos anormales clínicos y de laboratorio, no clasificados en otra parte",938,475,463,19,R00 - R99
Quiche,Otras causas,1356,716,640,19,Otras causas
Baja Verapaz,Todas las causas,1413,752,661,19,Todas las causas
Baja Verapaz,Infarto agudo del miocardio,159,78,81,19,I21
Baja Verapaz,"Neumonía, organismo no especificado",155,82,73,19,J18
Baja Verapaz,"Diabetes mellitus, no especificada",61,23,38,19,E14
Baja Verapaz,"Accidente vascular encefálico agudo, no especificado como hemorrágico o isquémico",61,35,26,19,I64
Baja Verapaz,Otras gastroenteritis y colitis de origen infeccioso y no especificado,39,22,17,19,A09
Baja Verapaz,Fibrosis y cirrosis del hígado,38,21,17,19,K74
Baja Verapaz,"Accidente de vehículo de motor o sin motor, tipo de vehículo no especificado",35,27,8,19,V89
Baja Verapaz,Exposición a factores no especificados,34,29,5,19,X59
Baja Verapaz,Hipertensión esencial (primaria),32,17,15,19,I10
Baja Verapaz,Tumor maligno del estómago,24,12,12,19,C16
Baja Verapaz,Tumor maligno del hígado y de las vías biliares intrahepáticas,24,10,14,19,C22
Baja Verapaz,Diabetes mellitus no insulinodependiente,22,7,15,19,E11
Baja Verapaz,Otras enfermedades pulmonares obstructivas crónicas,22,14,8,19,J44
Baja Verapaz,Otras artrosis,22,9,13,19,M19
Baja Verapaz,Insuficiencia cardíaca,21,7,14,19,I50
Baja Verapaz,"Síntomas, signos y hallazgos anormales clínicos y de laboratorio, no clasificados en otra parte",100,54,46,19,R00 - R99
Baja Verapaz,Otras causas,564,305,259,19,Otras causas
Alta Verapaz,Todas las causas,4917,2494,2423,19,Todas las causas
Alta Verapaz,"Neumonía, organismo no especificado",748,353,395,19,J18
Alta Verapaz,Otras gastroenteritis y colitis de origen infeccioso y no especificado,444,214,230,19,A09
Alta Verapaz,Infarto agudo del miocardio,367,183,184,19,I21
Alta Verapaz,"Diabetes mellitus, no especificada",250,77,173,19,E14
Alta Verapaz,Fibrosis y cirrosis del hígado,139,68,71,19,K74
Alta Verapaz,Exposición a factores no especificados,111,99,12,19,X59
Alta Verapaz,Tumor maligno del hígado y de las vías biliares intrahepáticas,103,37,66,19,C22
Alta Verapaz,"Accidente vascular encefálico agudo, no especificado como hemorrágico o isquémico",92,46,46,19,I64
Alta Verapaz,"Accidente de vehículo de motor o sin motor, tipo de vehículo no especificado",92,83,9,19,V89
Alta Verapaz,"Desnutrición proteicocalórica, no especificada",71,44,27,19,E46
Alta Verapaz,Depleción del volumen,70,31,39,19,E86
Alta Verapaz,Diabetes mellitus no insulinodependiente,68,24,44,19,E11
Alta Verapaz,Tumor maligno del estómago,67,26,41,19,C16
Alta Verapaz,Otras enfermedades pulmonares obstructivas crónicas,67,25,42,19,J44
Alta Verapaz,Otras anemias,66,24,42,19,D64
Alta Verapaz,"Síntomas, signos y hallazgos anormales clínicos y de laboratorio, no clasificados en otra parte",155,79,76,19,R00 - R99
Alta Verapaz,Otras causas,2007,1081,926,19,Otras causas
Peten,Todas las causas,2189,1263,926,19,Todas las causas
Peten,"Diabetes mellitus, no especificada",151,51,100,19,E14
Peten,"Agresión con disparo de otras armas de fuego, y las no especificadas",125,109,16,19,X95
Peten,"Accidente de vehículo de motor o sin motor, tipo de vehículo no especificado",121,103,18,19,V89
Peten,Infarto agudo del miocardio,119,70,49,19,I21
Peten,"Neumonía, organismo no especificado",87,47,40,19,J18
Peten,Fibrosis y cirrosis del hígado,71,35,36,19,K74
Peten,Diabetes mellitus no insulinodependiente,55,20,35,19,E11
Peten,Exposición a factores no especificados,53,42,11,19,X59
Peten,Otras gastroenteritis y colitis de origen infeccioso y no especificado,48,27,21,19,A09
Peten,Agresión por medios no especificados,41,37,4,19,Y09
Peten,"Neumonía bacteriana, no clasificada en otra parte",40,24,16,19,J15
Peten,Tumor maligno del hígado y de las vías biliares intrahepáticas,39,25,14,19,C22
Peten,"Accidente vascular encefálico agudo, no especificado como hemorrágico o isquémico",39,18,21,19,I64
Peten,Tumor maligno del estómago,37,25,12,19,C16
Peten,Enfermedad renal crónica,37,13,24,19,N18
Peten,"Síntomas, signos y hallazgos anormales clínicos y de laboratorio, no clasificados en otra parte",186,104,82,19,R00 - R99
Peten,Otras causas,940,513,427,19,Otras causas
Izabal,Todas las causas,2152,1258,894,19,Todas las causas
Izabal,Infarto agudo del miocardio,255,143,112,19,I21
Izabal,"Diabetes mellitus, no especificada",122,48,74,19,E14
Izabal,"Neumonía, organismo no especificado",122,80,42,19,J18
Izabal,"Accidente de vehículo de motor o sin motor, tipo de vehículo no especificado",84,78,6,19,V89
Izabal,"Agresión con disparo de otras armas de fuego, y las no especificadas",76,70,6,19,X95
Izabal,Otras gastroenteritis y colitis de origen infeccioso y no especificado,63,32,31,19,A09
Izabal,Insuficiencia renal no especificada,61,34,27,19,N19
Izabal,Fibrosis y cirrosis del hígado,59,30,29,19,K74
Izabal,Exposición a factores no especificados,57,51,6,19,X59
Izabal,"Accidente vascular encefálico agudo, no especificado como hemorrágico o isquémico",55,28,27,19,I64
Izabal,"Disparo de otras armas de fuego, y las no especificadas",55,45,10,19,W34
Izabal,Otras sepsis,39,19,20,19,A41
Izabal,Enfermedad renal crónica,34,21,13,19,N18
Izabal,Otras enfermedades cerebrovasculares,27,11,16,19,I67
Izabal,Insuficiencia renal aguda,27,10,17,19,N17
Izabal,"Síntomas, signos y hallazgos anormales clínicos y de laboratorio, no clasificados en otra parte",242,123,119,19,R00 - R99
Izabal,Otras causas,774,435,339,19,Otras causas
Zacapa,Todas las causas,1520,839,681,19,Todas las causas
Zacapa,Infarto agudo del miocardio,249,120,129,19,I21
Zacapa,"Diabetes mellitus, no especificada",78,24,54,19,E14
Zacapa,"Agresión con disparo de otras armas de fuego, y las no especificadas",76,66,10,19,X95
Zacapa,Diabetes mellitus no insulinodependiente,55,19,36,19,E11
Zacapa,"Neumonía, organismo no especificado",52,27,25,19,J18
Zacapa,Otras enfermedades cerebrovasculares,49,26,23,19,I67
Zacapa,Exposición a factores no especificados,48,39,9,19,X59
Zacapa,"Accidente vascular encefálico agudo, no especificado como hemorrágico o isquémico",46,18,28,19,I64
Zacapa,Fibrosis y cirrosis del hígado,44,24,20,19,K74
Zacapa,"Accidente de vehículo de motor o sin motor, tipo de vehículo no especificado",44,37,7,19,V89
Zacapa,Insuficiencia cardíaca,36,19,17,19,I50
Zacapa,Tumor maligno del estómago,28,15,13,19,C16
Zacapa,Tumor maligno del hígado y de las vías biliares intrahepáticas,28,12,16,19,C22
Zacapa,Enfermedad renal crónica,26,12,14,19,N18
Zacapa,Agresión por medios no especificados,24,24,0,19,Y09
Zacapa,"Síntomas, signos y hallazgos anormales clínicos y de laboratorio, no clasificados en otra parte",72,39,33,19,R00 - R99
Zacapa,Otras causas,565,318,247,19,Otras causas
Chiquimula,Todas las causas,2070,1159,911,19,Todas las causas
Chiquimula,Infarto agudo del miocardio,244,137,107,19,I21
Chiquimula,"Neumonía, organismo no especificado",179,96,83,19,J18
Chiquimula,"Diabetes mellitus, no especificada",109,40,69,19,E14
Chiquimula,Insuficiencia cardíaca,108,58,50,19,I50
Chiquimula,"Agresión con disparo de otras armas de fuego, y las no especificadas",87,77,10,19,X95
Chiquimula,"Accidente vascular encefálico agudo, no especificado como hemorrágico o isquémico",85,44,41,19,I64
Chiquimula,Fibrosis y cirrosis del hígado,73,47,26,19,K74
Chiquimula,"Accidente de vehículo de motor o sin motor, tipo de vehículo no especificado",67,57,10,19,V89
Chiquimula,Diabetes mellitus no insulinodependiente,57,21,36,19,E11
Chiquimula,Tumor maligno del estómago,52,26,26,19,C16
Chiquimula,Tumor maligno del hígado y de las vías biliares intrahepáticas,36,14,22,19,C22
Chiquimula,Otras enfermedades cerebrovasculares,35,17,18,19,I67
Chiquimula,Agresión con objeto cortante,35,33,2,19,X99
Chiquimula,Otras enfermedades del sistema digestivo,34,16,18,19,K92
Chiquimula,Otras enfermedades pulmonares obstructivas crónicas,28,15,13,19,J44
Chiquimula,"Síntomas, signos y hallazgos anormales clínicos y de laboratorio, no clasificados en otra parte",83,41,42,19,R00 - R99
Chiquimula,Otras causas,758,420,338,19,Otras causas
Jalapa,Todas las causas,1739,958,781,19,Todas las causas
Jalapa,"Neumonía, organismo no especificado",98,49,49,19,J18
Jalapa,Infarto agudo del miocardio,97,57,40,19,I21
Jalapa,"Agresión con disparo de otras armas de fuego, y las no especificadas",94,82,12,19,X95
Jalapa,"Diabetes mellitus, no especificada",86,31,55,19,E14
Jalapa,Otros trastornos del encéfalo,81,37,44,19,G93
Jalapa,Otros trastornos y los no especificados del sistema circulatorio,54,36,18,19,I99
Jalapa,Fibrosis y cirrosis del hígado,47,32,15,19,K74
Jalapa,"Accidente vascular encefálico agudo, no especificado como hemorrágico o isquémico",42,19,23,19,I64
Jalapa,Otras gastroenteritis y colitis de origen infeccioso y no especificado,37,23,14,19,A09
Jalapa,Tumor maligno de sitios no especificados,36,13,23,19,C80
Jalapa,Exposición a factores no especificados,31,26,5,19,X59
Jalapa,Insuficiencia cardíaca,28,15,13,19,I50
Jalapa,Otras enfermedades pulmonares obstructivas crónicas,28,17,11,19,J44
Jalapa,"Accidente de vehículo de motor o sin motor, tipo de vehículo no especificado",23,20,3,19,V89
Jalapa,Tumor maligno del estómago,20,10,10,19,C16
Jalapa,"Síntomas, signos y hallazgos anormales clínicos y de laboratorio, no clasificados en otra parte",324,157,167,19,R00 - R99
Jalapa,Otras causas,613,334,279,19,Otras causas
Jutiapa,Todas las causas,2738,1492,1246,19,Todas las causas
Jutiapa,Infarto agudo del miocardio,463,251,212,19,I21
Jutiapa,"Diabetes mellitus, no especificada",197,70,127,19,E14
Jutiapa,"Neumonía, organismo no especificado",133,67,66,19,J18
Jutiapa,"Accidente vascular encefálico agudo, no especificado como hemorrágico o isquémico",123,59,64,19,I64
Jutiapa,"Agresión con disparo de otras armas de fuego, y las no especificadas",112,99,13,19,X95
Jutiapa,Enfermedad renal crónica,79,46,33,19,N18
Jutiapa,Diabetes mellitus no insulinodependiente,75,30,45,19,E11
Jutiapa,Exposición a factores no especificados,74,55,19,19,X59
Jutiapa,Tumor maligno del estómago,70,36,34,19,C16
Jutiapa,"Accidente de vehículo de motor o sin motor, tipo de vehículo no especificado",65,53,12,19,V89
Jutiapa,Fibrosis y cirrosis del hígado,64,38,26,19,K74
Jutiapa,Insuficiencia cardíaca,63,33,30,19,I50
Jutiapa,Hipertensión esencial (primaria),52,26,26,19,I10
Jutiapa,Otras enfermedades cerebrovasculares,49,25,24,19,I67
Jutiapa,Tumor maligno del hígado y de las vías biliares intrahepáticas,45,22,23,19,C22
Jutiapa,"Síntomas, signos y hallazgos anormales clínicos y de laboratorio, no clasificados en otra parte",142,75,67,19,R00 - R99
Jutiapa,Otras causas,932,507,425,19,Otras causas
Extranjero,Todas las causas,133,91,42,19,Todas las causas
Extranjero,"Accidente de vehículo de motor o sin motor, tipo de vehículo no especificado",15,9,6,19,V89
Extranjero,"Agresión con disparo de otras armas de fuego, y las no especificadas",8,8,0,19,X95
Extranjero,"Diabetes mellitus, no especificada",7,4,3,19,E14
Extranjero,Infarto agudo del miocardio,7,7,0,19,I21
Extranjero,Exposición a factores no especificados,6,5,1,19,X59
Extranjero,Tumor maligno del hígado y de las vías biliares intrahepáticas,5,4,1,19,C22
Extranjero,Tumor maligno del colon,4,1,3,19,C18
Extranjero,Diabetes mellitus no insulinodependiente,4,2,2,19,E11
Extranjero,Fibrosis y cirrosis del hígado,4,4,0,19,K74
Extranjero,Enfermedad renal crónica,4,3,1,19,N18
Extranjero,"Envenenamiento accidental por, y exposición al alcohol",4,4,0,19,X45
Extranjero,Tumor maligno del estómago,3,3,0,19,C16
Extranjero,"Neumonía, organismo no especificado",3,1,2,19,J18
Extranjero,"Disparo de otras armas de fuego, y las no especificadas",3,2,1,19,W34
Extranjero,Hepatitis viral crónica,2,2,0,19,B18
Extranjero,"Síntomas, signos y hallazgos anormales clínicos y de laboratorio, no clasificados en otra parte",6,2,4,19,R00 - R99
Extranjero,Otras causas,48,30,18,19,Otras causas
Ignorado,Todas las causas,8455,4861,3594,19,Todas las causas
Ignorado,"Neumonía, organismo no especificado",903,488,415,19,J18
Ignorado,Otras gastroenteritis y colitis de origen infeccioso y no especificado,493,275,218,19,A09
Ignorado,Dificultad respiratoria del recién nacido,423,245,178,19,P22
Ignorado,Sepsis bacteriana del recién nacido,291,157,134,19,P36
Ignorado,Otras malformaciones congénitas del corazón,279,160,119,19,Q24
Ignorado,Exposición a factores no especificados,226,178,48,19,X59
Ignorado,Neumonía congénita,219,125,94,19,P23
Ignorado,"Agresión con disparo de otras armas de fuego, y las no especificadas",215,185,30,19,X95
Ignorado,Otras sepsis,202,116,86,19,A41
Ignorado,"Otras malformaciones congénitas, no clasificadas en otra parte",172,94,78,19,Q89
Ignorado,Asfixia del nacimiento,165,91,74,19,P21
Ignorado,Síndromes de aspiración neonatal,151,87,64,19,P24
Ignorado,"Trastornos relacionados con duración corta de la gestación y con bajo peso al nacer, no clasificados en otra parte",131,77,54,19,P07
Ignorado,"Accidente de vehículo de motor o sin motor, tipo de vehículo no especificado",112,75,37,19,V89
Ignorado,Trastornos cardiovasculares originados en el período perinatal,96,52,44,19,P29
Ignorado,"Síntomas, signos y hallazgos anormales clínicos y de laboratorio, no clasificados en otra parte",750,395,355,19,R00 - R99
Ignorado,Otras causas,3627,2061,1566,19,Otras causas
Todos los departamentos,Todas las causas,96001,55184,40817,20,Todas las causas
Todos los departamentos,SARS-CoV2/COVID-19,8004,5654,2350,20,U07
Todos los departamentos,Infarto agudo del miocardio,7754,4428,3326,20,I21
Todos los departamentos,"Diabetes mellitus, no especificada",7242,3285,3957,20,E14
Todos los departamentos,"Neumonía, organismo no especificado",3926,2314,1612,20,J18
Todos los departamentos,Fibrosis y cirrosis del hígado,2873,1839,1034,20,K74
Todos los departamentos,Diabetes mellitus no insulinodependiente,2540,1146,1394,20,E11
Todos los departamentos,Exposición a factores no especificados,2535,2050,485,20,X59
Todos los departamentos,Enfermedad renal crónica,1936,1053,883,20,N18
Todos los departamentos,"Accidente vascular encefálico agudo, no especificado como hemorrágico o isquémico",1881,976,905,20,I64
Todos los departamentos,Otras gastroenteritis y colitis de origen infeccioso y no especificado,1811,939,872,20,A09
Todos los departamentos,"Agresión con disparo de otras armas de fuego, y las no especificadas",1720,1503,217,20,X95
Todos los departamentos,Tumor maligno del hígado y de las vías biliares intrahepáticas,1634,807,827,20,C22
Todos los departamentos,Insuficiencia cardíaca,1550,810,740,20,I50
Todos los departamentos,"Accidente de vehículo de motor o sin motor, tipo de vehículo no especificado",1343,1128,215,20,V89
Todos los departamentos,Insuficiencia renal no especificada,1333,770,563,20,N19
Todos los departamentos,"Síntomas, signos y hallazgos anormales clínicos y de laboratorio, no clasificados en otra parte",13404,7279,6125,20,R00 - R99
Todos los departamentos,Otras causas,34515,19203,15312,20,Otras causas
Guatemala,Todas las causas,23719,13625,10094,20,Todas las causas
Guatemala,SARS-CoV2/COVID-19,3513,2457,1056,20,U07
Guatemala,"Diabetes mellitus, no especificada",2291,1079,1212,20,E14
Guatemala,Infarto agudo del miocardio,1808,1043,765,20,I21
Guatemala,Fibrosis y cirrosis del hígado,980,668,312,20,K74
Guatemala,Exposición a factores no especificados,773,635,138,20,X59
Guatemala,"Neumonía, organismo no especificado",757,478,279,20,J18
Guatemala,Enfermedad renal crónica,596,305,291,20,N18
Guatemala,Diabetes mellitus no insulinodependiente,582,277,305,20,E11
Guatemala,"Agresión con disparo de otras armas de fuego, y las no especificadas",506,435,71,20,X95
Guatemala,Tumor maligno del hígado y de las vías biliares intrahepáticas,495,245,250,20,C22
Guatemala,Hipertensión esencial (primaria),378,192,186,20,I10
Guatemala,"Accidente vascular encefálico agudo, no especificado como hemorrágico o isquémico",342,169,173,20,I64
Guatemala,Insuficiencia cardíaca,336,178,158,20,I50
Guatemala,Insuficiencia renal no especificada,326,175,151,20,N19
Guatemala,Otras sepsis,282,147,135,20,A41
Guatemala,"Síntomas, signos y hallazgos anormales clínicos y de laboratorio, no clasificados en otra parte",2641,1396,1245,20,R00 - R99
Guatemala,Otras causas,7113,3746,3367,20,Otras causas
El Progreso,Todas las causas,1214,695,519,20,Todas las causas
El Progreso,Infarto agudo del miocardio,175,114,61,20,I21
El Progreso,"Diabetes mellitus, no especificada",130,56,74,20,E14
El Progreso,SARS-CoV2/COVID-19,102,73,29,20,U07
El Progreso,"Accidente vascular encefálico agudo, no especificado como hemorrágico o isquémico",61,31,30,20,I64
El Progreso,Diabetes mellitus no insulinodependiente,41,16,25,20,E11
El Progreso,"Neumonía, organismo no especificado",36,17,19,20,J18
El Progreso,Fibrosis y cirrosis del hígado,35,25,10,20,K74
El Progreso,Tumor maligno del hígado y de las vías biliares intrahepáticas,33,16,17,20,C22
El Progreso,"Accidente de vehículo de motor o sin motor, tipo de vehículo no especificado",28,19,9,20,V89
El Progreso,Exposición a factores no especificados,28,19,9,20,X59
El Progreso,Tumor maligno de la próstata,24,24,0,20,C61
El Progreso,Enfermedad cardíaca hipertensiva,20,13,7,20,I11
El Progreso,"Agresión con disparo de otras armas de fuego, y las no especificadas",20,16,4,20,X95
El Progreso,Tumor maligno del estómago,17,4,13,20,C16
El Progreso,Insuficiencia cardíaca,16,6,10,20,I50
El Progreso,"Síntomas, signos y hallazgos anormales clínicos y de laboratorio, no clasificados en otra parte",87,47,40,20,R00 - R99
El Progreso,Otras causas,361,199,162,20,Otras causas
Sacatepéquez,Todas las causas,2061,1181,880,20,Todas las causas
Sacatepéquez,SARS-CoV2/COVID-19,226,160,66,20,U07
Sacatepéquez,"Diabetes mellitus, no especificada",174,81,93,20,E14
Sacatepéquez,Infarto agudo del miocardio,157,96,61,20,I21
Sacatepéquez,Diabetes mellitus no insulinodependiente,131,57,74,20,E11
Sacatepéquez,Fibrosis y cirrosis del hígado,81,46,35,20,K74
Sacatepéquez,Exposición a factores no especificados,57,45,12,20,X59
Sacatepéquez,"Accidente vascular encefálico agudo, no especificado como hemorrágico o isquémico",48,24,24,20,I64
Sacatepéquez,"Neumonía, organismo no especificado",48,34,14,20,J18
Sacatepéquez,Enfermedad alcohólica del hígado,42,37,5,20,K70
Sacatepéquez,Tumor maligno del hígado y de las vías biliares intrahepáticas,38,15,23,20,C22
Sacatepéquez,Insuficiencia cardíaca,38,18,20,20,I50
Sacatepéquez,Enfermedad renal crónica,35,19,16,20,N18
Sacatepéquez,"Desnutrición proteicocalórica, no especificada",31,12,19,20,E46
Sacatepéquez,Tumor maligno del estómago,29,11,18,20,C16
Sacatepéquez,Insuficiencia renal no especificada,27,11,16,20,N19
Sacatepéquez,"Síntomas, signos y hallazgos anormales clínicos y de laboratorio, no clasificados en otra parte",214,111,103,20,R00 - R99
Sacatepéquez,Otras causas,685,404,281,20,Otras causas
Chimaltenango,Todas las causas,3113,1709,1404,20,Todas las causas
Chimaltenango,"Diabetes mellitus, no especificada",261,101,160,20,E14
Chimaltenango,Infarto agudo del miocardio,239,115,124,20,I21
Chimaltenango,SARS-CoV2/COVID-19,202,151,51,20,U07
Chimaltenango,Fibrosis y cirrosis del hígado,174,102,72,20,K74
Chimaltenango,"Neumonía, organismo no especificado",167,102,65,20,J18
Chimaltenango,"Accidente vascular encefálico agudo, no especificado como hemorrágico o isquémico",148,66,82,20,I64
Chimaltenango,Diabetes mellitus no insulinodependiente,100,47,53,20,E11
Chimaltenango,Tumor maligno del estómago,76,33,43,20,C16
Chimaltenango,Exposición a factores no especificados,76,63,13,20,X59
Chimaltenango,Insuficiencia cardíaca,75,36,39,20,I50
Chimaltenango,Enfermedad renal crónica,65,26,39,20,N18
Chimaltenango,Tumor maligno del hígado y de las vías biliares intrahepáticas,57,33,24,20,C22
Chimaltenango,Enfermedad alcohólica del hígado,56,46,10,20,K70
Chimaltenango,Trastornos mentales y del comportamiento debidos al uso de alcohol,53,47,6,20,F10
Chimaltenango,"Accidente de vehículo de motor o sin motor, tipo de vehículo no especificado",50,37,13,20,V89
Chimaltenango,"Síntomas, signos y hallazgos anormales clínicos y de laboratorio, no clasificados en otra parte",259,125,134,20,R00 - R99
Chimaltenango,Otras causas,1055,579,476,20,Otras causas
Escuintla,Todas las causas,5333,3237,2096,20,Todas las causas
Escuintla,"Diabetes mellitus, no especificada",510,241,269,20,E14
Escuintla,SARS-CoV2/COVID-19,487,357,130,20,U07
Escuintla,Infarto agudo del miocardio,465,275,190,20,I21
Escuintla,"Agresión con disparo de otras armas de fuego, y las no especificadas",228,201,27,20,X95
Escuintla,Enfermedad renal crónica,173,114,59,20,N18
Escuintla,Diabetes mellitus no insulinodependiente,168,67,101,20,E11
Escuintla,"Accidente de vehículo de motor o sin motor, tipo de vehículo no especificado",150,130,20,20,V89
Escuintla,Insuficiencia renal no especificada,138,93,45,20,N19
Escuintla,"Neumonía, organismo no especificado",132,86,46,20,J18
Escuintla,Exposición a factores no especificados,116,93,23,20,X59
Escuintla,Fibrosis y cirrosis del hígado,115,70,45,20,K74
Escuintla,Enfermedad isquémica crónica del corazón,91,54,37,20,I25
Escuintla,Tumor maligno del hígado y de las vías biliares intrahepáticas,86,44,42,20,C22
Escuintla,Hipertensión esencial (primaria),74,42,32,20,I10
Escuintla,"Accidente vascular encefálico agudo, no especificado como hemorrágico o isquémico",64,37,27,20,I64
Escuintla,"Síntomas, signos y hallazgos anormales clínicos y de laboratorio, no clasificados en otra parte",831,466,365,20,R00 - R99
Escuintla,Otras causas,1505,867,638,20,Otras causas
Santa Rosa,Todas las causas,2386,1408,978,20,Todas las causas
Santa Rosa,Infarto agudo del miocardio,246,144,102,20,I21
Santa Rosa,"Diabetes mellitus, no especificada",195,74,121,20,E14
Santa Rosa,SARS-CoV2/COVID-19,128,94,34,20,U07
Santa Rosa,Enfermedad renal crónica,100,59,41,20,N18
Santa Rosa,"Agresión con disparo de otras armas de fuego, y las no especificadas",74,65,9,20,X95
Santa Rosa,"Accidente de vehículo de motor o sin motor, tipo de vehículo no especificado",71,67,4,20,V89
Santa Rosa,Diabetes mellitus no insulinodependiente,51,20,31,20,E11
Santa Rosa,Insuficiencia cardíaca,50,28,22,20,I50
Santa Rosa,"Neumonía, organismo no especificado",50,33,17,20,J18
Santa Rosa,Exposición a factores no especificados,48,38,10,20,X59
Santa Rosa,Tumor maligno del hígado y de las vías biliares intrahepáticas,45,25,20,20,C22
Santa Rosa,"Accidente vascular encefálico agudo, no especificado como hemorrágico o isquémico",44,25,19,20,I64
Santa Rosa,Insuficiencia renal no especificada,42,23,19,20,N19
Santa Rosa,Fibrosis y cirrosis del hígado,36,25,11,20,K74
Santa Rosa,Otros trastornos del encéfalo,34,17,17,20,G93
Santa Rosa,"Síntomas, signos y hallazgos anormales clínicos y de laboratorio, no clasificados en otra parte",372,223,149,20,R00 - R99
Santa Rosa,Otras causas,800,448,352,20,Otras causas
Sololá,Todas las causas,2219,1259,960,20,Todas las causas
Sololá,SARS-CoV2/COVID-19,173,131,42,20,U07
Sololá,"Diabetes mellitus, no especificada",154,77,77,20,E14
Sololá,Infarto agudo del miocardio,116,61,55,20,I21
Sololá,Diabetes mellitus no insulinodependiente,111,55,56,20,E11
Sololá,"Neumonía, organismo no especificado",96,53,43,20,J18
Sololá,"Desnutrición proteicocalórica, no especificada",69,39,30,20,E46
Sololá,Exposición a factores no especificados,64,46,18,20,X59
Sololá,Otras gastroenteritis y colitis de origen infeccioso y no especificado,59,32,27,20,A09
Sololá,Fibrosis y cirrosis del hígado,57,31,26,20,K74
Sololá,Enfermedad renal crónica,55,27,28,20,N18
Sololá,Insuficiencia cardíaca,54,34,20,20,I50
Sololá,"Envenenamiento accidental por, y exposición al alcohol",48,45,3,20,X45
Sololá,"Accidente vascular encefálico agudo, no especificado como hemorrágico o isquémico",45,24,21,20,I64
Sololá,Tumor maligno del hígado y de las vías biliares intrahepáticas,38,22,16,20,C22
Sololá,Enfermedad alcohólica del hígado,36,34,2,20,K70
Sololá,"Síntomas, signos y hallazgos anormales clínicos y de laboratorio, no clasificados en otra parte",351,172,179,20,R00 - R99
Sololá,Otras causas,693,376,317,20,Otras causas
Totonicapán,Todas las causas,2921,1716,1205,20,Todas las causas
Totonicapán,"Diabetes mellitus, no especificada",270,145,125,20,E14
Totonicapán,SARS-CoV2/COVID-19,184,144,40,20,U07
Totonicapán,"Envenenamiento accidental por, y exposición al alcohol",122,103,19,20,X45
Totonicapán,Fibrosis y cirrosis del hígado,102,69,33,20,K74
Totonicapán,Hipertensión esencial (primaria),82,42,40,20,I10
Totonicapán,Trastornos mentales y del comportamiento debidos al uso de alcohol,77,67,10,20,F10
Totonicapán,Infarto agudo del miocardio,71,45,26,20,I21
Totonicapán,"Neumonía, organismo no especificado",71,49,22,20,J18
Totonicapán,Otras gastroenteritis y colitis de origen infeccioso y no especificado,56,27,29,20,A09
Totonicapán,Exposición a factores no especificados,47,39,8,20,X59
Totonicapán,Diabetes mellitus no insulinodependiente,46,22,24,20,E11
Totonicapán,Insuficiencia renal no especificada,44,20,24,20,N19
Totonicapán,Otros trastornos del encéfalo,43,20,23,20,G93
Totonicapán,Úlcera gástrica,33,15,18,20,K25
Totonicapán,Complicaciones y descripciones mal definidas de enfermedad cardíaca,29,21,8,20,I51
Totonicapán,"Síntomas, signos y hallazgos anormales clínicos y de laboratorio, no clasificados en otra parte",982,534,448,20,R00 - R99
Totonicapán,Otras causas,662,354,308,20,Otras causas
Quetzaltenango,Todas las causas,5616,3184,2432,20,Todas las causas
Quetzaltenango,SARS-CoV2/COVID-19,558,370,188,20,U07
Quetzaltenango,"Diabetes mellitus, no especificada",499,259,240,20,E14
Quetzaltenango,Infarto agudo del miocardio,347,204,143,20,I21
Quetzaltenango,Insuficiencia cardíaca,274,129,145,20,I50
Quetzaltenango,Diabetes mellitus no insulinodependiente,235,117,118,20,E11
Quetzaltenango,Fibrosis y cirrosis del hígado,166,108,58,20,K74
Quetzaltenango,Exposición a factores no especificados,143,110,33,20,X59
Quetzaltenango,Enfermedad alcohólica del hígado,134,112,22,20,K70
Quetzaltenango,Tumor maligno del hígado y de las vías biliares intrahepáticas,112,50,62,20,C22
Quetzaltenango,"Accidente vascular encefálico agudo, no especificado como hemorrágico o isquémico",105,63,42,20,I64
Quetzaltenango,Insuficiencia renal no especificada,100,52,48,20,N19
Quetzaltenango,"Neumonía, organismo no especificado",97,56,41,20,J18
Quetzaltenango,"Envenenamiento accidental por, y exposición al alcohol",95,80,15,20,X45
Quetzaltenango,Enfermedad renal crónica,79,41,38,20,N18
Quetzaltenango,Tumor maligno del estómago,76,26,50,20,C16
Quetzaltenango,"Síntomas, signos y hallazgos anormales clínicos y de laboratorio, no clasificados en otra parte",712,361,351,20,R00 - R99
Quetzaltenango,Otras causas,1884,1046,838,20,Otras causas
Suchitepéquez,Todas las causas,3725,2193,1532,20,Todas las causas
Suchitepéquez,SARS-CoV2/COVID-19,230,178,52,20,U07
Suchitepéquez,"Diabetes mellitus, no especificada",199,95,104,20,E14
Suchitepéquez,Infarto agudo del miocardio,123,71,52,20,I21
Suchitepéquez,Insuficiencia renal no especificada,114,70,44,20,N19
Suchitepéquez,Exposición a factores no especificados,105,90,15,20,X59
Suchitepéquez,Fibrosis y cirrosis del hígado,92,50,42,20,K74
Suchitepéquez,Enfermedad renal crónica,85,52,33,20,N18
Suchitepéquez,Diabetes mellitus no insulinodependiente,58,26,32,20,E11
Suchitepéquez,"Neumonía, organismo no especificado",51,31,20,20,J18
Suchitepéquez,"Accidente de vehículo de motor o sin motor, tipo de vehículo no especificado",39,34,5,20,V89
Suchitepéquez,Tumor maligno del hígado y de las vías biliares intrahepáticas,38,18,20,20,C22
Suchitepéquez,Otros trastornos del encéfalo,36,24,12,20,G93
Suchitepéquez,Diabetes mellitus insulinodependiente,32,11,21,20,E10
Suchitepéquez,"Desnutrición proteicocalórica, no especificada",29,17,12,20,E46
Suchitepéquez,Insuficiencia cardíaca,29,16,13,20,I50
Suchitepéquez,"Síntomas, signos y hallazgos anormales clínicos y de laboratorio, no clasificados en otra parte",1753,983,770,20,R00 - R99
Suchitepéquez,Otras causas,712,427,285,20,Otras causas
Retalhuleu,Todas las causas,2255,1345,910,20,Todas las causas
Retalhuleu,SARS-CoV2/COVID-19,136,102,34,20,U07
Retalhuleu,"Diabetes mellitus, no especificada",122,50,72,20,E14
Retalhuleu,Exposición a factores no especificados,61,49,12,20,X59
Retalhuleu,Infarto agudo del miocardio,51,29,22,20,I21
Retalhuleu,Insuficiencia renal no especificada,49,44,5,20,N19
Retalhuleu,"Neumonía, organismo no especificado",47,33,14,20,J18
Retalhuleu,Enfermedad renal crónica,44,34,10,20,N18
Retalhuleu,"Agresión con disparo de otras armas de fuego, y las no especificadas",41,37,4,20,X95
Retalhuleu,"Accidente de vehículo de motor o sin motor, tipo de vehículo no especificado",40,35,5,20,V89
Retalhuleu,Fibrosis y cirrosis del hígado,34,17,17,20,K74
Retalhuleu,Insuficiencia cardíaca,20,11,9,20,I50
Retalhuleu,Diabetes mellitus no insulinodependiente,19,11,8,20,E11
Retalhuleu,Otras anemias,16,11,5,20,D64
Retalhuleu,Otras sepsis,13,7,6,20,A41
Retalhuleu,Otros trastornos del encéfalo,13,8,5,20,G93
Retalhuleu,"Síntomas, signos y hallazgos anormales clínicos y de laboratorio, no clasificados en otra parte",1151,645,506,20,R00 - R99
Retalhuleu,Otras causas,398,222,176,20,Otras causas
San Marcos,Todas las causas,5654,3325,2329,20,Todas las causas
San Marcos,Infarto agudo del miocardio,611,358,253,20,I21
San Marcos,"Neumonía, organismo no especificado",425,267,158,20,J18
San Marcos,"Diabetes mellitus, no especificada",412,181,231,20,E14
San Marcos,SARS-CoV2/COVID-19,347,237,110,20,U07
San Marcos,Fibrosis y cirrosis del hígado,227,150,77,20,K74
San Marcos,Insuficiencia cardíaca,155,84,71,20,I50
San Marcos,Diabetes mellitus no insulinodependiente,153,70,83,20,E11
San Marcos,Enfermedad renal crónica,149,82,67,20,N18
San Marcos,Tumor maligno del hígado y de las vías biliares intrahepáticas,143,72,71,20,C22
San Marcos,Exposición a factores no especificados,124,92,32,20,X59
San Marcos,Otras gastroenteritis y colitis de origen infeccioso y no especificado,112,64,48,20,A09
San Marcos,"Accidente vascular encefálico agudo, no especificado como hemorrágico o isquémico",104,59,45,20,I64
San Marcos,"Envenenamiento accidental por, y exposición al alcohol",100,88,12,20,X45
San Marcos,Otros trastornos del encéfalo,92,54,38,20,G93
San Marcos,Úlcera gástrica,83,38,45,20,K25
San Marcos,"Síntomas, signos y hallazgos anormales clínicos y de laboratorio, no clasificados en otra parte",600,358,242,20,R00 - R99
San Marcos,Otras causas,1817,1071,746,20,Otras causas
Huehuetenango,Todas las causas,4764,2673,2091,20,Todas las causas
Huehuetenango,Infarto agudo del miocardio,548,323,225,20,I21
Huehuetenango,"Diabetes mellitus, no especificada",378,148,230,20,E14
Huehuetenango,"Neumonía, organismo no especificado",317,176,141,20,J18
Huehuetenango,SARS-CoV2/COVID-19,291,209,82,20,U07
Huehuetenango,Otras gastroenteritis y colitis de origen infeccioso y no especificado,162,77,85,20,A09
Huehuetenango,Otras enfermedades cerebrovasculares,156,83,73,20,I67
Huehuetenango,Diabetes mellitus no insulinodependiente,154,51,103,20,E11
Huehuetenango,"Accidente vascular encefálico agudo, no especificado como hemorrágico o isquémico",152,90,62,20,I64
Huehuetenango,Fibrosis y cirrosis del hígado,126,82,44,20,K74
Huehuetenango,Tumor maligno del estómago,114,66,48,20,C16
Huehuetenango,Exposición a factores no especificados,110,92,18,20,X59
Huehuetenango,Tumor maligno del hígado y de las vías biliares intrahepáticas,100,57,43,20,C22
Huehuetenango,Enfermedad renal crónica,93,45,48,20,N18
Huehuetenango,Insuficiencia cardíaca,91,50,41,20,I50
Huehuetenango,"Envenenamiento accidental por, y exposición al alcohol",71,65,6,20,X45
Huehuetenango,"Síntomas, signos y hallazgos anormales clínicos y de laboratorio, no clasificados en otra parte",180,88,92,20,R00 - R99
Huehuetenango,Otras causas,1721,971,750,20,Otras causas
Quiche,Todas las causas,4193,2350,1843,20,Todas las causas
Quiche,"Diabetes mellitus, no especificada",284,136,148,20,E14
Quiche,Infarto agudo del miocardio,237,129,108,20,I21
Quiche,"Neumonía, organismo no especificado",208,120,88,20,J18
Quiche,SARS-CoV2/COVID-19,180,139,41,20,U07
Quiche,Diabetes mellitus no insulinodependiente,179,98,81,20,E11
Quiche,Otras gastroenteritis y colitis de origen infeccioso y no especificado,102,40,62,20,A09
Quiche,Fibrosis y cirrosis del hígado,102,70,32,20,K74
Quiche,"Envenenamiento accidental por, y exposición al alcohol",101,96,5,20,X45
Quiche,Exposición a factores no especificados,95,75,20,20,X59
Quiche,"Accidente vascular encefálico agudo, no especificado como hemorrágico o isquémico",74,34,40,20,I64
Quiche,Enfermedad renal crónica,72,45,27,20,N18
Quiche,Tumor maligno del hígado y de las vías biliares intrahepáticas,68,33,35,20,C22
Quiche,Tumor maligno del estómago,65,34,31,20,C16
Quiche,Trastornos mentales y del comportamiento debidos al uso de alcohol,65,62,3,20,F10
Quiche,Hipertensión esencial (primaria),60,28,32,20,I10
Quiche,"Síntomas, signos y hallazgos anormales clínicos y de laboratorio, no clasificados en otra parte",942,483,459,20,R00 - R99
Quiche,Otras causas,1359,728,631,20,Otras causas
Baja Verapaz,Todas las causas,1425,741,684,20,Todas las causas
Baja Verapaz,Infarto agudo del miocardio,169,87,82,20,I21
Baja Verapaz,"Diabetes mellitus, no especificada",106,43,63,20,E14
Baja Verapaz,SARS-CoV2/COVID-19,100,69,31,20,U07
Baja Verapaz,"Accidente vascular encefálico agudo, no especificado como hemorrágico o isquémico",89,41,48,20,I64
Baja Verapaz,"Neumonía, organismo no especificado",69,37,32,20,J18
Baja Verapaz,Exposición a factores no especificados,52,36,16,20,X59
Baja Verapaz,Hipertensión esencial (primaria),47,25,22,20,I10
Baja Verapaz,Tumor maligno del estómago,35,22,13,20,C16
Baja Verapaz,Diabetes mellitus no insulinodependiente,35,9,26,20,E11
Baja Verapaz,"Accidente de vehículo de motor o sin motor, tipo de vehículo no especificado",26,21,5,20,V89
Baja Verapaz,Enfermedad renal crónica,25,12,13,20,N18
Baja Verapaz,Tumor maligno del hígado y de las vías biliares intrahepáticas,24,12,12,20,C22
Baja Verapaz,Otras gastroenteritis y colitis de origen infeccioso y no especificado,23,11,12,20,A09
Baja Verapaz,Fibrosis y cirrosis del hígado,23,15,8,20,K74
Baja Verapaz,Otras enfermedades pulmonares obstructivas crónicas,16,5,11,20,J44
Baja Verapaz,"Síntomas, signos y hallazgos anormales clínicos y de laboratorio, no clasificados en otra parte",125,58,67,20,R00 - R99
Baja Verapaz,Otras causas,461,238,223,20,Otras causas
Alta Verapaz,Todas las causas,4651,2458,2193,20,Todas las causas
Alta Verapaz,Otras gastroenteritis y colitis de origen infeccioso y no especificado,537,287,250,20,A09
Alta Verapaz,Infarto agudo del miocardio,453,238,215,20,I21
Alta Verapaz,"Neumonía, organismo no especificado",374,178,196,20,J18
Alta Verapaz,"Diabetes mellitus, no especificada",245,92,153,20,E14
Alta Verapaz,Fibrosis y cirrosis del hígado,158,79,79,20,K74
Alta Verapaz,SARS-CoV2/COVID-19,142,106,36,20,U07
Alta Verapaz,Exposición a factores no especificados,127,111,16,20,X59
Alta Verapaz,"Accidente vascular encefálico agudo, no especificado como hemorrágico o isquémico",110,63,47,20,I64
Alta Verapaz,Diabetes mellitus no insulinodependiente,108,45,63,20,E11
Alta Verapaz,Tumor maligno del hígado y de las vías biliares intrahepáticas,107,51,56,20,C22
Alta Verapaz,Tumor maligno del estómago,81,33,48,20,C16
Alta Verapaz,"Accidente de vehículo de motor o sin motor, tipo de vehículo no especificado",75,65,10,20,V89
Alta Verapaz,"Desnutrición proteicocalórica, no especificada",70,34,36,20,E46
Alta Verapaz,Úlcera gástrica,70,32,38,20,K25
Alta Verapaz,Otras sepsis,63,24,39,20,A41
Alta Verapaz,"Síntomas, signos y hallazgos anormales clínicos y de laboratorio, no clasificados en otra parte",157,73,84,20,R00 - R99
Alta Verapaz,Otras causas,1774,947,827,20,Otras causas
Peten,Todas las causas,2306,1370,936,20,Todas las causas
Peten,"Diabetes mellitus, no especificada",254,106,148,20,E14
Peten,SARS-CoV2/COVID-19,173,115,58,20,U07
Peten,Infarto agudo del miocardio,167,110,57,20,I21
Peten,"Agresión con disparo de otras armas de fuego, y las no especificadas",98,88,10,20,X95
Peten,"Accidente de vehículo de motor o sin motor, tipo de vehículo no especificado",71,58,13,20,V89
Peten,Fibrosis y cirrosis del hígado,67,37,30,20,K74
Peten,Diabetes mellitus no insulinodependiente,58,22,36,20,E11
Peten,"Neumonía, organismo no especificado",58,42,16,20,J18
Peten,Exposición a factores no especificados,50,42,8,20,X59
Peten,Tumor maligno del hígado y de las vías biliares intrahepáticas,45,18,27,20,C22
Peten,Otros trastornos del encéfalo,42,26,16,20,G93
Peten,Tumor maligno de la próstata,36,36,0,20,C61
Peten,Hipertensión esencial (primaria),36,20,16,20,I10
Peten,"Accidente vascular encefálico agudo, no especificado como hemorrágico o isquémico",35,20,15,20,I64
Peten,Tumor maligno del estómago,33,18,15,20,C16
Peten,"Síntomas, signos y hallazgos anormales clínicos y de laboratorio, no clasificados en otra parte",225,139,86,20,R00 - R99
Peten,Otras causas,858,473,385,20,Otras causas
Izabal,Todas las causas,2487,1462,1025,20,Todas las causas
Izabal,Infarto agudo del miocardio,422,234,188,20,I21
Izabal,SARS-CoV2/COVID-19,225,158,67,20,U07
Izabal,"Diabetes mellitus, no especificada",169,65,104,20,E14
Izabal,"Accidente de vehículo de motor o sin motor, tipo de vehículo no especificado",105,88,17,20,V89
Izabal,"Neumonía, organismo no especificado",74,45,29,20,J18
Izabal,"Agresión con disparo de otras armas de fuego, y las no especificadas",72,63,9,20,X95
Izabal,Fibrosis y cirrosis del hígado,69,37,32,20,K74
Izabal,"Disparo de otras armas de fuego, y las no especificadas",55,49,6,20,W34
Izabal,Exposición a factores no especificados,51,46,5,20,X59
Izabal,"Accidente vascular encefálico agudo, no especificado como hemorrágico o isquémico",43,25,18,20,I64
Izabal,Diabetes mellitus no insulinodependiente,36,15,21,20,E11
Izabal,Otras sepsis,35,18,17,20,A41
Izabal,Otras gastroenteritis y colitis de origen infeccioso y no especificado,34,15,19,20,A09
Izabal,Enfermedad renal crónica,32,17,15,20,N18
Izabal,Insuficiencia cardíaca,31,14,17,20,I50
Izabal,"Síntomas, signos y hallazgos anormales clínicos y de laboratorio, no clasificados en otra parte",265,135,130,20,R00 - R99
Izabal,Otras causas,769,438,331,20,Otras causas
Zacapa,Todas las causas,1587,900,687,20,Todas las causas
Zacapa,Infarto agudo del miocardio,267,156,111,20,I21
Zacapa,SARS-CoV2/COVID-19,142,82,60,20,U07
Zacapa,"Diabetes mellitus, no especificada",104,45,59,20,E14
Zacapa,Diabetes mellitus no insulinodependiente,61,25,36,20,E11
Zacapa,Otras enfermedades cerebrovasculares,61,31,30,20,I67
Zacapa,Exposición a factores no especificados,54,46,8,20,X59
Zacapa,Fibrosis y cirrosis del hígado,48,32,16,20,K74
Zacapa,"Accidente vascular encefálico agudo, no especificado como hemorrágico o isquémico",46,20,26,20,I64
Zacapa,"Neumonía, organismo no especificado",34,20,14,20,J18
Zacapa,Enfermedad renal crónica,33,17,16,20,N18
Zacapa,Tumor maligno del hígado y de las vías biliares intrahepáticas,32,18,14,20,C22
Zacapa,"Agresión con disparo de otras armas de fuego, y las no especificadas",30,27,3,20,X95
Zacapa,"Accidente de vehículo de motor o sin motor, tipo de vehículo no especificado",28,25,3,20,V89
Zacapa,Insuficiencia cardíaca,27,16,11,20,I50
Zacapa,Tumor maligno del estómago,22,14,8,20,C16
Zacapa,"Síntomas, signos y hallazgos anormales clínicos y de laboratorio, no clasificados en otra parte",65,31,34,20,R00 - R99
Zacapa,Otras causas,533,295,238,20,Otras causas
Chiquimula,Todas las causas,2022,1211,811,20,Todas las causas
Chiquimula,Infarto agudo del miocardio,298,162,136,20,I21
Chiquimula,"Diabetes mellitus, no especificada",131,60,71,20,E14
Chiquimula,SARS-CoV2/COVID-19,117,88,29,20,U07
Chiquimula,"Agresión con disparo de otras armas de fuego, y las no especificadas",96,88,8,20,X95
Chiquimula,"Neumonía, organismo no especificado",89,53,36,20,J18
Chiquimula,"Accidente vascular encefálico agudo, no especificado como hemorrágico o isquémico",72,38,34,20,I64
Chiquimula,Fibrosis y cirrosis del hígado,53,33,20,20,K74
Chiquimula,Insuficiencia cardíaca,51,35,16,20,I50
Chiquimula,Tumor maligno del estómago,49,23,26,20,C16
Chiquimula,Diabetes mellitus no insulinodependiente,49,24,25,20,E11
Chiquimula,"Accidente de vehículo de motor o sin motor, tipo de vehículo no especificado",35,33,2,20,V89
Chiquimula,Otras enfermedades pulmonares obstructivas crónicas,34,15,19,20,J44
Chiquimula,Enfermedad renal crónica,32,14,18,20,N18
Chiquimula,Exposición a factores no especificados,30,22,8,20,X59
Chiquimula,Agresión con objeto cortante,29,27,2,20,X99
Chiquimula,"Síntomas, signos y hallazgos anormales clínicos y de laboratorio, no clasificados en otra parte",142,91,51,20,R00 - R99
Chiquimula,Otras causas,715,405,310,20,Otras causas
Jalapa,Todas las causas,1649,931,718,20,Todas las causas
Jalapa,Infarto agudo del miocardio,110,57,53,20,I21
Jalapa,"Diabetes mellitus, no especificada",84,32,52,20,E14
Jalapa,Otros trastornos del encéfalo,83,46,37,20,G93
Jalapa,"Agresión con disparo de otras armas de fuego, y las no especificadas",75,65,10,20,X95
Jalapa,"Neumonía, organismo no especificado",60,35,25,20,J18
Jalapa,"Accidente vascular encefálico agudo, no especificado como hemorrágico o isquémico",54,26,28,20,I64
Jalapa,SARS-CoV2/COVID-19,51,33,18,20,U07
Jalapa,Exposición a factores no especificados,42,37,5,20,X59
Jalapa,Otros trastornos y los no especificados del sistema circulatorio,41,26,15,20,I99
Jalapa,Tumor maligno del estómago,30,14,16,20,C16
Jalapa,Tumor maligno del hígado y de las vías biliares intrahepáticas,30,14,16,20,C22
Jalapa,Insuficiencia cardíaca,27,11,16,20,I50
Jalapa,Insuficiencia renal no especificada,27,12,15,20,N19
Jalapa,Tumor maligno de la próstata,26,26,0,20,C61
Jalapa,"Accidente de vehículo de motor o sin motor, tipo de vehículo no especificado",25,25,0,20,V89
Jalapa,"Síntomas, signos y hallazgos anormales clínicos y de laboratorio, no clasificados en otra parte",345,189,156,20,R00 - R99
Jalapa,Otras causas,539,283,256,20,Otras causas
Jutiapa,Todas las causas,2919,1664,1255,20,Todas las causas
Jutiapa,Infarto agudo del miocardio,574,328,246,20,I21
Jutiapa,"Diabetes mellitus, no especificada",205,80,125,20,E14
Jutiapa,"Accidente vascular encefálico agudo, no especificado como hemorrágico o isquémico",174,87,87,20,I64
Jutiapa,SARS-CoV2/COVID-19,134,100,34,20,U07
Jutiapa,Diabetes mellitus no insulinodependiente,121,54,67,20,E11
Jutiapa,Tumor maligno del estómago,90,40,50,20,C16
Jutiapa,"Agresión con disparo de otras armas de fuego, y las no especificadas",89,79,10,20,X95
Jutiapa,Enfermedad renal crónica,88,52,36,20,N18
Jutiapa,"Neumonía, organismo no especificado",72,41,31,20,J18
Jutiapa,Exposición a factores no especificados,63,49,14,20,X59
Jutiapa,"Accidente de vehículo de motor o sin motor, tipo de vehículo no especificado",58,47,11,20,V89
Jutiapa,Fibrosis y cirrosis del hígado,57,36,21,20,K74
Jutiapa,Insuficiencia cardíaca,52,19,33,20,I50
Jutiapa,Tumor maligno de la próstata,48,48,0,20,C61
Jutiapa,Tumor maligno del hígado y de las vías biliares intrahepáticas,43,17,26,20,C22
Jutiapa,"Síntomas, signos y hallazgos anormales clínicos y de laboratorio, no clasificados en otra parte",178,100,78,20,R00 - R99
Jutiapa,Otras causas,873,487,386,20,Otras causas
Extranjero,Todas las causas,108,75,33,20,Todas las causas
Extranjero,"Agresión con disparo de otras armas de fuego, y las no especificadas",9,8,1,20,X95
Extranjero,"Diabetes mellitus, no especificada",8,8,0,20,E14
Extranjero,Infarto agudo del miocardio,7,4,3,20,I21
Extranjero,"Accidente de vehículo de motor o sin motor, tipo de vehículo no especificado",6,6,0,20,V89
Extranjero,Exposición a factores no especificados,5,4,1,20,X59
Extranjero,Fibrosis y cirrosis del hígado,4,3,1,20,K74
Extranjero,SARS-CoV2/COVID-19,4,2,2,20,U07
Extranjero,Tumor maligno del páncreas,3,1,2,20,C25
Extranjero,Leucemia de células de tipo no especificado,3,3,0,20,C95
Extranjero,Insuficiencia cardíaca,3,3,0,20,I50
Extranjero,Enfermedad renal crónica,3,2,1,20,N18
Extranjero,Tumor maligno del estómago,2,1,1,20,C16
Extranjero,Tumor maligno del hígado y de las vías biliares intrahepáticas,2,1,1,20,C22
Extranjero,Tumor maligno de los bronquios y del pulmón,2,1,1,20,C34
Extranjero,Tumor maligno de sitios no especificados,2,1,1,20,C80
Extranjero,"Síntomas, signos y hallazgos anormales clínicos y de laboratorio, no clasificados en otra parte",7,6,1,20,R00 - R99
Extranjero,Otras causas,38,21,17,20,Otras causas
Ignorado,Todas las causas,7674,4472,3202,20,Todas las causas
Ignorado,"Neumonía, organismo no especificado",593,327,266,20,J18
Ignorado,Otras gastroenteritis y colitis de origen infeccioso y no especificado,432,247,185,20,A09
Ignorado,Dificultad respiratoria del recién nacido,355,213,142,20,P22
Ignorado,Sepsis bacteriana del recién nacido,311,184,127,20,P36
Ignorado,Otras malformaciones congénitas del corazón,254,134,120,20,Q24
Ignorado,Exposición a factores no especificados,214,171,43,20,X59
Ignorado,Otras sepsis,206,121,85,20,A41
Ignorado,Neumonía congénita,186,103,83,20,P23
Ignorado,SARS-CoV2/COVID-19,159,99,60,20,U07
Ignorado,Síndromes de aspiración neonatal,143,73,70,20,P24
Ignorado,"Agresión con disparo de otras armas de fuego, y las no especificadas",132,112,20,20,X95
Ignorado,"Otras malformaciones congénitas, no clasificadas en otra parte",131,63,68,20,Q89
Ignorado,Asfixia del nacimiento,120,74,46,20,P21
Ignorado,"Trastornos relacionados con duración corta de la gestación y con bajo peso al nacer, no clasificados en otra parte",94,55,39,20,P07
Ignorado,Infarto agudo del miocardio,93,45,48,20,I21
Ignorado,"Síntomas, signos y hallazgos anormales clínicos y de laboratorio, no clasificados en otra parte",820,465,355,20,R00 - R99
Ignorado,Otras causas,3431,1986,1445,20,Otras causas
Todos los departamentos,Todas las causas,118465,66951,51514,21,Todas las causas
Todos los departamentos,SARS-CoV2/COVID 19,14628,9022,5606,21,U07
Todos los departamentos,Infarto agudo del miocardio,11083,6262,4821,21,I21
Todos los departamentos,"Diabetes mellitus, no especificada",8156,3585,4571,21,E14
Todos los departamentos,"Neumonía, organismo no especificado",4563,2710,1853,21,J18
Todos los departamentos,Fibrosis y cirrosis del hígado,3345,2257,1088,21,K74
Todos los departamentos,Diabetes mellitus no insulinodependiente,3281,1450,1831,21,E11
Todos los departamentos,Exposición a factores no especificados,2612,2141,471,21,X59
Todos los departamentos,"Accidente vascular encefálico agudo, no especificado como hemorrágico o isquémico",2250,1071,1179,21,I64
Todos los departamentos,Otras gastroenteritis y colitis de origen infeccioso y no especificado,2228,1153,1075,21,A09
Todos los departamentos,"Agresión con disparo de otras armas de fuego, y las no especificadas",2044,1792,252,21,X95
Todos los departamentos,"Accidente de vehículo de motor o sin motor, tipo de vehículo no especificado",1968,1700,268,21,V89
Todos los departamentos,Enfermedad renal crónica,1963,1075,888,21,N18
Todos los departamentos,Tumor maligno del hígado y de las vías biliares intrahepáticas,1788,880,908,21,C22
Todos los departamentos,Insuficiencia cardíaca,1599,793,806,21,I50
Todos los departamentos,Hipertensión esencial (primaria),1548,715,833,21,I10
Todos los departamentos,"Síntomas, signos y hallazgos anormales clínicos y de laboratorio, no clasificados en otra parte",16287,8669,7618,21,R00 - R99
Todos los departamentos,Otras causas,39122,21676,17446,21,Otras causas
Guatemala,Todas las causas,27445,15413,12032,21,Todas las causas
Guatemala,SARS-CoV2/COVID 19,5226,3283,1943,21,U07
Guatemala,Infarto agudo del miocardio,2641,1434,1207,21,I21
Guatemala,"Diabetes mellitus, no especificada",2341,1071,1270,21,E14
Guatemala,Fibrosis y cirrosis del hígado,1061,754,307,21,K74
Guatemala,Exposición a factores no especificados,810,682,128,21,X59
Guatemala,"Agresión con disparo de otras armas de fuego, y las no especificadas",735,635,100,21,X95
Guatemala,"Neumonía, organismo no especificado",695,428,267,21,J18
Guatemala,Diabetes mellitus no insulinodependiente,663,303,360,21,E11
Guatemala,Enfermedad renal crónica,582,299,283,21,N18
Guatemala,Tumor maligno del hígado y de las vías biliares intrahepáticas,523,247,276,21,C22
Guatemala,Otras sepsis,465,231,234,21,A41
Guatemala,"Accidente vascular encefálico agudo, no especificado como hemorrágico o isquémico",367,163,204,21,I64
Guatemala,Hipertensión esencial (primaria),349,162,187,21,I10
Guatemala,Tumor maligno del estómago,320,159,161,21,C16
Guatemala,Insuficiencia cardíaca,315,139,176,21,I50
Guatemala,"Síntomas, signos y hallazgos anormales clínicos y de laboratorio, no clasificados en otra parte",2574,1306,1268,21,R00 - R99
Guatemala,Otras causas,7778,4117,3661,21,Otras causas
El Progreso,Todas las causas,1587,928,659,21,Todas las causas
El Progreso,Infarto agudo del miocardio,297,176,121,21,I21
El Progreso,SARS-CoV2/COVID 19,293,165,128,21,U07
El Progreso,"Diabetes mellitus, no especificada",136,67,69,21,E14
El Progreso,"Accidente vascular encefálico agudo, no especificado como hemorrágico o isquémico",50,27,23,21,I64
El Progreso,"Accidente de vehículo de motor o sin motor, tipo de vehículo no especificado",46,42,4,21,V89
El Progreso,Diabetes mellitus no insulinodependiente,40,13,27,21,E11
El Progreso,"Neumonía, organismo no especificado",36,23,13,21,J18
El Progreso,Fibrosis y cirrosis del hígado,32,17,15,21,K74
El Progreso,Tumor maligno del hígado y de las vías biliares intrahepáticas,28,17,11,21,C22
El Progreso,Exposición a factores no especificados,28,24,4,21,X59
El Progreso,Enfermedad renal crónica,22,10,12,21,N18
El Progreso,"Agresión con disparo de otras armas de fuego, y las no especificadas",22,22,0,21,X95
El Progreso,Otras enfermedades pulmonares obstructivas crónicas,20,13,7,21,J44
El Progreso,Otras sepsis,18,10,8,21,A41
El Progreso,Hipertensión esencial (primaria),18,11,7,21,I10
El Progreso,"Síntomas, signos y hallazgos anormales clínicos y de laboratorio, no clasificados en otra parte",93,54,39,21,R00 - R99
El Progreso,Otras causas,408,237,171,21,Otras causas
Sacatepéquez,Todas las causas,2709,1581,1128,21,Todas las causas
Sacatepéquez,SARS-CoV2/COVID 19,500,329,171,21,U07
Sacatepéquez,Infarto agudo del miocardio,208,115,93,21,I21
Sacatepéquez,"Diabetes mellitus, no especificada",182,85,97,21,E14
Sacatepéquez,Diabetes mellitus no insulinodependiente,146,62,84,21,E11
Sacatepéquez,Fibrosis y cirrosis del hígado,85,57,28,21,K74
Sacatepéquez,"Neumonía, organismo no especificado",82,62,20,21,J18
Sacatepéquez,Exposición a factores no especificados,71,60,11,21,X59
Sacatepéquez,"Accidente de vehículo de motor o sin motor, tipo de vehículo no especificado",55,50,5,21,V89
Sacatepéquez,Enfermedad alcohólica del hígado,50,39,11,21,K70
Sacatepéquez,Enfermedad renal crónica,45,24,21,21,N18
Sacatepéquez,"Accidente vascular encefálico agudo, no especificado como hemorrágico o isquémico",44,19,25,21,I64
Sacatepéquez,Tumor maligno del hígado y de las vías biliares intrahepáticas,43,23,20,21,C22
Sacatepéquez,Insuficiencia cardíaca,40,19,21,21,I50
Sacatepéquez,"Desnutrición proteicocalórica, no especificada",34,15,19,21,E46
Sacatepéquez,Tumor maligno del estómago,33,11,22,21,C16
Sacatepéquez,"Síntomas, signos y hallazgos anormales clínicos y de laboratorio, no clasificados en otra parte",247,124,123,21,R00 - R99
Sacatepéquez,Otras causas,844,487,357,21,Otras causas
Chimaltenango,Todas las causas,4354,2499,1855,21,Todas las causas
Chimaltenango,Infarto agudo del miocardio,456,262,194,21,I21
Chimaltenango,SARS-CoV2/COVID 19,452,287,165,21,U07
Chimaltenango,"Diabetes mellitus, no especificada",362,152,210,21,E14
Chimaltenango,Fibrosis y cirrosis del hígado,262,179,83,21,K74
Chimaltenango,"Neumonía, organismo no especificado",221,146,75,21,J18
Chimaltenango,Diabetes mellitus no insulinodependiente,175,75,100,21,E11
Chimaltenango,"Accidente vascular encefálico agudo, no especificado como hemorrágico o isquémico",163,85,78,21,I64
Chimaltenango,Insuficiencia cardíaca,129,70,59,21,I50
Chimaltenango,Enfermedad alcohólica del hígado,106,91,15,21,K70
Chimaltenango,Trastornos mentales y del comportamiento debidos al uso de alcohol,86,73,13,21,F10
Chimaltenango,Enfermedad renal crónica,76,33,43,21,N18
Chimaltenango,Tumor maligno del hígado y de las vías biliares intrahepáticas,67,33,34,21,C22
Chimaltenango,Exposición a factores no especificados,67,50,17,21,X59
Chimaltenango,"Accidente de vehículo de motor o sin motor, tipo de vehículo no especificado",64,58,6,21,V89
Chimaltenango,Tumor maligno del estómago,63,28,35,21,C16
Chimaltenango,"Síntomas, signos y hallazgos anormales clínicos y de laboratorio, no clasificados en otra parte",328,169,159,21,R00 - R99
Chimaltenango,Otras causas,1277,708,569,21,Otras causas
Escuintla,Todas las causas,6170,3652,2518,21,Todas las causas
Escuintla,SARS-CoV2/COVID 19,782,506,276,21,U07
Escuintla,"Diabetes mellitus, no especificada",553,259,294,21,E14
Escuintla,Infarto agudo del miocardio,477,266,211,21,I21
Escuintla,Enfermedad renal crónica,229,139,90,21,N18
Escuintla,"Accidente de vehículo de motor o sin motor, tipo de vehículo no especificado",208,178,30,21,V89
Escuintla,"Agresión con disparo de otras armas de fuego, y las no especificadas",208,194,14,21,X95
Escuintla,Fibrosis y cirrosis del hígado,165,109,56,21,K74
Escuintla,"Neumonía, organismo no especificado",155,104,51,21,J18
Escuintla,Diabetes mellitus no insulinodependiente,148,68,80,21,E11
Escuintla,Insuficiencia renal no especificada,138,72,66,21,N19
Escuintla,Exposición a factores no especificados,121,101,20,21,X59
Escuintla,Tumor maligno del hígado y de las vías biliares intrahepáticas,92,54,38,21,C22
Escuintla,Tumor maligno del estómago,79,42,37,21,C16
Escuintla,"Accidente vascular encefálico agudo, no especificado como hemorrágico o isquémico",73,31,42,21,I64
Escuintla,Hipertensión esencial (primaria),67,34,33,21,I10
Escuintla,"Síntomas, signos y hallazgos anormales clínicos y de laboratorio, no clasificados en otra parte",1069,602,467,21,R00 - R99
Escuintla,Otras causas,1606,893,713,21,Otras causas
Santa Rosa,Todas las causas,2989,1728,1261,21,Todas las causas
Santa Rosa,Infarto agudo del miocardio,365,197,168,21,I21
Santa Rosa,SARS-CoV2/COVID 19,300,174,126,21,U07
Santa Rosa,"Diabetes mellitus, no especificada",209,90,119,21,E14
Santa Rosa,"Neumonía, organismo no especificado",93,55,38,21,J18
Santa Rosa,"Agresión con disparo de otras armas de fuego, y las no especificadas",91,80,11,21,X95
Santa Rosa,"Accidente de vehículo de motor o sin motor, tipo de vehículo no especificado",88,82,6,21,V89
Santa Rosa,Enfermedad renal crónica,86,48,38,21,N18
Santa Rosa,Insuficiencia renal no especificada,80,40,40,21,N19
Santa Rosa,"Accidente vascular encefálico agudo, no especificado como hemorrágico o isquémico",63,29,34,21,I64
Santa Rosa,Diabetes mellitus no insulinodependiente,62,24,38,21,E11
Santa Rosa,Insuficiencia cardíaca,62,39,23,21,I50
Santa Rosa,Fibrosis y cirrosis del hígado,61,47,14,21,K74
Santa Rosa,Otras enfermedades cerebrovasculares,48,23,25,21,I67
Santa Rosa,Tumor maligno del hígado y de las vías biliares intrahepáticas,44,22,22,21,C22
Santa Rosa,Exposición a factores no especificados,42,33,9,21,X59
Santa Rosa,"Síntomas, signos y hallazgos anormales clínicos y de laboratorio, no clasificados en otra parte",461,253,208,21,R00 - R99
Santa Rosa,Otras causas,834,492,342,21,Otras causas
Sololá,Todas las causas,3048,1768,1280,21,Todas las causas
Sololá,SARS-CoV2/COVID 19,360,247,113,21,U07
Sololá,Infarto agudo del miocardio,262,150,112,21,I21
Sololá,"Diabetes mellitus, no especificada",220,91,129,21,E14
Sololá,Diabetes mellitus no insulinodependiente,130,58,72,21,E11
Sololá,"Neumonía, organismo no especificado",101,53,48,21,J18
Sololá,"Accidente vascular encefálico agudo, no especificado como hemorrágico o isquémico",96,42,54,21,I64
Sololá,Fibrosis y cirrosis del hígado,78,51,27,21,K74
Sololá,Exposición a factores no especificados,77,65,12,21,X59
Sololá,Trastornos mentales y del comportamiento debidos al uso de alcohol,69,63,6,21,F10
Sololá,"Desnutrición proteicocalórica, no especificada",68,30,38,21,E46
Sololá,"Envenenamiento accidental por, y exposición al alcohol",63,55,8,21,X45
Sololá,Enfermedad alcohólica del hígado,59,51,8,21,K70
Sololá,Otras gastroenteritis y colitis de origen infeccioso y no especificado,54,26,28,21,A09
Sololá,Enfermedad renal crónica,50,24,26,21,N18
Sololá,"Accidente de vehículo de motor o sin motor, tipo de vehículo no especificado",47,39,8,21,V89
Sololá,"Síntomas, signos y hallazgos anormales clínicos y de laboratorio, no clasificados en otra parte",432,234,198,21,R00 - R99
Sololá,Otras causas,882,489,393,21,Otras causas
Totonicapán,Todas las causas,3920,2218,1702,21,Todas las causas
Totonicapán,SARS-CoV2/COVID 19,383,235,148,21,U07
Totonicapán,"Diabetes mellitus, no especificada",322,164,158,21,E14
Totonicapán,"Envenenamiento accidental por, y exposición al alcohol",155,129,26,21,X45
Totonicapán,Infarto agudo del miocardio,150,92,58,21,I21
Totonicapán,Fibrosis y cirrosis del hígado,144,90,54,21,K74
Totonicapán,"Neumonía, organismo no especificado",138,82,56,21,J18
Totonicapán,Hipertensión esencial (primaria),110,62,48,21,I10
Totonicapán,Trastornos mentales y del comportamiento debidos al uso de alcohol,76,61,15,21,F10
Totonicapán,Otros trastornos del encéfalo,69,39,30,21,G93
Totonicapán,Otras gastroenteritis y colitis de origen infeccioso y no especificado,67,36,31,21,A09
Totonicapán,Insuficiencia cardíaca,51,26,25,21,I50
Totonicapán,Diabetes mellitus no insulinodependiente,50,27,23,21,E11
Totonicapán,"Accidente vascular encefálico agudo, no especificado como hemorrágico o isquémico",50,23,27,21,I64
Totonicapán,Enfermedad alcohólica del hígado,50,36,14,21,K70
Totonicapán,Exposición a factores no especificados,46,37,9,21,X59
Totonicapán,"Síntomas, signos y hallazgos anormales clínicos y de laboratorio, no clasificados en otra parte",1299,692,607,21,R00 - R99
Totonicapán,Otras causas,760,387,373,21,Otras causas
Quetzaltenango,Todas las causas,6904,3861,3043,21,Todas las causas
Quetzaltenango,SARS-CoV2/COVID 19,926,555,371,21,U07
Quetzaltenango,Infarto agudo del miocardio,498,282,216,21,I21
Quetzaltenango,"Diabetes mellitus, no especificada",474,211,263,21,E14
Quetzaltenango,Diabetes mellitus no insulinodependiente,296,141,155,21,E11
Quetzaltenango,Fibrosis y cirrosis del hígado,218,142,76,21,K74
Quetzaltenango,Insuficiencia cardíaca,210,106,104,21,I50
Quetzaltenango,Enfermedad alcohólica del hígado,199,166,33,21,K70
Quetzaltenango,"Neumonía, organismo no especificado",158,89,69,21,J18
Quetzaltenango,Exposición a factores no especificados,156,123,33,21,X59
Quetzaltenango,Insuficiencia renal no especificada,127,69,58,21,N19
Quetzaltenango,Hipertensión esencial (primaria),117,50,67,21,I10
Quetzaltenango,Tumor maligno del hígado y de las vías biliares intrahepáticas,112,49,63,21,C22
Quetzaltenango,"Envenenamiento accidental por, y exposición al alcohol",106,94,12,21,X45
Quetzaltenango,Enfermedad renal crónica,95,55,40,21,N18
Quetzaltenango,"Accidente vascular encefálico agudo, no especificado como hemorrágico o isquémico",93,41,52,21,I64
Quetzaltenango,"Síntomas, signos y hallazgos anormales clínicos y de laboratorio, no clasificados en otra parte",909,472,437,21,R00 - R99
Quetzaltenango,Otras causas,2210,1216,994,21,Otras causas
Suchitepéquez,Todas las causas,4330,2444,1886,21,Todas las causas
Suchitepéquez,SARS-CoV2/COVID 19,443,283,160,21,U07
Suchitepéquez,"Diabetes mellitus, no especificada",183,67,116,21,E14
Suchitepéquez,Insuficiencia renal no especificada,158,95,63,21,N19
Suchitepéquez,Infarto agudo del miocardio,136,71,65,21,I21
Suchitepéquez,Exposición a factores no especificados,120,101,19,21,X59
Suchitepéquez,Enfermedad renal crónica,79,55,24,21,N18
Suchitepéquez,Diabetes mellitus no insulinodependiente,77,37,40,21,E11
Suchitepéquez,Fibrosis y cirrosis del hígado,60,41,19,21,K74
Suchitepéquez,Otros trastornos endocrinos,51,24,27,21,E34
Suchitepéquez,"Accidente de vehículo de motor o sin motor, tipo de vehículo no especificado",50,45,5,21,V89
Suchitepéquez,"Neumonía, organismo no especificado",47,28,19,21,J18
Suchitepéquez,Tumor maligno del hígado y de las vías biliares intrahepáticas,40,21,19,21,C22
Suchitepéquez,Diabetes mellitus insulinodependiente,31,11,20,21,E10
Suchitepéquez,"Agresión con disparo de otras armas de fuego, y las no especificadas",25,22,3,21,X95
Suchitepéquez,Insuficiencia cardíaca,21,5,16,21,I50
Suchitepéquez,"Síntomas, signos y hallazgos anormales clínicos y de laboratorio, no clasificados en otra parte",2095,1108,987,21,R00 - R99
Suchitepéquez,Otras causas,714,430,284,21,Otras causas
Retalhuleu,Todas las causas,2610,1497,1113,21,Todas las causas
Retalhuleu,SARS-CoV2/COVID 19,259,156,103,21,U07
Retalhuleu,"Diabetes mellitus, no especificada",120,54,66,21,E14
Retalhuleu,Infarto agudo del miocardio,70,33,37,21,I21
Retalhuleu,"Accidente de vehículo de motor o sin motor, tipo de vehículo no especificado",67,59,8,21,V89
Retalhuleu,Exposición a factores no especificados,52,45,7,21,X59
Retalhuleu,Insuficiencia renal no especificada,44,36,8,21,N19
Retalhuleu,Fibrosis y cirrosis del hígado,43,27,16,21,K74
Retalhuleu,"Neumonía, organismo no especificado",42,28,14,21,J18
Retalhuleu,Enfermedad renal crónica,42,25,17,21,N18
Retalhuleu,"Agresión con disparo de otras armas de fuego, y las no especificadas",30,29,1,21,X95
Retalhuleu,Otras sepsis,21,14,7,21,A41
Retalhuleu,Diabetes mellitus no insulinodependiente,21,12,9,21,E11
Retalhuleu,Insuficiencia cardíaca,21,12,9,21,I50
Retalhuleu,Tumor maligno del hígado y de las vías biliares intrahepáticas,14,6,8,21,C22
Retalhuleu,Tumor maligno de la próstata,12,12,0,21,C61
Retalhuleu,"Síntomas, signos y hallazgos anormales clínicos y de laboratorio, no clasificados en otra parte",1356,710,646,21,R00 - R99
Retalhuleu,Otras causas,396,239,157,21,Otras causas
San Marcos,Todas las causas,7135,4179,2956,21,Todas las causas
San Marcos,Infarto agudo del miocardio,907,576,331,21,I21
San Marcos,SARS-CoV2/COVID 19,717,447,270,21,U07
San Marcos,"Diabetes mellitus, no especificada",453,198,255,21,E14
San Marcos,"Neumonía, organismo no especificado",381,235,146,21,J18
San Marcos,Diabetes mellitus no insulinodependiente,273,121,152,21,E11
San Marcos,Fibrosis y cirrosis del hígado,260,179,81,21,K74
San Marcos,Insuficiencia cardíaca,196,95,101,21,I50
San Marcos,"Accidente vascular encefálico agudo, no especificado como hemorrágico o isquémico",155,78,77,21,I64
San Marcos,Tumor maligno del hígado y de las vías biliares intrahepáticas,148,76,72,21,C22
San Marcos,Enfermedad renal crónica,138,78,60,21,N18
San Marcos,"Envenenamiento accidental por, y exposición al alcohol",129,124,5,21,X45
San Marcos,Otras gastroenteritis y colitis de origen infeccioso y no especificado,124,81,43,21,A09
San Marcos,Exposición a factores no especificados,120,100,20,21,X59
San Marcos,Úlcera gástrica,114,60,54,21,K25
San Marcos,"Accidente de vehículo de motor o sin motor, tipo de vehículo no especificado",98,82,16,21,V89
San Marcos,"Síntomas, signos y hallazgos anormales clínicos y de laboratorio, no clasificados en otra parte",843,468,375,21,R00 - R99
San Marcos,Otras causas,2079,1181,898,21,Otras causas
Huehuetenango,Todas las causas,6531,3694,2837,21,Todas las causas
Huehuetenango,Infarto agudo del miocardio,804,447,357,21,I21
Huehuetenango,SARS-CoV2/COVID 19,700,438,262,21,U07
Huehuetenango,"Neumonía, organismo no especificado",595,341,254,21,J18
Huehuetenango,"Diabetes mellitus, no especificada",570,257,313,21,E14
Huehuetenango,"Accidente vascular encefálico agudo, no especificado como hemorrágico o isquémico",215,114,101,21,I64
Huehuetenango,Otras gastroenteritis y colitis de origen infeccioso y no especificado,189,96,93,21,A09
Huehuetenango,Diabetes mellitus no insulinodependiente,179,71,108,21,E11
Huehuetenango,Fibrosis y cirrosis del hígado,171,112,59,21,K74
Huehuetenango,Tumor maligno del estómago,144,70,74,21,C16
Huehuetenango,Otras enfermedades cerebrovasculares,133,68,65,21,I67
Huehuetenango,Tumor maligno del hígado y de las vías biliares intrahepáticas,127,62,65,21,C22
Huehuetenango,Exposición a factores no especificados,125,96,29,21,X59
Huehuetenango,Enfermedad renal crónica,115,66,49,21,N18
Huehuetenango,Úlcera gástrica,100,51,49,21,K25
Huehuetenango,Hipertensión esencial (primaria),96,47,49,21,I10
Huehuetenango,"Síntomas, signos y hallazgos anormales clínicos y de laboratorio, no clasificados en otra parte",273,152,121,21,R00 - R99
Huehuetenango,Otras causas,1995,1206,789,21,Otras causas
Quiche,Todas las causas,5617,3047,2570,21,Todas las causas
Quiche,SARS-CoV2/COVID 19,434,273,161,21,U07
Quiche,Infarto agudo del miocardio,408,224,184,21,I21
Quiche,"Diabetes mellitus, no especificada",362,166,196,21,E14
Quiche,Diabetes mellitus no insulinodependiente,286,123,163,21,E11
Quiche,"Neumonía, organismo no especificado",166,98,68,21,J18
Quiche,Hipertensión esencial (primaria),155,64,91,21,I10
Quiche,Otras gastroenteritis y colitis de origen infeccioso y no especificado,140,65,75,21,A09
Quiche,Exposición a factores no especificados,130,100,30,21,X59
Quiche,"Envenenamiento accidental por, y exposición al alcohol",107,99,8,21,X45
Quiche,Fibrosis y cirrosis del hígado,104,71,33,21,K74
Quiche,Insuficiencia renal no especificada,76,29,47,21,N19
Quiche,Trastornos mentales y del comportamiento debidos al uso de alcohol,74,72,2,21,F10
Quiche,"Accidente vascular encefálico agudo, no especificado como hemorrágico o isquémico",71,33,38,21,I64
Quiche,Enfermedad alcohólica del hígado,70,53,17,21,K70
Quiche,Otros trastornos del encéfalo,69,35,34,21,G93
Quiche,"Síntomas, signos y hallazgos anormales clínicos y de laboratorio, no clasificados en otra parte",1244,640,604,21,R00 - R99
Quiche,Otras causas,1721,902,819,21,Otras causas
Baja Verapaz,Todas las causas,1814,973,841,21,Todas las causas
Baja Verapaz,Infarto agudo del miocardio,276,138,138,21,I21
Baja Verapaz,SARS-CoV2/COVID 19,168,99,69,21,U07
Baja Verapaz,"Diabetes mellitus, no especificada",126,47,79,21,E14
Baja Verapaz,"Accidente vascular encefálico agudo, no especificado como hemorrágico o isquémico",89,42,47,21,I64
Baja Verapaz,"Neumonía, organismo no especificado",78,47,31,21,J18
Baja Verapaz,Tumor maligno del estómago,48,25,23,21,C16
Baja Verapaz,Hipertensión esencial (primaria),47,23,24,21,I10
Baja Verapaz,Exposición a factores no especificados,44,30,14,21,X59
Baja Verapaz,Diabetes mellitus no insulinodependiente,38,12,26,21,E11
Baja Verapaz,Fibrosis y cirrosis del hígado,29,21,8,21,K74
Baja Verapaz,"Accidente de vehículo de motor o sin motor, tipo de vehículo no especificado",25,22,3,21,V89
Baja Verapaz,Tumor maligno del hígado y de las vías biliares intrahepáticas,24,12,12,21,C22
Baja Verapaz,Otras gastroenteritis y colitis de origen infeccioso y no especificado,22,12,10,21,A09
Baja Verapaz,"Envenenamiento accidental por, y exposición al alcohol",19,18,1,21,X45
Baja Verapaz,Insuficiencia cardíaca,16,10,6,21,I50
Baja Verapaz,"Síntomas, signos y hallazgos anormales clínicos y de laboratorio, no clasificados en otra parte",153,87,66,21,R00 - R99
Baja Verapaz,Otras causas,612,328,284,21,Otras causas
Alta Verapaz,Todas las causas,5423,2830,2593,21,Todas las causas
Alta Verapaz,Otras gastroenteritis y colitis de origen infeccioso y no especificado,645,305,340,21,A09
Alta Verapaz,Infarto agudo del miocardio,510,283,227,21,I21
Alta Verapaz,"Neumonía, organismo no especificado",384,201,183,21,J18
Alta Verapaz,"Diabetes mellitus, no especificada",344,133,211,21,E14
Alta Verapaz,SARS-CoV2/COVID 19,240,144,96,21,U07
Alta Verapaz,Fibrosis y cirrosis del hígado,182,102,80,21,K74
Alta Verapaz,Diabetes mellitus no insulinodependiente,166,72,94,21,E11
Alta Verapaz,Tumor maligno del hígado y de las vías biliares intrahepáticas,137,65,72,21,C22
Alta Verapaz,Exposición a factores no especificados,122,108,14,21,X59
Alta Verapaz,Tumor maligno del estómago,102,50,52,21,C16
Alta Verapaz,Hipertensión esencial (primaria),100,41,59,21,I10
Alta Verapaz,"Desnutrición proteicocalórica, no especificada",95,47,48,21,E46
Alta Verapaz,"Accidente vascular encefálico agudo, no especificado como hemorrágico o isquémico",95,43,52,21,I64
Alta Verapaz,Úlcera gástrica,91,44,47,21,K25
Alta Verapaz,"Accidente de vehículo de motor o sin motor, tipo de vehículo no especificado",91,83,8,21,V89
Alta Verapaz,"Síntomas, signos y hallazgos anormales clínicos y de laboratorio, no clasificados en otra parte",174,82,92,21,R00 - R99
Alta Verapaz,Otras causas,1945,1027,918,21,Otras causas
Peten,Todas las causas,3222,1832,1390,21,Todas las causas
Peten,SARS-CoV2/COVID 19,532,298,234,21,U07
Peten,"Diabetes mellitus, no especificada",275,115,160,21,E14
Peten,Infarto agudo del miocardio,249,157,92,21,I21
Peten,"Accidente de vehículo de motor o sin motor, tipo de vehículo no especificado",132,111,21,21,V89
Peten,"Neumonía, organismo no especificado",100,63,37,21,J18
Peten,Diabetes mellitus no insulinodependiente,96,37,59,21,E11
Peten,"Agresión con disparo de otras armas de fuego, y las no especificadas",81,75,6,21,X95
Peten,Fibrosis y cirrosis del hígado,63,31,32,21,K74
Peten,Hipertensión esencial (primaria),56,26,30,21,I10
Peten,Otros trastornos del encéfalo,53,23,30,21,G93
Peten,Exposición a factores no especificados,49,45,4,21,X59
Peten,Tumor maligno del hígado y de las vías biliares intrahepáticas,43,22,21,21,C22
Peten,Enfermedad renal crónica,39,18,21,21,N18
Peten,Tumor maligno de la próstata,38,38,0,21,C61
Peten,Tumor maligno del estómago,34,14,20,21,C16
Peten,"Síntomas, signos y hallazgos anormales clínicos y de laboratorio, no clasificados en otra parte",463,263,200,21,R00 - R99
Peten,Otras causas,919,496,423,21,Otras causas
Izabal,Todas las causas,2932,1663,1269,21,Todas las causas
Izabal,Infarto agudo del miocardio,472,265,207,21,I21
Izabal,SARS-CoV2/COVID 19,369,205,164,21,U07
Izabal,"Diabetes mellitus, no especificada",197,76,121,21,E14
Izabal,"Neumonía, organismo no especificado",106,56,50,21,J18
Izabal,"Accidente de vehículo de motor o sin motor, tipo de vehículo no especificado",102,89,13,21,V89
Izabal,"Agresión con disparo de otras armas de fuego, y las no especificadas",73,66,7,21,X95
Izabal,Fibrosis y cirrosis del hígado,70,41,29,21,K74
Izabal,Exposición a factores no especificados,70,59,11,21,X59
Izabal,Otras gastroenteritis y colitis de origen infeccioso y no especificado,67,34,33,21,A09
Izabal,"Accidente vascular encefálico agudo, no especificado como hemorrágico o isquémico",66,35,31,21,I64
Izabal,Diabetes mellitus no insulinodependiente,50,23,27,21,E11
Izabal,Insuficiencia renal no especificada,49,28,21,21,N19
Izabal,Otras sepsis,43,25,18,21,A41
Izabal,"Disparo de otras armas de fuego, y las no especificadas",40,38,2,21,W34
Izabal,Tumor maligno del estómago,37,19,18,21,C16
Izabal,"Síntomas, signos y hallazgos anormales clínicos y de laboratorio, no clasificados en otra parte",277,151,126,21,R00 - R99
Izabal,Otras causas,844,453,391,21,Otras causas
Zacapa,Todas las causas,2090,1148,942,21,Todas las causas
Zacapa,SARS-CoV2/COVID 19,362,223,139,21,U07
Zacapa,Infarto agudo del miocardio,321,177,144,21,I21
Zacapa,Diabetes mellitus no insulinodependiente,133,62,71,21,E11
Zacapa,"Diabetes mellitus, no especificada",125,45,80,21,E14
Zacapa,"Accidente vascular encefálico agudo, no especificado como hemorrágico o isquémico",75,33,42,21,I64
Zacapa,"Agresión con disparo de otras armas de fuego, y las no especificadas",75,65,10,21,X95
Zacapa,"Neumonía, organismo no especificado",56,29,27,21,J18
Zacapa,"Accidente de vehículo de motor o sin motor, tipo de vehículo no especificado",51,41,10,21,V89
Zacapa,Exposición a factores no especificados,47,34,13,21,X59
Zacapa,Fibrosis y cirrosis del hígado,36,24,12,21,K74
Zacapa,Tumor maligno del estómago,31,13,18,21,C16
Zacapa,Insuficiencia cardíaca,31,18,13,21,I50
Zacapa,Otras enfermedades pulmonares obstructivas crónicas,30,12,18,21,J44
Zacapa,Tumor maligno del hígado y de las vías biliares intrahepáticas,26,13,13,21,C22
Zacapa,Hipertensión esencial (primaria),24,9,15,21,I10
Zacapa,"Síntomas, signos y hallazgos anormales clínicos y de laboratorio, no clasificados en otra parte",116,65,51,21,R00 - R99
Zacapa,Otras causas,551,285,266,21,Otras causas
Chiquimula,Todas las causas,2815,1601,1214,21,Todas las causas
Chiquimula,SARS-CoV2/COVID 19,406,235,171,21,U07
Chiquimula,Infarto agudo del miocardio,397,237,160,21,I21
Chiquimula,"Diabetes mellitus, no especificada",141,49,92,21,E14
Chiquimula,"Neumonía, organismo no especificado",110,62,48,21,J18
Chiquimula,"Agresión con disparo de otras armas de fuego, y las no especificadas",101,95,6,21,X95
Chiquimula,Insuficiencia cardíaca,77,37,40,21,I50
Chiquimula,Fibrosis y cirrosis del hígado,77,49,28,21,K74
Chiquimula,"Accidente de vehículo de motor o sin motor, tipo de vehículo no especificado",73,63,10,21,V89
Chiquimula,Otras enfermedades cerebrovasculares,66,40,26,21,I67
Chiquimula,"Accidente vascular encefálico agudo, no especificado como hemorrágico o isquémico",63,30,33,21,I64
Chiquimula,Tumor maligno del estómago,62,40,22,21,C16
Chiquimula,Diabetes mellitus no insulinodependiente,62,28,34,21,E11
Chiquimula,Hipertensión esencial (primaria),51,24,27,21,I10
Chiquimula,Otras enfermedades pulmonares obstructivas crónicas,51,28,23,21,J44
Chiquimula,Tumor maligno del hígado y de las vías biliares intrahepáticas,35,19,16,21,C22
Chiquimula,"Síntomas, signos y hallazgos anormales clínicos y de laboratorio, no clasificados en otra parte",201,100,101,21,R00 - R99
Chiquimula,Otras causas,842,465,377,21,Otras causas
Jalapa,Todas las causas,2187,1264,923,21,Todas las causas
Jalapa,Infarto agudo del miocardio,295,173,122,21,I21
Jalapa,SARS-CoV2/COVID 19,187,124,63,21,U07
Jalapa,"Diabetes mellitus, no especificada",119,53,66,21,E14
Jalapa,Otros trastornos del encéfalo,107,51,56,21,G93
Jalapa,"Accidente vascular encefálico agudo, no especificado como hemorrágico o isquémico",79,39,40,21,I64
Jalapa,"Neumonía, organismo no especificado",70,40,30,21,J18
Jalapa,"Agresión con disparo de otras armas de fuego, y las no especificadas",69,53,16,21,X95
Jalapa,Tumor maligno del hígado y de las vías biliares intrahepáticas,55,28,27,21,C22
Jalapa,Insuficiencia renal no especificada,38,21,17,21,N19
Jalapa,Exposición a factores no especificados,36,30,6,21,X59
Jalapa,Fibrosis y cirrosis del hígado,32,24,8,21,K74
Jalapa,Tumor maligno de sitios no especificados,31,10,21,21,C80
Jalapa,Tumor maligno del estómago,29,13,16,21,C16
Jalapa,Úlcera gástrica,29,13,16,21,K25
Jalapa,"Accidente de vehículo de motor o sin motor, tipo de vehículo no especificado",27,24,3,21,V89
Jalapa,"Síntomas, signos y hallazgos anormales clínicos y de laboratorio, no clasificados en otra parte",455,267,188,21,R00 - R99
Jalapa,Otras causas,529,301,228,21,Otras causas
Jutiapa,Todas las causas,3675,2017,1658,21,Todas las causas
Jutiapa,Infarto agudo del miocardio,734,427,307,21,I21
Jutiapa,SARS-CoV2/COVID 19,344,186,158,21,U07
Jutiapa,"Diabetes mellitus, no especificada",271,104,167,21,E14
Jutiapa,"Accidente vascular encefálico agudo, no especificado como hemorrágico o isquémico",258,119,139,21,I64
Jutiapa,Diabetes mellitus no insulinodependiente,144,59,85,21,E11
Jutiapa,Enfermedad renal crónica,103,58,45,21,N18
Jutiapa,"Neumonía, organismo no especificado",87,52,35,21,J18
Jutiapa,"Accidente de vehículo de motor o sin motor, tipo de vehículo no especificado",83,74,9,21,V89
Jutiapa,Tumor maligno del estómago,75,40,35,21,C16
Jutiapa,"Agresión con disparo de otras armas de fuego, y las no especificadas",75,58,17,21,X95
Jutiapa,Insuficiencia cardíaca,69,37,32,21,I50
Jutiapa,Fibrosis y cirrosis del hígado,55,43,12,21,K74
Jutiapa,Hipertensión esencial (primaria),52,20,32,21,I10
Jutiapa,Tumor maligno del hígado y de las vías biliares intrahepáticas,48,19,29,21,C22
Jutiapa,Exposición a factores no especificados,46,37,9,21,X59
Jutiapa,"Síntomas, signos y hallazgos anormales clínicos y de laboratorio, no clasificados en otra parte",211,98,113,21,R00 - R99
Jutiapa,Otras causas,1020,586,434,21,Otras causas
Extranjero,Todas las causas,208,150,58,21,Todas las causas
Extranjero,SARS-CoV2/COVID 19,31,18,13,21,U07
Extranjero,Infarto agudo del miocardio,19,12,7,21,I21
Extranjero,"Diabetes mellitus, no especificada",13,9,4,21,E14
Extranjero,"Accidente de vehículo de motor o sin motor, tipo de vehículo no especificado",9,6,3,21,V89
Extranjero,"Neumonía, organismo no especificado",8,7,1,21,J18
Extranjero,"Agresión con disparo de otras armas de fuego, y las no especificadas",8,6,2,21,X95
Extranjero,Diabetes mellitus no insulinodependiente,7,5,2,21,E11
Extranjero,Fibrosis y cirrosis del hígado,6,5,1,21,K74
Extranjero,Enfermedad renal crónica,6,6,0,21,N18
Extranjero,Tumor maligno del hígado y de las vías biliares intrahepáticas,5,4,1,21,C22
Extranjero,Tumor maligno del estómago,4,3,1,21,C16
Extranjero,"Envenenamiento accidental por, y exposición al alcohol",4,4,0,21,X45
Extranjero,Tumor maligno de los bronquios y del pulmón,3,2,1,21,C34
Extranjero,Enfermedad alcohólica del hígado,3,3,0,21,K70
Extranjero,Exposición a factores no especificados,3,3,0,21,X59
Extranjero,"Síntomas, signos y hallazgos anormales clínicos y de laboratorio, no clasificados en otra parte",21,18,3,21,R00 - R99
Extranjero,Otras causas,58,39,19,21,Otras causas
Ignorado,Todas las causas,8750,4964,3786,21,Todas las causas
Ignorado,"Neumonía, organismo no especificado",654,381,273,21,J18
Ignorado,Otras gastroenteritis y colitis de origen infeccioso y no especificado,636,354,282,21,A09
Ignorado,Sepsis bacteriana del recién nacido,444,255,189,21,P36
Ignorado,Dificultad respiratoria del recién nacido,311,168,143,21,P22
Ignorado,Otras sepsis,281,139,142,21,A41
Ignorado,"Otras malformaciones congénitas, no clasificadas en otra parte",252,138,114,21,Q89
Ignorado,Otras malformaciones congénitas del corazón,248,113,135,21,Q24
Ignorado,SARS-CoV2/COVID 19,214,112,102,21,U07
Ignorado,Neumonía congénita,203,117,86,21,P23
Ignorado,Exposición a factores no especificados,198,153,45,21,X59
Ignorado,"Accidente de vehículo de motor o sin motor, tipo de vehículo no especificado",157,123,34,21,V89
Ignorado,"Agresión con disparo de otras armas de fuego, y las no especificadas",153,127,26,21,X95
Ignorado,Síndromes de aspiración neonatal,148,83,65,21,P24
Ignorado,Infarto agudo del miocardio,131,68,63,21,I21
Ignorado,"Trastornos relacionados con duración corta de la gestación y con bajo peso al nacer, no clasificados en otra parte",131,79,52,21,P07
Ignorado,"Síntomas, signos y hallazgos anormales clínicos y de laboratorio, no clasificados en otra parte",993,554,439,21,R00 - R99
Ignorado,Otras causas,3596,2000,1596,21,Otras causas
